"Second","initial_unique_user","viewersAfterDrop","newViewersAppearing","total_active_viewer","total_views","[MB] cdnBWConsumption","[$] cdnBWConsumptionCost","[MB] totalCDNBWConsumption|so_far","[$] totalCDNBWConsumptionCost|so_far"
"1","0","0","0","1000","1000","219.375","0.002851875","219.375","0.002851875"
"2","1000","996","4","1000","1004","219.375","0.002851875","438.75","0.00570375"
"3","1000","994","3","997","1007","218.716875","0.0028433193749999998","657.466875","0.008547069374999999"
"4","997","991","1","992","1008","217.61999999999998","0.0028290599999999996","875.086875","0.011376129374999999"
"5","992","991","4","995","1012","218.278125","0.0028376156249999996","1093.365","0.014213744999999998"
"6","995","987","8","995","1020","218.278125","0.0028376156249999996","1311.643125","0.017051360624999998"
"7","995","994","6","1000","1026","219.375","0.002851875","1531.018125","0.019903235624999998"
"8","1000","998","8","1006","1034","220.69125","0.00286898625","1751.7093750000001","0.022772221875"
"9","1006","1003","9","1012","1043","222.0075","0.0028860974999999995","1973.716875","0.025658319375"
"10","1012","1011","8","1019","1051","223.54312500000003","0.0029060606250000003","2197.26","0.02856438"
"11","1019","1018","8","1026","1059","225.07875","0.00292602375","2422.3387500000003","0.03149040375"
"12","1026","1018","1","1019","1060","223.54312500000003","0.0029060606250000003","2645.8818750000005","0.034396464375"
"13","1019","1017","6","1023","1066","224.420625","0.002917468125","2870.3025000000007","0.0373139325"
"14","1023","1016","6","1022","1072","224.20125","0.0029146162499999995","3094.5037500000008","0.04022854875"
"15","1022","1020","7","1027","1079","225.29812499999994","0.002928875624999999","3319.8018750000006","0.043157424375"
"16","1027","1024","1","1025","1080","224.859375","0.002923171875","3544.6612500000006","0.04608059625"
"17","1025","1021","8","1029","1088","225.736875","0.002934579375","3770.3981250000006","0.049015175625000004"
"18","1029","1027","6","1033","1094","226.614375","0.002945986875","3997.0125000000007","0.051961162500000005"
"19","1033","1029","9","1038","1103","227.71124999999998","0.0029602462499999996","4224.723750000001","0.054921408750000004"
"20","1038","1033","2","1035","1105","227.053125","0.0029516906249999995","4451.776875000001","0.057873099375"
"21","1035","1033","8","1041","1113","228.36937500000002","0.002968801875","4680.146250000002","0.060841901250000004"
"22","1041","1039","3","1042","1116","228.58874999999998","0.0029716537499999995","4908.7350000000015","0.06381355500000001"
"23","1042","1035","6","1041","1122","228.36937500000002","0.002968801875","5137.104375000002","0.066782356875"
"24","1041","1035","7","1042","1129","228.58874999999998","0.0029716537499999995","5365.693125000002","0.069754010625"
"25","1042","1034","5","1039","1134","227.93062500000002","0.002963098125","5593.623750000002","0.07271710875"
"26","1039","1035","5","1040","1139","228.15","0.0029659499999999997","5821.773750000001","0.07568305874999999"
"27","1040","1033","1","1034","1140","226.83375","0.00294883875","6048.607500000001","0.07863189749999999"
"28","1034","1033","4","1037","1144","227.491875","0.0029573943749999997","6276.099375000001","0.081589291875"
"29","1037","1033","5","1038","1149","227.71124999999998","0.0029602462499999996","6503.810625000001","0.08454953812499999"
"30","1038","1035","5","1040","1154","228.15","0.0029659499999999997","6731.960625000001","0.08751548812499998"
"31","1040","1039","1","1040","1155","228.15","0.0029659499999999997","6960.110625","0.09048143812499998"
"32","1040","1036","2","1038","1157","227.71124999999998","0.0029602462499999996","7187.821875000001","0.09344168437499997"
"33","1038","1035","7","1042","1164","228.58874999999998","0.0029716537499999995","7416.410625","0.09641333812499997"
"34","1042","1037","2","1039","1166","227.93062500000002","0.002963098125","7644.34125","0.09937643624999996"
"35","1039","1038","7","1045","1173","229.246875","0.0029802093749999995","7873.588125","0.10235664562499996"
"36","1045","1039","6","1045","1179","229.246875","0.0029802093749999995","8102.835","0.10533685499999997"
"37","1045","1042","3","1045","1182","229.246875","0.0029802093749999995","8332.081875","0.10831706437499997"
"38","1045","1038","9","1047","1191","229.685625","0.0029859131249999997","8561.7675","0.11130297749999997"
"39","1047","1043","5","1048","1196","229.905","0.002988765","8791.6725","0.11429174249999997"
"40","1048","1040","7","1047","1203","229.685625","0.0029859131249999997","9021.358125","0.11727765562499998"
"41","1047","1041","8","1049","1211","230.124375","0.0029916168749999994","9251.4825","0.12026927249999998"
"42","1049","1048","3","1051","1214","230.563125","0.002997320625","9482.045625","0.12326659312499998"
"43","1051","1045","8","1053","1222","231.00187499999998","0.0030030243749999998","9713.0475","0.1262696175"
"44","1053","1047","9","1056","1231","231.66","0.00301158","9944.7075","0.1292811975"
"45","1056","1049","5","1054","1236","231.22125","0.0030058762499999996","10175.928750000001","0.13228707375"
"46","1054","1045","7","1052","1243","230.78249999999994","0.003000172499999999","10406.71125","0.13528724625000002"
"47","1052","1045","9","1054","1252","231.22125","0.0030058762499999996","10637.9325","0.13829312250000003"
"48","1054","1046","9","1055","1261","231.440625","0.003008728125","10869.373125","0.14130185062500003"
"49","1055","1054","2","1056","1263","231.66","0.00301158","11101.033125","0.14431343062500002"
"50","1056","1047","6","1053","1269","231.00187499999998","0.0030030243749999998","11332.035","0.147316455"
"51","1053","1052","1","1053","1270","231.00187499999998","0.0030030243749999998","11563.036875","0.150319479375"
"52","1053","1045","9","1054","1279","231.22125","0.0030058762499999996","11794.258125","0.15332535562500002"
"53","1054","1048","8","1056","1287","231.66","0.00301158","12025.918125","0.156336935625"
"54","1056","1049","1","1050","1288","230.34375","0.0029944687499999997","12256.261875","0.159331404375"
"55","1050","1045","3","1048","1291","229.905","0.002988765","12486.166875","0.16232016937500002"
"56","1048","1047","5","1052","1296","230.78249999999994","0.003000172499999999","12716.949375","0.16532034187500003"
"57","1052","1046","2","1048","1298","229.905","0.002988765","12946.854375","0.16830910687500003"
"58","1048","1039","8","1047","1306","229.685625","0.0029859131249999997","13176.54","0.17129502000000002"
"59","1047","1044","6","1050","1312","230.34375","0.0029944687499999997","13406.88375","0.17428948875000003"
"60","1050","1044","9","1053","1321","231.00187499999998","0.0030030243749999998","13637.885625","0.17729251312500002"
"61","1053","1052","4","1056","1325","231.66","0.00301158","13869.545625","0.180304093125"
"62","1056","1050","2","1052","1327","230.78249999999994","0.003000172499999999","14100.328125","0.18330426562500002"
"63","1052","1045","4","1049","1331","230.124375","0.0029916168749999994","14330.4525","0.1862958825"
"64","1049","1041","5","1046","1336","229.46625","0.00298306125","14559.918749999999","0.18927894375"
"65","1046","1043","7","1050","1343","230.34375","0.0029944687499999997","14790.262499999999","0.19227341250000002"
"66","1050","1044","4","1048","1347","229.905","0.002988765","15020.1675","0.19526217750000002"
"67","1048","1041","7","1048","1354","229.905","0.002988765","15250.0725","0.19825094250000003"
"68","1048","1040","3","1043","1357","228.808125","0.002974505625","15478.880625","0.20122544812500004"
"69","1043","1039","2","1041","1359","228.36937500000002","0.002968801875","15707.25","0.20419425000000005"
"70","1041","1032","9","1041","1368","228.36937500000002","0.002968801875","15935.619375","0.20716305187500006"
"71","1041","1040","2","1042","1370","228.58874999999998","0.0029716537499999995","16164.208125000001","0.21013470562500006"
"72","1042","1036","2","1038","1372","227.71124999999998","0.0029602462499999996","16391.919375","0.21309495187500005"
"73","1038","1029","4","1033","1376","226.614375","0.002945986875","16618.533750000002","0.21604093875000005"
"74","1033","1031","4","1035","1380","227.053125","0.0029516906249999995","16845.586875","0.21899262937500005"
"75","1035","1032","9","1041","1389","228.36937500000002","0.002968801875","17073.95625","0.22196143125000006"
"76","1041","1039","5","1044","1394","229.02750000000003","0.0029773575","17302.98375","0.22493878875000006"
"77","1044","1037","7","1044","1401","229.02750000000003","0.0029773575","17532.01125","0.22791614625000006"
"78","1044","1036","3","1039","1404","227.93062500000002","0.002963098125","17759.941875","0.23087924437500007"
"79","1039","1038","5","1043","1409","228.808125","0.002974505625","17988.75","0.23385375000000008"
"80","1043","1040","2","1042","1411","228.58874999999998","0.0029716537499999995","18217.33875","0.23682540375000008"
"81","1042","1037","2","1039","1413","227.93062500000002","0.002963098125","18445.269375","0.2397885018750001"
"82","1039","1034","2","1036","1415","227.2725","0.0029545425","18672.541875","0.24274304437500008"
"83","1036","1030","9","1039","1424","227.93062500000002","0.002963098125","18900.4725","0.24570614250000009"
"84","1039","1030","7","1037","1431","227.491875","0.0029573943749999997","19127.964375","0.2486635368750001"
"85","1037","1032","9","1041","1440","228.36937500000002","0.002968801875","19356.333749999998","0.2516323387500001"
"86","1041","1038","7","1045","1447","229.246875","0.0029802093749999995","19585.580625","0.25461254812500006"
"87","1045","1041","8","1049","1455","230.124375","0.0029916168749999994","19815.704999999998","0.25760416500000005"
"88","1049","1040","5","1045","1460","229.246875","0.0029802093749999995","20044.951875","0.26058437437500004"
"89","1045","1044","5","1049","1465","230.124375","0.0029916168749999994","20275.07625","0.26357599125000003"
"90","1049","1044","1","1045","1466","229.246875","0.0029802093749999995","20504.323125","0.266556200625"
"91","1045","1043","2","1045","1468","229.246875","0.0029802093749999995","20733.57","0.26953641"
"92","1045","1038","9","1047","1477","229.685625","0.0029859131249999997","20963.255624999998","0.272522323125"
"93","1047","1041","7","1048","1484","229.905","0.002988765","21193.160624999997","0.275511088125"
"94","1048","1042","1","1043","1485","228.808125","0.002974505625","21421.968749999996","0.27848559375000004"
"95","1043","1039","3","1042","1488","228.58874999999998","0.0029716537499999995","21650.557499999995","0.28145724750000006"
"96","1042","1033","6","1039","1494","227.93062500000002","0.002963098125","21878.488124999996","0.28442034562500007"
"97","1039","1033","6","1039","1500","227.93062500000002","0.002963098125","22106.418749999997","0.2873834437500001"
"98","1039","1031","1","1032","1501","226.39499999999998","0.0029431349999999995","22332.813749999998","0.29032657875000006"
"99","1032","1026","5","1031","1506","226.175625","0.0029402831249999996","22558.989374999997","0.29326686187500006"
"100","1031","1029","8","1037","1514","227.491875","0.0029573943749999997","22786.481249999997","0.29622425625000004"
"101","1037","1035","2","1037","1516","227.491875","0.0029573943749999997","23013.973124999997","0.299181650625"
"102","1037","1033","5","1038","1521","227.71124999999998","0.0029602462499999996","23241.684374999997","0.30214189687500004"
"103","1038","1030","1","1031","1522","226.175625","0.0029402831249999996","23467.859999999997","0.30508218000000004"
"104","1031","1027","6","1033","1528","226.614375","0.002945986875","23694.474374999998","0.308028166875"
"105","1033","1031","7","1038","1535","227.71124999999998","0.0029602462499999996","23922.185625","0.31098841312500003"
"106","1038","1029","4","1033","1539","226.614375","0.002945986875","24148.8","0.3139344"
"107","1033","1027","4","1031","1543","226.175625","0.0029402831249999996","24374.975625","0.316874683125"
"108","1031","1024","4","1028","1547","225.51749999999998","0.0029317274999999996","24600.493125","0.319806410625"
"109","1028","1027","4","1031","1551","226.175625","0.0029402831249999996","24826.66875","0.32274669375"
"110","1031","1022","4","1026","1555","225.07875","0.00292602375","25051.7475","0.3256727175"
"111","1026","1020","4","1024","1559","224.64","0.0029203199999999997","25276.3875","0.32859303749999996"
"112","1024","1022","7","1029","1566","225.736875","0.002934579375","25502.124375","0.331527616875"
"113","1029","1027","1","1028","1567","225.51749999999998","0.0029317274999999996","25727.641875","0.33445934437499997"
"114","1028","1027","7","1034","1574","226.83375","0.00294883875","25954.475625000003","0.337408183125"
"115","1034","1033","8","1041","1582","228.36937500000002","0.002968801875","26182.845","0.34037698499999997"
"116","1041","1039","6","1045","1588","229.246875","0.0029802093749999995","26412.091875000002","0.34335719437499995"
"117","1045","1044","9","1053","1597","231.00187499999998","0.0030030243749999998","26643.093750000004","0.34636021874999995"
"118","1053","1048","7","1055","1604","231.440625","0.003008728125","26874.534375000003","0.349368946875"
"119","1055","1048","6","1054","1610","231.22125","0.0030058762499999996","27105.755625","0.35237482312499996"
"120","1054","1046","7","1053","1617","231.00187499999998","0.0030030243749999998","27336.757500000003","0.35537784749999995"
"121","1053","1050","4","1054","1621","231.22125","0.0030058762499999996","27567.978750000002","0.35838372374999994"
"122","1054","1050","2","1052","1623","230.78249999999994","0.003000172499999999","27798.761250000003","0.36138389624999995"
"123","1052","1046","6","1052","1629","230.78249999999994","0.003000172499999999","28029.543750000004","0.36438406874999996"
"124","1052","1043","5","1048","1634","229.905","0.002988765","28259.448750000003","0.36737283374999996"
"125","1048","1041","4","1045","1638","229.246875","0.0029802093749999995","28488.695625000004","0.37035304312499995"
"126","1045","1039","5","1044","1643","229.02750000000003","0.0029773575","28717.723125000004","0.37333040062499995"
"127","1044","1035","2","1037","1645","227.491875","0.0029573943749999997","28945.215000000004","0.3762877949999999"
"128","1037","1028","6","1034","1651","226.83375","0.00294883875","29172.048750000005","0.37923663374999994"
"129","1034","1028","4","1032","1655","226.39499999999998","0.0029431349999999995","29398.443750000006","0.3821797687499999"
"130","1032","1025","2","1027","1657","225.29812499999994","0.002928875624999999","29623.741875000007","0.3851086443749999"
"131","1027","1019","2","1021","1659","223.981875","0.0029117643749999996","29847.72375000001","0.38802040874999993"
"132","1021","1014","9","1023","1668","224.420625","0.002917468125","30072.144375000007","0.3909378768749999"
"133","1023","1019","4","1023","1672","224.420625","0.002917468125","30296.565000000006","0.3938553449999999"
"134","1023","1020","4","1024","1676","224.64","0.0029203199999999997","30521.205000000005","0.3967756649999999"
"135","1024","1023","4","1027","1680","225.29812499999994","0.002928875624999999","30746.503125000007","0.3997045406249999"
"136","1027","1021","3","1024","1683","224.64","0.0029203199999999997","30971.143125000006","0.40262486062499986"
"137","1024","1020","3","1023","1686","224.420625","0.002917468125","31195.563750000005","0.40554232874999985"
"138","1023","1014","8","1022","1694","224.20125","0.0029146162499999995","31419.765000000003","0.40845694499999985"
"139","1022","1013","8","1021","1702","223.981875","0.0029117643749999996","31643.746875000004","0.41136870937499986"
"140","1021","1015","4","1019","1706","223.54312500000003","0.0029060606250000003","31867.290000000005","0.41427476999999985"
"141","1019","1010","4","1014","1710","222.44625000000002","0.00289180125","32089.736250000005","0.41716657124999984"
"142","1014","1008","1","1009","1711","221.349375","0.002877541875","32311.085625000007","0.42004411312499984"
"143","1009","1002","4","1006","1715","220.69125","0.00286898625","32531.776875000007","0.4229130993749998"
"144","1006","999","7","1006","1722","220.69125","0.00286898625","32752.468125000007","0.4257820856249998"
"145","1006","1004","4","1008","1726","221.13","0.0028746899999999996","32973.598125000004","0.4286567756249998"
"146","1008","1002","8","1010","1734","221.56875","0.00288039375","33195.166875","0.4315371693749998"
"147","1010","1003","8","1011","1742","221.788125","0.002883245625","33416.955","0.4344204149999998"
"148","1011","1002","9","1011","1751","221.788125","0.002883245625","33638.743125","0.43730366062499976"
"149","1011","1008","7","1015","1758","222.665625","0.002894653125","33861.40875","0.44019831374999974"
"150","1015","1012","3","1015","1761","222.665625","0.002894653125","34084.074375000004","0.4430929668749997"
"151","1015","1011","8","1019","1769","223.54312500000003","0.0029060606250000003","34307.6175","0.4459990274999997"
"152","1019","1011","2","1013","1771","222.22687499999998","0.0028889493749999994","34529.844375","0.4488879768749997"
"153","1013","1008","9","1017","1780","223.10437499999998","0.0029003568749999993","34752.94875","0.4517883337499997"
"154","1017","1012","6","1018","1786","223.32375","0.0029032087499999996","34976.27250000001","0.4546915424999997"
"155","1018","1014","9","1023","1795","224.420625","0.002917468125","35200.693125000005","0.4576090106249997"
"156","1023","1022","8","1030","1803","225.95625","0.0029374312499999998","35426.64937500001","0.4605464418749997"
"157","1030","1027","1","1028","1804","225.51749999999998","0.0029317274999999996","35652.16687500001","0.4634781693749997"
"158","1028","1022","2","1024","1806","224.64","0.0029203199999999997","35876.80687500001","0.46639848937499967"
"159","1024","1016","2","1018","1808","223.32375","0.0029032087499999996","36100.13062500001","0.46930169812499967"
"160","1018","1016","2","1018","1810","223.32375","0.0029032087499999996","36323.454375000016","0.47220490687499966"
"161","1018","1011","4","1015","1814","222.665625","0.002894653125","36546.12000000002","0.47509955999999964"
"162","1015","1013","6","1019","1820","223.54312500000003","0.0029060606250000003","36769.663125000014","0.4780056206249996"
"163","1019","1011","4","1015","1824","222.665625","0.002894653125","36992.328750000015","0.4809002737499996"
"164","1015","1006","3","1009","1827","221.349375","0.002877541875","37213.67812500001","0.4837778156249996"
"165","1009","1005","6","1011","1833","221.788125","0.002883245625","37435.46625000001","0.4866610612499996"
"166","1011","1005","9","1014","1842","222.44625000000002","0.00289180125","37657.91250000001","0.4895528624999996"
"167","1014","1007","6","1013","1848","222.22687499999998","0.0028889493749999994","37880.13937500001","0.4924418118749996"
"168","1013","1011","8","1019","1856","223.54312500000003","0.0029060606250000003","38103.68250000001","0.49534787249999956"
"169","1019","1014","5","1019","1861","223.54312500000003","0.0029060606250000003","38327.22562500001","0.49825393312499955"
"170","1019","1011","3","1014","1864","222.44625000000002","0.00289180125","38549.67187500001","0.5011457343749995"
"171","1014","1013","4","1017","1868","223.10437499999998","0.0029003568749999993","38772.77625000001","0.5040460912499996"
"172","1017","1014","3","1017","1871","223.10437499999998","0.0029003568749999993","38995.88062500001","0.5069464481249996"
"173","1017","1010","5","1015","1876","222.665625","0.002894653125","39218.546250000014","0.5098411012499996"
"174","1015","1014","7","1021","1883","223.981875","0.0029117643749999996","39442.52812500001","0.5127528656249996"
"175","1021","1014","7","1021","1890","223.981875","0.0029117643749999996","39666.51000000001","0.5156646299999995"
"176","1021","1018","1","1019","1891","223.54312500000003","0.0029060606250000003","39890.053125000006","0.5185706906249995"
"177","1019","1016","5","1021","1896","223.981875","0.0029117643749999996","40114.035","0.5214824549999995"
"178","1021","1013","2","1015","1898","222.665625","0.002894653125","40336.700625000005","0.5243771081249995"
"179","1015","1009","3","1012","1901","222.0075","0.0028860974999999995","40558.708125000005","0.5272632056249995"
"180","1012","1004","9","1013","1910","222.22687499999998","0.0028889493749999994","40780.935000000005","0.5301521549999995"
"181","1013","1010","4","1014","1914","222.44625000000002","0.00289180125","41003.381250000006","0.5330439562499995"
"182","1014","1011","6","1017","1920","223.10437499999998","0.0029003568749999993","41226.48562500001","0.5359443131249995"
"183","1017","1013","4","1017","1924","223.10437499999998","0.0029003568749999993","41449.59000000001","0.5388446699999995"
"184","1017","1010","4","1014","1928","222.44625000000002","0.00289180125","41672.03625000001","0.5417364712499995"
"185","1014","1007","1","1008","1929","221.13","0.0028746899999999996","41893.16625000001","0.5446111612499994"
"186","1008","1002","9","1011","1938","221.788125","0.002883245625","42114.95437500001","0.5474944068749994"
"187","1011","1006","4","1010","1942","221.56875","0.00288039375","42336.52312500001","0.5503748006249994"
"188","1010","1002","7","1009","1949","221.349375","0.002877541875","42557.872500000005","0.5532523424999994"
"189","1009","1008","6","1014","1955","222.44625000000002","0.00289180125","42780.318750000006","0.5561441437499994"
"190","1014","1006","4","1010","1959","221.56875","0.00288039375","43001.887500000004","0.5590245374999995"
"191","1010","1006","9","1015","1968","222.665625","0.002894653125","43224.553125000006","0.5619191906249995"
"192","1015","1007","6","1013","1974","222.22687499999998","0.0028889493749999994","43446.780000000006","0.5648081399999995"
"193","1013","1004","7","1011","1981","221.788125","0.002883245625","43668.568125000005","0.5676913856249994"
"194","1011","1002","1","1003","1982","220.03312499999998","0.0028604306249999994","43888.60125000001","0.5705518162499994"
"195","1003","1002","1","1003","1983","220.03312499999998","0.0028604306249999994","44108.63437500001","0.5734122468749994"
"196","1003","1000","6","1006","1989","220.69125","0.00286898625","44329.32562500001","0.5762812331249993"
"197","1006","1005","2","1007","1991","220.91062499999998","0.0028718381249999998","44550.23625000001","0.5791530712499994"
"198","1007","999","6","1005","1997","220.471875","0.002866134375","44770.70812500001","0.5820192056249994"
"199","1005","1003","6","1009","2003","221.349375","0.002877541875","44992.05750000001","0.5848967474999994"
"200","1009","1005","3","1008","2006","221.13","0.0028746899999999996","45213.18750000001","0.5877714374999994"
"201","1008","1001","7","1008","2013","221.13","0.0028746899999999996","45434.317500000005","0.5906461274999993"
"202","1008","1006","2","1008","2015","221.13","0.0028746899999999996","45655.4475","0.5935208174999993"
"203","1008","1002","3","1005","2018","220.471875","0.002866134375","45875.919375000005","0.5963869518749993"
"204","1005","1000","3","1003","2021","220.03312499999998","0.0028604306249999994","46095.95250000001","0.5992473824999993"
"205","1003","994","6","1000","2027","219.375","0.002851875","46315.32750000001","0.6020992574999993"
"206","1000","998","6","1004","2033","220.2525","0.0028632824999999997","46535.58000000001","0.6049625399999993"
"207","1004","997","2","999","2035","219.155625","0.0028490231249999995","46754.73562500001","0.6078115631249993"
"208","999","998","2","1000","2037","219.375","0.002851875","46974.11062500001","0.6106634381249992"
"209","1000","997","9","1006","2046","220.69125","0.00286898625","47194.80187500001","0.6135324243749992"
"210","1006","1002","2","1004","2048","220.2525","0.0028632824999999997","47415.054375000014","0.6163957068749992"
"211","1004","1000","1","1001","2049","219.594375","0.002854726875","47634.648750000015","0.6192504337499992"
"212","1001","995","6","1001","2055","219.594375","0.002854726875","47854.243125000015","0.6221051606249992"
"213","1001","996","7","1003","2062","220.03312499999998","0.0028604306249999994","48074.27625000002","0.6249655912499992"
"214","1003","998","3","1001","2065","219.594375","0.002854726875","48293.87062500002","0.6278203181249992"
"215","1001","995","8","1003","2073","220.03312499999998","0.0028604306249999994","48513.90375000002","0.6306807487499991"
"216","1003","996","5","1001","2078","219.594375","0.002854726875","48733.49812500002","0.6335354756249991"
"217","1001","996","3","999","2081","219.155625","0.0028490231249999995","48952.65375000002","0.6363844987499991"
"218","999","993","6","999","2087","219.155625","0.0028490231249999995","49171.80937500002","0.6392335218749992"
"219","999","992","2","994","2089","218.05875000000003","0.00283476375","49389.868125000015","0.6420682856249992"
"220","994","992","6","998","2095","218.93625","0.0028461712499999996","49608.804375000014","0.6449144568749992"
"221","998","996","6","1002","2101","219.81374999999994","0.002857578749999999","49828.618125000015","0.6477720356249992"
"222","1002","995","5","1000","2106","219.375","0.002851875","50047.993125000015","0.6506239106249991"
"223","1000","995","4","999","2110","219.155625","0.0028490231249999995","50267.148750000015","0.6534729337499992"
"224","999","996","3","999","2113","219.155625","0.0028490231249999995","50486.304375000014","0.6563219568749992"
"225","999","991","3","994","2116","218.05875000000003","0.00283476375","50704.36312500001","0.6591567206249992"
"226","994","987","9","996","2125","218.4975","0.0028404675","50922.86062500001","0.6619971881249992"
"227","996","989","5","994","2130","218.05875000000003","0.00283476375","51140.919375000005","0.6648319518749992"
"228","994","992","5","997","2135","218.716875","0.0028433193749999998","51359.63625","0.6676752712499993"
"229","997","996","5","1001","2140","219.594375","0.002854726875","51579.230625000004","0.6705299981249992"
"230","1001","999","6","1005","2146","220.471875","0.002866134375","51799.70250000001","0.6733961324999993"
"231","1005","997","5","1002","2151","219.81374999999994","0.002857578749999999","52019.51625000001","0.6762537112499993"
"232","1002","997","9","1006","2160","220.69125","0.00286898625","52240.20750000001","0.6791226974999993"
"233","1006","1002","9","1011","2169","221.788125","0.002883245625","52461.99562500001","0.6820059431249993"
"234","1011","1003","4","1007","2173","220.91062499999998","0.0028718381249999998","52682.90625000001","0.6848777812499993"
"235","1007","1000","4","1004","2177","220.2525","0.0028632824999999997","52903.15875000001","0.6877410637499993"
"236","1004","1003","5","1008","2182","221.13","0.0028746899999999996","53124.28875000001","0.6906157537499993"
"237","1008","1007","1","1008","2183","221.13","0.0028746899999999996","53345.418750000004","0.6934904437499992"
"238","1008","1000","1","1001","2184","219.594375","0.002854726875","53565.013125000005","0.6963451706249992"
"239","1001","998","1","999","2185","219.155625","0.0028490231249999995","53784.168750000004","0.6991941937499992"
"240","999","994","4","998","2189","218.93625","0.0028461712499999996","54003.105","0.7020403649999992"
"241","998","995","9","1004","2198","220.2525","0.0028632824999999997","54223.357500000006","0.7049036474999992"
"242","1004","996","3","999","2201","219.155625","0.0028490231249999995","54442.513125000005","0.7077526706249992"
"243","999","990","9","999","2210","219.155625","0.0028490231249999995","54661.668750000004","0.7106016937499993"
"244","999","995","2","997","2212","218.716875","0.0028433193749999998","54880.385625","0.7134450131249993"
"245","997","994","6","1000","2218","219.375","0.002851875","55099.760625","0.7162968881249993"
"246","1000","999","3","1002","2221","219.81374999999994","0.002857578749999999","55319.574375000004","0.7191544668749993"
"247","1002","997","8","1005","2229","220.471875","0.002866134375","55540.04625000001","0.7220206012499993"
"248","1005","998","7","1005","2236","220.471875","0.002866134375","55760.51812500001","0.7248867356249994"
"249","1005","997","8","1005","2244","220.471875","0.002866134375","55980.99000000001","0.7277528699999994"
"250","1005","1001","9","1010","2253","221.56875","0.00288039375","56202.55875000001","0.7306332637499995"
"251","1010","1009","3","1012","2256","222.0075","0.0028860974999999995","56424.56625000001","0.7335193612499995"
"252","1012","1007","8","1015","2264","222.665625","0.002894653125","56647.23187500001","0.7364140143749995"
"253","1015","1011","6","1017","2270","223.10437499999998","0.0029003568749999993","56870.336250000015","0.7393143712499995"
"254","1017","1014","6","1020","2276","223.7625","0.0029089124999999998","57094.09875000001","0.7422232837499996"
"255","1020","1019","1","1020","2277","223.7625","0.0029089124999999998","57317.86125000001","0.7451321962499996"
"256","1020","1018","9","1027","2286","225.29812499999994","0.002928875624999999","57543.15937500001","0.7480610718749996"
"257","1027","1022","9","1031","2295","226.175625","0.0029402831249999996","57769.335000000014","0.7510013549999996"
"258","1031","1028","6","1034","2301","226.83375","0.00294883875","57996.16875000001","0.7539501937499996"
"259","1034","1033","8","1041","2309","228.36937500000002","0.002968801875","58224.538125000014","0.7569189956249996"
"260","1041","1036","4","1040","2313","228.15","0.0029659499999999997","58452.688125000015","0.7598849456249996"
"261","1040","1032","3","1035","2316","227.053125","0.0029516906249999995","58679.741250000014","0.7628366362499996"
"262","1035","1033","5","1038","2321","227.71124999999998","0.0029602462499999996","58907.452500000014","0.7657968824999997"
"263","1038","1034","8","1042","2329","228.58874999999998","0.0029716537499999995","59136.04125000002","0.7687685362499996"
"264","1042","1040","8","1048","2337","229.905","0.002988765","59365.946250000015","0.7717573012499996"
"265","1048","1039","3","1042","2340","228.58874999999998","0.0029716537499999995","59594.53500000002","0.7747289549999996"
"266","1042","1034","4","1038","2344","227.71124999999998","0.0029602462499999996","59822.24625000002","0.7776892012499996"
"267","1038","1033","3","1036","2347","227.2725","0.0029545425","60049.51875000002","0.7806437437499997"
"268","1036","1035","9","1044","2356","229.02750000000003","0.0029773575","60278.546250000014","0.7836211012499997"
"269","1044","1043","9","1052","2365","230.78249999999994","0.003000172499999999","60509.328750000015","0.7866212737499997"
"270","1052","1044","4","1048","2369","229.905","0.002988765","60739.233750000014","0.7896100387499997"
"271","1048","1042","3","1045","2372","229.246875","0.0029802093749999995","60968.48062500001","0.7925902481249997"
"272","1045","1042","7","1049","2379","230.124375","0.0029916168749999994","61198.60500000001","0.7955818649999997"
"273","1049","1042","2","1044","2381","229.02750000000003","0.0029773575","61427.63250000001","0.7985592224999998"
"274","1044","1039","1","1040","2382","228.15","0.0029659499999999997","61655.78250000001","0.8015251724999998"
"275","1040","1038","8","1046","2390","229.46625","0.00298306125","61885.248750000006","0.8045082337499998"
"276","1046","1043","5","1048","2395","229.905","0.002988765","62115.153750000005","0.8074969987499998"
"277","1048","1047","6","1053","2401","231.00187499999998","0.0030030243749999998","62346.15562500001","0.8105000231249998"
"278","1053","1044","5","1049","2406","230.124375","0.0029916168749999994","62576.280000000006","0.8134916399999998"
"279","1049","1041","4","1045","2410","229.246875","0.0029802093749999995","62805.526875","0.8164718493749998"
"280","1045","1044","6","1050","2416","230.34375","0.0029944687499999997","63035.870625","0.8194663181249998"
"281","1050","1049","9","1058","2425","232.09875","0.0030172837499999995","63267.969375","0.8224836018749998"
"282","1058","1055","8","1063","2433","233.19562499999998","0.0030315431249999993","63501.165","0.8255151449999998"
"283","1063","1061","1","1062","2434","232.97625","0.00302869125","63734.14125","0.8285438362499998"
"284","1062","1060","5","1065","2439","233.634375","0.003037246875","63967.775625","0.8315810831249998"
"285","1065","1063","8","1071","2447","234.950625","0.003054358125","64202.72625","0.8346354412499998"
"286","1071","1064","6","1070","2453","234.73125","0.0030515062499999997","64437.4575","0.8376869474999997"
"287","1070","1065","5","1070","2458","234.73125","0.0030515062499999997","64672.188749999994","0.8407384537499997"
"288","1070","1069","9","1078","2467","236.48624999999998","0.0030743212499999995","64908.674999999996","0.8438127749999996"
"289","1078","1073","5","1078","2472","236.48624999999998","0.0030743212499999995","65145.16125","0.8468870962499996"
"290","1078","1070","9","1079","2481","236.705625","0.003077173125","65381.866875","0.8499642693749996"
"291","1079","1078","8","1086","2489","238.24125","0.0030971362499999998","65620.108125","0.8530614056249995"
"292","1086","1081","7","1088","2496","238.67999999999998","0.0031028399999999995","65858.78812499999","0.8561642456249996"
"293","1088","1083","6","1089","2502","238.89937500000002","0.0031056918750000002","66097.68749999999","0.8592699374999996"
"294","1089","1085","1","1086","2503","238.24125","0.0030971362499999998","66335.92874999999","0.8623670737499995"
"295","1086","1082","9","1091","2512","239.33812500000002","0.003111395625","66575.26687499999","0.8654784693749995"
"296","1091","1087","6","1093","2518","239.776875","0.0031170993749999997","66815.04374999998","0.8685955687499995"
"297","1093","1091","4","1095","2522","240.215625","0.0031228031249999995","67055.25937499998","0.8717183718749996"
"298","1095","1093","6","1099","2528","241.093125","0.003134210625","67296.35249999998","0.8748525824999995"
"299","1099","1092","2","1094","2530","239.99625000000003","0.00311995125","67536.34874999998","0.8779725337499995"
"300","1094","1093","6","1099","2536","241.093125","0.003134210625","67777.44187499997","0.8811067443749995"
"301","1099","1098","4","1102","2540","241.75125","0.00314276625","68019.19312499998","0.8842495106249995"
"302","1102","1095","8","1103","2548","241.97062499999998","0.0031456181249999997","68261.16374999998","0.8873951287499995"
"303","1103","1100","7","1107","2555","242.84812499999998","0.0031570256249999996","68504.01187499998","0.8905521543749995"
"304","1107","1106","5","1111","2560","243.725625","0.003168433125","68747.73749999999","0.8937205874999995"
"305","1111","1106","3","1109","2563","243.286875","0.0031627293749999998","68991.024375","0.8968833168749994"
"306","1109","1102","5","1107","2568","242.84812499999998","0.0031570256249999996","69233.8725","0.9000403424999994"
"307","1107","1103","6","1109","2574","243.286875","0.0031627293749999998","69477.159375","0.9032030718749994"
"308","1109","1101","9","1110","2583","243.50625","0.0031655812499999996","69720.66562500001","0.9063686531249994"
"309","1110","1109","2","1111","2585","243.725625","0.003168433125","69964.39125000002","0.9095370862499994"
"310","1111","1105","2","1107","2587","242.84812499999998","0.0031570256249999996","70207.23937500002","0.9126941118749994"
"311","1107","1104","9","1113","2596","244.16437499999998","0.0031741368749999997","70451.40375000001","0.9158682487499994"
"312","1113","1104","1","1105","2597","242.409375","0.003151321875","70693.81312500002","0.9190195706249994"
"313","1105","1103","3","1106","2600","242.62875","0.0031541737499999997","70936.44187500002","0.9221737443749994"
"314","1106","1102","1","1103","2601","241.97062499999998","0.0031456181249999997","71178.41250000002","0.9253193624999995"
"315","1103","1094","6","1100","2607","241.3125","0.0031370624999999997","71419.72500000002","0.9284564249999995"
"316","1100","1099","8","1107","2615","242.84812499999998","0.0031570256249999996","71662.57312500002","0.9316134506249995"
"317","1107","1101","3","1104","2618","242.19","0.0031484699999999996","71904.76312500003","0.9347619206249994"
"318","1104","1096","8","1104","2626","242.19","0.0031484699999999996","72146.95312500003","0.9379103906249994"
"319","1104","1099","8","1107","2634","242.84812499999998","0.0031570256249999996","72389.80125000003","0.9410674162499993"
"320","1107","1100","4","1104","2638","242.19","0.0031484699999999996","72631.99125000004","0.9442158862499993"
"321","1104","1100","2","1102","2640","241.75125","0.00314276625","72873.74250000004","0.9473586524999993"
"322","1102","1093","2","1095","2642","240.215625","0.0031228031249999995","73113.95812500003","0.9504814556249993"
"323","1095","1089","1","1090","2643","239.11875","0.0031085437499999997","73353.07687500003","0.9535899993749993"
"324","1090","1084","3","1087","2646","238.460625","0.0030999881249999996","73591.53750000003","0.9566899874999993"
"325","1087","1086","6","1092","2652","239.55749999999998","0.0031142474999999994","73831.09500000003","0.9598042349999993"
"326","1092","1084","3","1087","2655","238.460625","0.0030999881249999996","74069.55562500004","0.9629042231249993"
"327","1087","1085","9","1094","2664","239.99625000000003","0.00311995125","74309.55187500003","0.9660241743749993"
"328","1094","1089","4","1093","2668","239.776875","0.0031170993749999997","74549.32875000003","0.9691412737499994"
"329","1093","1092","4","1096","2672","240.435","0.0031256549999999998","74789.76375000003","0.9722669287499993"
"330","1096","1093","6","1099","2678","241.093125","0.003134210625","75030.85687500003","0.9754011393749993"
"331","1099","1098","3","1101","2681","241.531875","0.003139914375","75272.38875000003","0.9785410537499993"
"332","1101","1096","8","1104","2689","242.19","0.0031484699999999996","75514.57875000003","0.9816895237499993"
"333","1104","1102","7","1109","2696","243.286875","0.0031627293749999998","75757.86562500003","0.9848522531249992"
"334","1109","1107","1","1108","2697","243.0675","0.0031598775","76000.93312500004","0.9880121306249993"
"335","1108","1100","2","1102","2699","241.75125","0.00314276625","76242.68437500004","0.9911548968749992"
"336","1102","1095","6","1101","2705","241.531875","0.003139914375","76484.21625000004","0.9942948112499993"
"337","1101","1095","8","1103","2713","241.97062499999998","0.0031456181249999997","76726.18687500004","0.9974404293749993"
"338","1103","1095","4","1099","2717","241.093125","0.003134210625","76967.28000000004","1.0005746399999993"
"339","1099","1091","3","1094","2720","239.99625000000003","0.00311995125","77207.27625000004","1.0036945912499993"
"340","1094","1085","3","1088","2723","238.67999999999998","0.0031028399999999995","77445.95625000003","1.0067974312499992"
"341","1088","1080","3","1083","2726","237.583125","0.0030885806249999997","77683.53937500004","1.0098860118749993"
"342","1083","1076","6","1082","2732","237.36374999999998","0.0030857287499999994","77920.90312500004","1.0129717406249992"
"343","1082","1079","9","1088","2741","238.67999999999998","0.0031028399999999995","78159.58312500003","1.0160745806249991"
"344","1088","1087","1","1088","2742","238.67999999999998","0.0031028399999999995","78398.26312500003","1.019177420624999"
"345","1088","1082","9","1091","2751","239.33812500000002","0.003111395625","78637.60125000002","1.022288816249999"
"346","1091","1086","1","1087","2752","238.460625","0.0030999881249999996","78876.06187500003","1.025388804374999"
"347","1087","1083","6","1089","2758","238.89937500000002","0.0031056918750000002","79114.96125000002","1.0284944962499991"
"348","1089","1087","3","1090","2761","239.11875","0.0031085437499999997","79354.08000000002","1.0316030399999991"
"349","1090","1086","5","1091","2766","239.33812500000002","0.003111395625","79593.41812500001","1.034714435624999"
"350","1091","1082","9","1091","2775","239.33812500000002","0.003111395625","79832.75625","1.037825831249999"
"351","1091","1088","5","1093","2780","239.776875","0.0031170993749999997","80072.533125","1.040942930624999"
"352","1093","1092","7","1099","2787","241.093125","0.003134210625","80313.62625","1.0440771412499992"
"353","1099","1091","3","1094","2790","239.99625000000003","0.00311995125","80553.6225","1.0471970924999991"
"354","1094","1085","7","1092","2797","239.55749999999998","0.0031142474999999994","80793.18","1.050311339999999"
"355","1092","1087","2","1089","2799","238.89937500000002","0.0031056918750000002","81032.07937499999","1.0534170318749991"
"356","1089","1084","7","1091","2806","239.33812500000002","0.003111395625","81271.41749999998","1.056528427499999"
"357","1091","1088","6","1094","2812","239.99625000000003","0.00311995125","81511.41374999998","1.059648378749999"
"358","1094","1090","7","1097","2819","240.654375","0.0031285068749999996","81752.06812499998","1.062776885624999"
"359","1097","1088","5","1093","2824","239.776875","0.0031170993749999997","81991.84499999997","1.065893984999999"
"360","1093","1085","7","1092","2831","239.55749999999998","0.0031142474999999994","82231.40249999997","1.069008232499999"
"361","1092","1085","5","1090","2836","239.11875","0.0031085437499999997","82470.52124999996","1.072116776249999"
"362","1090","1084","5","1089","2841","238.89937500000002","0.0031056918750000002","82709.42062499996","1.075222468124999"
"363","1089","1082","8","1090","2849","239.11875","0.0031085437499999997","82948.53937499995","1.0783310118749991"
"364","1090","1085","2","1087","2851","238.460625","0.0030999881249999996","83186.99999999996","1.0814309999999991"
"365","1087","1085","8","1093","2859","239.776875","0.0031170993749999997","83426.77687499995","1.0845480993749992"
"366","1093","1085","5","1090","2864","239.11875","0.0031085437499999997","83665.89562499995","1.0876566431249992"
"367","1090","1089","4","1093","2868","239.776875","0.0031170993749999997","83905.67249999994","1.0907737424999993"
"368","1093","1091","7","1098","2875","240.87375","0.00313135875","84146.54624999994","1.0939051012499992"
"369","1098","1091","2","1093","2877","239.776875","0.0031170993749999997","84386.32312499994","1.0970222006249992"
"370","1093","1092","7","1099","2884","241.093125","0.003134210625","84627.41624999994","1.1001564112499993"
"371","1099","1097","5","1102","2889","241.75125","0.00314276625","84869.16749999994","1.1032991774999994"
"372","1102","1095","3","1098","2892","240.87375","0.00313135875","85110.04124999994","1.1064305362499993"
"373","1098","1089","1","1090","2893","239.11875","0.0031085437499999997","85349.15999999993","1.1095390799999993"
"374","1090","1081","2","1083","2895","237.583125","0.0030885806249999997","85586.74312499994","1.1126276606249994"
"375","1083","1077","8","1085","2903","238.021875","0.003094284375","85824.76499999994","1.1157219449999993"
"376","1085","1084","6","1090","2909","239.11875","0.0031085437499999997","86063.88374999994","1.1188304887499994"
"377","1090","1089","7","1096","2916","240.435","0.0031256549999999998","86304.31874999993","1.1219561437499994"
"378","1096","1094","7","1101","2923","241.531875","0.003139914375","86545.85062499993","1.1250960581249994"
"379","1101","1096","1","1097","2924","240.654375","0.0031285068749999996","86786.50499999993","1.1282245649999993"
"380","1097","1096","2","1098","2926","240.87375","0.00313135875","87027.37874999993","1.1313559237499993"
"381","1098","1095","9","1104","2935","242.19","0.0031484699999999996","87269.56874999993","1.1345043937499992"
"382","1104","1097","4","1101","2939","241.531875","0.003139914375","87511.10062499993","1.1376443081249992"
"383","1101","1098","8","1106","2947","242.62875","0.0031541737499999997","87753.72937499994","1.1407984818749992"
"384","1106","1103","8","1111","2955","243.725625","0.003168433125","87997.45499999994","1.1439669149999991"
"385","1111","1106","3","1109","2958","243.286875","0.0031627293749999998","88240.74187499995","1.1471296443749992"
"386","1109","1105","9","1114","2967","244.38375000000002","0.00317698875","88485.12562499994","1.1503066331249991"
"387","1114","1105","8","1113","2975","244.16437499999998","0.0031741368749999997","88729.28999999994","1.1534807699999992"
"388","1113","1111","6","1117","2981","245.04187499999998","0.0031855443749999996","88974.33187499993","1.1566663143749991"
"389","1117","1108","9","1117","2990","245.04187499999998","0.0031855443749999996","89219.37374999993","1.159851858749999"
"390","1117","1112","7","1119","2997","245.48062500000003","0.003191248125","89464.85437499992","1.1630431068749991"
"391","1119","1116","5","1121","3002","245.919375","0.003196951875","89710.77374999992","1.166240058749999"
"392","1121","1112","1","1113","3003","244.16437499999998","0.0031741368749999997","89954.93812499991","1.169414195624999"
"393","1113","1105","4","1109","3007","243.286875","0.0031627293749999998","90198.22499999992","1.172576924999999"
"394","1109","1108","9","1117","3016","245.04187499999998","0.0031855443749999996","90443.26687499991","1.175762469374999"
"395","1117","1114","8","1122","3024","246.13875","0.00319980375","90689.40562499991","1.1789622731249991"
"396","1122","1117","2","1119","3026","245.48062500000003","0.003191248125","90934.88624999991","1.1821535212499992"
"397","1119","1117","5","1122","3031","246.13875","0.00319980375","91181.0249999999","1.1853533249999992"
"398","1122","1119","3","1122","3034","246.13875","0.00319980375","91427.1637499999","1.1885531287499993"
"399","1122","1114","4","1118","3038","245.26125","0.0031883962499999995","91672.4249999999","1.1917415249999992"
"400","1118","1109","6","1115","3044","244.603125","0.003179840625","91917.0281249999","1.1949213656249993"
"401","1115","1107","8","1115","3052","244.603125","0.003179840625","92161.63124999989","1.1981012062499994"
"402","1115","1108","4","1112","3056","243.945","0.003171285","92405.5762499999","1.2012724912499995"
"403","1112","1111","4","1115","3060","244.603125","0.003179840625","92650.17937499989","1.2044523318749996"
"404","1115","1109","6","1115","3066","244.603125","0.003179840625","92894.78249999988","1.2076321724999997"
"405","1115","1106","7","1113","3073","244.16437499999998","0.0031741368749999997","93138.94687499988","1.2108063093749997"
"406","1113","1107","8","1115","3081","244.603125","0.003179840625","93383.54999999987","1.2139861499999998"
"407","1115","1114","8","1122","3089","246.13875","0.00319980375","93629.68874999987","1.2171859537499998"
"408","1122","1121","2","1123","3091","246.358125","0.0032026556249999997","93876.04687499987","1.2203886093749998"
"409","1123","1120","2","1122","3093","246.13875","0.00319980375","94122.18562499987","1.2235884131249999"
"410","1122","1114","7","1121","3100","245.919375","0.003196951875","94368.10499999986","1.2267853649999998"
"411","1121","1117","1","1118","3101","245.26125","0.0031883962499999995","94613.36624999986","1.2299737612499997"
"412","1118","1114","4","1118","3105","245.26125","0.0031883962499999995","94858.62749999986","1.2331621574999996"
"413","1118","1115","4","1119","3109","245.48062500000003","0.003191248125","95104.10812499985","1.2363534056249996"
"414","1119","1115","7","1122","3116","246.13875","0.00319980375","95350.24687499985","1.2395532093749997"
"415","1122","1117","2","1119","3118","245.48062500000003","0.003191248125","95595.72749999985","1.2427444574999997"
"416","1119","1110","1","1111","3119","243.725625","0.003168433125","95839.45312499985","1.2459128906249997"
"417","1111","1105","5","1110","3124","243.50625","0.0031655812499999996","96082.95937499986","1.2490784718749997"
"418","1110","1106","7","1113","3131","244.16437499999998","0.0031741368749999997","96327.12374999985","1.2522526087499997"
"419","1113","1109","7","1116","3138","244.82250000000002","0.0031826925","96571.94624999985","1.2554353012499997"
"420","1116","1114","8","1122","3146","246.13875","0.00319980375","96818.08499999985","1.2586351049999998"
"421","1122","1118","2","1120","3148","245.7","0.0031940999999999996","97063.78499999984","1.2618292049999997"
"422","1120","1113","9","1122","3157","246.13875","0.00319980375","97309.92374999984","1.2650290087499998"
"423","1122","1120","1","1121","3158","245.919375","0.003196951875","97555.84312499984","1.2682259606249997"
"424","1121","1113","5","1118","3163","245.26125","0.0031883962499999995","97801.10437499984","1.2714143568749996"
"425","1118","1109","8","1117","3171","245.04187499999998","0.0031855443749999996","98046.14624999983","1.2745999012499996"
"426","1117","1110","9","1119","3180","245.48062500000003","0.003191248125","98291.62687499983","1.2777911493749996"
"427","1119","1113","8","1121","3188","245.919375","0.003196951875","98537.54624999982","1.2809881012499995"
"428","1121","1119","5","1124","3193","246.5775","0.0032055074999999995","98784.12374999982","1.2841936087499994"
"429","1124","1123","7","1130","3200","247.89375","0.00322261875","99032.01749999983","1.2874162274999994"
"430","1130","1127","7","1134","3207","248.77125","0.00323402625","99280.78874999983","1.2906502537499993"
"431","1134","1130","3","1133","3210","248.551875","0.0032311743749999997","99529.34062499984","1.2938814281249993"
"432","1133","1127","4","1131","3214","248.113125","0.003225470625","99777.45374999984","1.2971068987499992"
"433","1131","1128","8","1136","3222","249.21","0.0032397299999999997","100026.66374999985","1.3003466287499992"
"434","1136","1135","4","1139","3226","249.86812500000002","0.003248285625","100276.53187499984","1.3035949143749992"
"435","1139","1131","2","1133","3228","248.551875","0.0032311743749999997","100525.08374999985","1.3068260887499992"
"436","1133","1127","6","1133","3234","248.551875","0.0032311743749999997","100773.63562499985","1.3100572631249991"
"437","1133","1126","4","1130","3238","247.89375","0.00322261875","101021.52937499985","1.313279881874999"
"438","1130","1121","3","1124","3241","246.5775","0.0032055074999999995","101268.10687499985","1.316485389374999"
"439","1124","1121","4","1125","3245","246.796875","0.003208359375","101514.90374999985","1.3196937487499991"
"440","1125","1122","8","1130","3253","247.89375","0.00322261875","101762.79749999986","1.322916367499999"
"441","1130","1127","4","1131","3257","248.113125","0.003225470625","102010.91062499986","1.326141838124999"
"442","1131","1126","2","1128","3259","247.45499999999998","0.0032169149999999994","102258.36562499986","1.329358753124999"
"443","1128","1122","9","1131","3268","248.113125","0.003225470625","102506.47874999986","1.332584223749999"
"444","1131","1127","7","1134","3275","248.77125","0.00323402625","102755.24999999987","1.3358182499999989"
"445","1134","1127","2","1129","3277","247.674375","0.0032197668749999997","103002.92437499987","1.339038016874999"
"446","1129","1120","8","1128","3285","247.45499999999998","0.0032169149999999994","103250.37937499987","1.342254931874999"
"447","1128","1125","6","1131","3291","248.113125","0.003225470625","103498.49249999988","1.345480402499999"
"448","1131","1124","9","1133","3300","248.551875","0.0032311743749999997","103747.04437499988","1.3487115768749989"
"449","1133","1129","1","1130","3301","247.89375","0.00322261875","103994.93812499988","1.3519341956249988"
"450","1130","1122","9","1131","3310","248.113125","0.003225470625","104243.05124999989","1.3551596662499987"
"451","1131","1130","1","1131","3311","248.113125","0.003225470625","104491.16437499989","1.3583851368749986"
"452","1131","1126","7","1133","3318","248.551875","0.0032311743749999997","104739.7162499999","1.3616163112499986"
"453","1133","1130","3","1133","3321","248.551875","0.0032311743749999997","104988.2681249999","1.3648474856249986"
"454","1133","1131","2","1133","3323","248.551875","0.0032311743749999997","105236.8199999999","1.3680786599999986"
"455","1133","1124","9","1133","3332","248.551875","0.0032311743749999997","105485.37187499991","1.3713098343749985"
"456","1133","1127","9","1136","3341","249.21","0.0032397299999999997","105734.58187499992","1.3745495643749985"
"457","1136","1129","7","1136","3348","249.21","0.0032397299999999997","105983.79187499992","1.3777892943749985"
"458","1136","1135","5","1140","3353","250.0875","0.0032511375","106233.87937499992","1.3810404318749985"
"459","1140","1138","8","1146","3361","251.40375","0.0032682487499999997","106485.28312499991","1.3843086806249985"
"460","1146","1140","1","1141","3362","250.30687500000002","0.003253989375","106735.58999999991","1.3875626699999986"
"461","1141","1132","8","1140","3370","250.0875","0.0032511375","106985.6774999999","1.3908138074999985"
"462","1140","1136","9","1145","3379","251.184375","0.003265396875","107236.8618749999","1.3940792043749985"
"463","1145","1144","7","1151","3386","252.500625","0.003282508125","107489.3624999999","1.3973617124999986"
"464","1151","1142","8","1150","3394","252.28125","0.0032796562499999996","107741.6437499999","1.4006413687499986"
"465","1150","1148","1","1149","3395","252.061875","0.0032768043749999997","107993.7056249999","1.4039181731249986"
"466","1149","1142","3","1145","3398","251.184375","0.003265396875","108244.8899999999","1.4071835699999986"
"467","1145","1139","3","1142","3401","250.52624999999998","0.0032568412499999993","108495.4162499999","1.4104404112499986"
"468","1142","1141","1","1142","3402","250.52624999999998","0.0032568412499999993","108745.94249999989","1.4136972524999987"
"469","1142","1139","5","1144","3407","250.96500000000003","0.0032625450000000004","108996.90749999988","1.4169597974999986"
"470","1144","1137","3","1140","3410","250.0875","0.0032511375","109246.99499999988","1.4202109349999985"
"471","1140","1136","5","1141","3415","250.30687500000002","0.003253989375","109497.30187499987","1.4234649243749986"
"472","1141","1137","6","1143","3421","250.745625","0.0032596931249999996","109748.04749999987","1.4267246174999986"
"473","1143","1136","9","1145","3430","251.184375","0.003265396875","109999.23187499987","1.4299900143749986"
"474","1145","1142","4","1146","3434","251.40375","0.0032682487499999997","110250.63562499986","1.4332582631249986"
"475","1146","1141","4","1145","3438","251.184375","0.003265396875","110501.81999999986","1.4365236599999986"
"476","1145","1137","7","1144","3445","250.96500000000003","0.0032625450000000004","110752.78499999986","1.4397862049999985"
"477","1144","1141","3","1144","3448","250.96500000000003","0.0032625450000000004","111003.74999999985","1.4430487499999984"
"478","1144","1138","2","1140","3450","250.0875","0.0032511375","111253.83749999985","1.4462998874999984"
"479","1140","1133","6","1139","3456","249.86812500000002","0.003248285625","111503.70562499984","1.4495481731249984"
"480","1139","1132","5","1137","3461","249.429375","0.0032425818749999996","111753.13499999985","1.4527907549999983"
"481","1137","1133","1","1134","3462","248.77125","0.00323402625","112001.90624999985","1.4560247812499982"
"482","1134","1132","2","1134","3464","248.77125","0.00323402625","112250.67749999986","1.4592588074999981"
"483","1134","1125","5","1130","3469","247.89375","0.00322261875","112498.57124999986","1.462481426249998"
"484","1130","1127","6","1133","3475","248.551875","0.0032311743749999997","112747.12312499987","1.465712600624998"
"485","1133","1124","9","1133","3484","248.551875","0.0032311743749999997","112995.67499999987","1.468943774999998"
"486","1133","1124","1","1125","3485","246.796875","0.003208359375","113242.47187499987","1.4721521343749981"
"487","1125","1122","6","1128","3491","247.45499999999998","0.0032169149999999994","113489.92687499987","1.4753690493749982"
"488","1128","1127","5","1132","3496","248.33249999999998","0.0032283224999999994","113738.25937499988","1.4785973718749983"
"489","1132","1128","9","1137","3505","249.429375","0.0032425818749999996","113987.68874999988","1.4818399537499982"
"490","1137","1130","5","1135","3510","248.990625","0.003236878125","114236.67937499989","1.4850768318749983"
"491","1135","1128","8","1136","3518","249.21","0.0032397299999999997","114485.8893749999","1.4883165618749983"
"492","1136","1130","6","1136","3524","249.21","0.0032397299999999997","114735.0993749999","1.4915562918749983"
"493","1136","1127","6","1133","3530","248.551875","0.0032311743749999997","114983.65124999991","1.4947874662499983"
"494","1133","1126","4","1130","3534","247.89375","0.00322261875","115231.54499999991","1.4980100849999982"
"495","1130","1125","8","1133","3542","248.551875","0.0032311743749999997","115480.09687499992","1.5012412593749982"
"496","1133","1130","7","1137","3549","249.429375","0.0032425818749999996","115729.52624999992","1.5044838412499981"
"497","1137","1136","3","1139","3552","249.86812500000002","0.003248285625","115979.39437499992","1.5077321268749981"
"498","1139","1138","9","1147","3561","251.623125","0.0032711006249999995","116231.01749999991","1.511003227499998"
"499","1147","1144","9","1153","3570","252.93937499999998","0.0032882118749999996","116483.95687499992","1.514291439374998"
"500","1153","1146","9","1155","3579","253.378125","0.003293915625","116737.33499999992","1.517585354999998"
"501","1155","1146","2","1148","3581","251.8425","0.0032739525","116989.17749999992","1.520859307499998"
"502","1148","1146","7","1153","3588","252.93937499999998","0.0032882118749999996","117242.11687499992","1.524147519374998"
"503","1153","1150","9","1159","3597","254.255625","0.0033053231249999997","117496.37249999992","1.527452842499998"
"504","1159","1157","8","1165","3605","255.571875","0.0033224343749999998","117751.94437499992","1.530775276874998"
"505","1165","1164","1","1165","3606","255.571875","0.0033224343749999998","118007.51624999991","1.534097711249998"
"506","1165","1164","5","1169","3611","256.44937500000003","0.003333841875","118263.96562499991","1.537431553124998"
"507","1169","1160","9","1169","3620","256.44937500000003","0.003333841875","118520.4149999999","1.540765394999998"
"508","1169","1162","3","1165","3623","255.571875","0.0033224343749999998","118775.9868749999","1.544087829374998"
"509","1165","1156","9","1165","3632","255.571875","0.0033224343749999998","119031.5587499999","1.547410263749998"
"510","1165","1159","2","1161","3634","254.694375","0.003311026875","119286.2531249999","1.550721290624998"
"511","1161","1158","8","1166","3642","255.79125000000002","0.00332528625","119542.0443749999","1.554046576874998"
"512","1166","1163","1","1164","3643","255.35250000000002","0.0033195825","119797.39687499989","1.5573661593749981"
"513","1164","1160","2","1162","3645","254.91375","0.0033138787499999997","120052.3106249999","1.5606800381249981"
"514","1162","1160","4","1164","3649","255.35250000000002","0.0033195825","120307.66312499989","1.5639996206249982"
"515","1164","1163","9","1172","3658","257.1075","0.0033423975","120564.77062499989","1.5673420181249982"
"516","1172","1167","6","1173","3664","257.326875","0.0033452493749999996","120822.09749999989","1.570687267499998"
"517","1173","1164","9","1173","3673","257.326875","0.0033452493749999996","121079.42437499989","1.574032516874998"
"518","1173","1164","3","1167","3676","256.010625","0.003328138125","121335.43499999988","1.5773606549999981"
"519","1167","1164","2","1166","3678","255.79125000000002","0.00332528625","121591.22624999988","1.580685941249998"
"520","1166","1160","5","1165","3683","255.571875","0.0033224343749999998","121846.79812499987","1.584008375624998"
"521","1165","1162","8","1170","3691","256.66875","0.0033366937499999996","122103.46687499987","1.587345069374998"
"522","1170","1168","5","1173","3696","257.326875","0.0033452493749999996","122360.79374999987","1.590690318749998"
"523","1173","1167","7","1174","3703","257.54625","0.0033481012499999995","122618.33999999987","1.594038419999998"
"524","1174","1171","5","1176","3708","257.985","0.003353805","122876.32499999987","1.597392224999998"
"525","1176","1172","4","1176","3712","257.985","0.003353805","123134.30999999987","1.6007460299999978"
"526","1176","1174","7","1181","3719","259.08187499999997","0.0033680643749999994","123393.39187499987","1.6041140943749979"
"527","1181","1174","5","1179","3724","258.643125","0.0033623606249999997","123652.03499999987","1.6074764549999978"
"528","1179","1178","8","1186","3732","260.17875","0.0033823237499999996","123912.21374999988","1.6108587787499977"
"529","1186","1179","5","1184","3737","259.74","0.00337662","124171.95374999988","1.6142353987499978"
"530","1184","1175","5","1180","3742","258.8625","0.0033652125","124430.81624999989","1.6176006112499979"
"531","1180","1179","7","1186","3749","260.17875","0.0033823237499999996","124690.9949999999","1.6209829349999978"
"532","1186","1185","1","1186","3750","260.17875","0.0033823237499999996","124951.1737499999","1.6243652587499977"
"533","1186","1185","7","1192","3757","261.495","0.0033994349999999997","125212.6687499999","1.6277646937499977"
"534","1192","1186","6","1192","3763","261.495","0.0033994349999999997","125474.16374999989","1.6311641287499976"
"535","1192","1187","4","1191","3767","261.275625","0.003396583125","125735.43937499989","1.6345607118749976"
"536","1191","1188","5","1193","3772","261.71437499999996","0.003402286874999999","125997.15374999988","1.6379629987499977"
"537","1193","1188","2","1190","3774","261.05625","0.0033937312499999995","126258.20999999988","1.6413567299999978"
"538","1190","1186","7","1193","3781","261.71437499999996","0.003402286874999999","126519.92437499987","1.644759016874998"
"539","1193","1185","1","1186","3782","260.17875","0.0033823237499999996","126780.10312499988","1.6481413406249978"
"540","1186","1179","9","1188","3791","260.61749999999995","0.0033880274999999994","127040.72062499987","1.6515293681249978"
"541","1188","1187","6","1193","3797","261.71437499999996","0.003402286874999999","127302.43499999987","1.654931654999998"
"542","1193","1186","3","1189","3800","260.836875","0.003390879375","127563.27187499986","1.6583225343749979"
"543","1189","1188","9","1197","3809","262.591875","0.003413694375","127825.86374999986","1.661736228749998"
"544","1197","1195","8","1203","3817","263.908125","0.0034308056249999996","128089.77187499986","1.665167034374998"
"545","1203","1197","9","1206","3826","264.56624999999997","0.0034393612499999996","128354.33812499986","1.6686063956249981"
"546","1206","1200","3","1203","3829","263.908125","0.0034308056249999996","128618.24624999987","1.6720372012499982"
"547","1203","1196","2","1198","3831","262.81125","0.0034165462499999993","128881.05749999986","1.6754537474999982"
"548","1198","1195","5","1200","3836","263.25","0.00342225","129144.30749999986","1.6788759974999983"
"549","1200","1195","5","1200","3841","263.25","0.00342225","129407.55749999986","1.6822982474999983"
"550","1200","1199","5","1204","3846","264.1275","0.0034336575","129671.68499999987","1.6857319049999984"
"551","1204","1198","6","1204","3852","264.1275","0.0034336575","129935.81249999987","1.6891655624999984"
"552","1204","1196","3","1199","3855","263.030625","0.0034193981249999996","130198.84312499987","1.6925849606249983"
"553","1199","1192","3","1195","3858","262.153125","0.0034079906249999997","130460.99624999987","1.6959929512499983"
"554","1195","1187","3","1190","3861","261.05625","0.0033937312499999995","130722.05249999986","1.6993866824999984"
"555","1190","1182","1","1183","3862","259.520625","0.0033737681249999996","130981.57312499986","1.7027604506249983"
"556","1183","1181","5","1186","3867","260.17875","0.0033823237499999996","131241.75187499987","1.7061427743749982"
"557","1186","1182","2","1184","3869","259.74","0.00337662","131501.49187499986","1.7095193943749982"
"558","1184","1175","2","1177","3871","258.20437499999997","0.0033566568749999995","131759.69624999986","1.7128760512499983"
"559","1177","1175","9","1184","3880","259.74","0.00337662","132019.43624999985","1.7162526712499984"
"560","1184","1179","6","1185","3886","259.959375","0.003379471875","132279.39562499986","1.7196321431249983"
"561","1185","1184","8","1192","3894","261.495","0.0033994349999999997","132540.89062499985","1.7230315781249983"
"562","1192","1191","1","1192","3895","261.495","0.0033994349999999997","132802.38562499985","1.7264310131249982"
"563","1192","1189","9","1198","3904","262.81125","0.0034165462499999993","133065.19687499985","1.7298475593749982"
"564","1198","1190","5","1195","3909","262.153125","0.0034079906249999997","133327.34999999986","1.7332555499999982"
"565","1195","1190","2","1192","3911","261.495","0.0033994349999999997","133588.84499999986","1.7366549849999982"
"566","1192","1189","1","1190","3912","261.05625","0.0033937312499999995","133849.90124999985","1.7400487162499982"
"567","1190","1187","2","1189","3914","260.836875","0.003390879375","134110.73812499986","1.7434395956249982"
"568","1189","1180","1","1181","3915","259.08187499999997","0.0033680643749999994","134369.81999999986","1.7468076599999982"
"569","1181","1175","3","1178","3918","258.42375","0.0033595087499999994","134628.24374999985","1.7501671687499982"
"570","1178","1176","6","1182","3924","259.30125","0.0033709162499999997","134887.54499999984","1.7535380849999982"
"571","1182","1176","6","1182","3930","259.30125","0.0033709162499999997","135146.84624999983","1.7569090012499982"
"572","1182","1181","9","1190","3939","261.05625","0.0033937312499999995","135407.90249999982","1.7603027324999982"
"573","1190","1186","5","1191","3944","261.275625","0.003396583125","135669.17812499983","1.7636993156249983"
"574","1191","1189","5","1194","3949","261.93375000000003","0.0034051387500000003","135931.11187499983","1.7671044543749983"
"575","1194","1188","5","1193","3954","261.71437499999996","0.003402286874999999","136192.82624999984","1.7705067412499984"
"576","1193","1186","2","1188","3956","260.61749999999995","0.0033880274999999994","136453.44374999983","1.7738947687499984"
"577","1188","1184","4","1188","3960","260.61749999999995","0.0033880274999999994","136714.06124999982","1.7772827962499984"
"578","1188","1180","2","1182","3962","259.30125","0.0033709162499999997","136973.3624999998","1.7806537124999984"
"579","1182","1178","8","1186","3970","260.17875","0.0033823237499999996","137233.5412499998","1.7840360362499983"
"580","1186","1179","8","1187","3978","260.398125","0.0033851756249999995","137493.9393749998","1.7874212118749984"
"581","1187","1183","1","1184","3979","259.74","0.00337662","137753.6793749998","1.7907978318749984"
"582","1184","1182","2","1184","3981","259.74","0.00337662","138013.4193749998","1.7941744518749985"
"583","1184","1180","9","1189","3990","260.836875","0.003390879375","138274.2562499998","1.7975653312499984"
"584","1189","1186","5","1191","3995","261.275625","0.003396583125","138535.5318749998","1.8009619143749984"
"585","1191","1184","3","1187","3998","260.398125","0.0033851756249999995","138795.92999999982","1.8043470899999985"
"586","1187","1180","1","1181","3999","259.08187499999997","0.0033680643749999994","139055.01187499982","1.8077151543749985"
"587","1181","1176","8","1184","4007","259.74","0.00337662","139314.7518749998","1.8110917743749986"
"588","1184","1179","9","1188","4016","260.61749999999995","0.0033880274999999994","139575.3693749998","1.8144798018749986"
"589","1188","1179","8","1187","4024","260.398125","0.0033851756249999995","139835.7674999998","1.8178649774999986"
"590","1187","1183","1","1184","4025","259.74","0.00337662","140095.5074999998","1.8212415974999987"
"591","1184","1181","5","1186","4030","260.17875","0.0033823237499999996","140355.6862499998","1.8246239212499986"
"592","1186","1178","3","1181","4033","259.08187499999997","0.0033680643749999994","140614.7681249998","1.8279919856249986"
"593","1181","1179","6","1185","4039","259.959375","0.003379471875","140874.7274999998","1.8313714574999986"
"594","1185","1179","6","1185","4045","259.959375","0.003379471875","141134.6868749998","1.8347509293749986"
"595","1185","1184","7","1191","4052","261.275625","0.003396583125","141395.96249999982","1.8381475124999986"
"596","1191","1187","2","1189","4054","260.836875","0.003390879375","141656.79937499983","1.8415383918749986"
"597","1189","1186","4","1190","4058","261.05625","0.0033937312499999995","141917.85562499982","1.8449321231249987"
"598","1190","1186","2","1188","4060","260.61749999999995","0.0033880274999999994","142178.47312499981","1.8483201506249987"
"599","1188","1182","8","1190","4068","261.05625","0.0033937312499999995","142439.5293749998","1.8517138818749987"
"600","1190","1183","4","1187","4072","260.398125","0.0033851756249999995","142699.92749999982","1.8550990574999988"
"601","1187","1187","10000","11187","14072","2454.148125","0.031903925625","145154.07562499982","1.8870029831249988"
"602","11187","11184","4","11188","14076","2454.3675","0.0319067775","147608.44312499982","1.9189097606249987"
"603","11188","11186","1","11187","14077","2454.148125","0.031903925625","150062.59124999982","1.9508136862499987"
"604","11187","11179","1","11180","14078","2452.6125","0.0318839625","152515.2037499998","1.9826976487499988"
"605","11180","11176","8","11184","14086","2453.49","0.03189536999999999","154968.6937499998","2.014593018749999"
"606","11184","11181","7","11188","14093","2454.3675","0.0319067775","157423.0612499998","2.046499796249999"
"607","11188","11186","6","11192","14099","2455.245","0.031918184999999995","159878.3062499998","2.078417981249999"
"608","11192","11186","5","11191","14104","2455.025625","0.031915333125","162333.3318749998","2.110333314374999"
"609","11191","11187","9","11196","14113","2456.1225000000004","0.031929592500000006","164789.4543749998","2.142262906874999"
"610","11196","11187","5","11192","14118","2455.245","0.031918184999999995","167244.6993749998","2.174181091874999"
"611","11192","11183","8","11191","14126","2455.025625","0.031915333125","169699.7249999998","2.2060964249999993"
"612","11191","11185","2","11187","14128","2454.148125","0.031903925625","172153.8731249998","2.2380003506249992"
"613","11187","11185","6","11191","14134","2455.025625","0.031915333125","174608.89874999982","2.2699156837499994"
"614","11191","11183","3","11186","14137","2453.92875","0.03190107375","177062.8274999998","2.3018167574999993"
"615","11186","11177","4","11181","14141","2452.8318750000003","0.031886814375","179515.6593749998","2.333703571874999"
"616","11181","11180","4","11184","14145","2453.49","0.03189536999999999","181969.1493749998","2.365598941874999"
"617","11184","11181","9","11190","14154","2454.80625","0.03191248125","184423.9556249998","2.397511423124999"
"618","11190","11181","8","11189","14162","2454.586875","0.031909629375","186878.5424999998","2.429421052499999"
"619","11189","11183","7","11190","14169","2454.80625","0.03191248125","189333.3487499998","2.461333533749999"
"620","11190","11181","4","11185","14173","2453.709375","0.031898221874999994","191787.0581249998","2.493231755624999"
"621","11185","11184","8","11192","14181","2455.245","0.031918184999999995","194242.3031249998","2.525149940624999"
"622","11192","11187","9","11196","14190","2456.1225000000004","0.031929592500000006","196698.4256249998","2.557079533124999"
"623","11196","11194","9","11203","14199","2457.658125","0.031949555624999994","199156.0837499998","2.589029088749999"
"624","11203","11199","7","11206","14206","2458.3162500000003","0.031958111250000004","201614.3999999998","2.6209871999999987"
"625","11206","11205","2","11207","14208","2458.535625","0.031960963125","204072.93562499978","2.6529481631249987"
"626","11207","11206","8","11214","14216","2460.07125","0.03198092625","206533.0068749998","2.684929089374999"
"627","11214","11205","4","11209","14220","2458.974375","0.031966666874999994","208991.98124999978","2.7168957562499987"
"628","11209","11200","5","11205","14225","2458.096875","0.031955259375","211450.07812499977","2.748851015624999"
"629","11205","11198","1","11199","14226","2456.780625","0.031938148124999996","213906.85874999978","2.780789163749999"
"630","11199","11191","9","11200","14235","2457.0","0.031941","216363.85874999978","2.8127301637499986"
"631","11200","11199","9","11208","14244","2458.755","0.031963815","218822.6137499998","2.8446939787499987"
"632","11208","11203","3","11206","14247","2458.3162500000003","0.031958111250000004","221280.9299999998","2.8766520899999986"
"633","11206","11205","7","11212","14254","2459.6325","0.0319752225","223740.5624999998","2.9086273124999984"
"634","11212","11207","5","11212","14259","2459.6325","0.0319752225","226200.1949999998","2.9406025349999982"
"635","11212","11204","1","11205","14260","2458.096875","0.031955259375","228658.2918749998","2.9725577943749983"
"636","11205","11199","6","11205","14266","2458.096875","0.031955259375","231116.38874999978","3.0045130537499984"
"637","11205","11204","4","11208","14270","2458.755","0.031963815","233575.14374999978","3.0364768687499986"
"638","11208","11203","5","11208","14275","2458.755","0.031963815","236033.8987499998","3.0684406837499987"
"639","11208","11201","5","11206","14280","2458.3162500000003","0.031958111250000004","238492.2149999998","3.1003987949999985"
"640","11206","11199","4","11203","14284","2457.658125","0.031949555624999994","240949.87312499978","3.1323483506249983"
"641","11203","11199","7","11206","14291","2458.3162500000003","0.031958111250000004","243408.18937499978","3.164306461874998"
"642","11206","11202","2","11204","14293","2457.8774999999996","0.031952407499999995","245866.0668749998","3.196258869374998"
"643","11204","11197","2","11199","14295","2456.780625","0.031938148124999996","248322.8474999998","3.228197017499998"
"644","11199","11195","4","11199","14299","2456.780625","0.031938148124999996","250779.6281249998","3.260135165624998"
"645","11199","11193","6","11199","14305","2456.780625","0.031938148124999996","253236.40874999983","3.2920733137499982"
"646","11199","11191","9","11200","14314","2457.0","0.031941","255693.40874999983","3.3240143137499985"
"647","11200","11197","5","11202","14319","2457.4387500000003","0.03194670375","258150.84749999983","3.3559610174999985"
"648","11202","11194","1","11195","14320","2455.903125","0.031926740625","260606.75062499984","3.3878877581249984"
"649","11195","11194","9","11203","14329","2457.658125","0.031949555624999994","263064.4087499998","3.419837313749998"
"650","11203","11199","6","11205","14335","2458.096875","0.031955259375","265522.5056249998","3.4517925731249983"
"651","11205","11201","4","11205","14339","2458.096875","0.031955259375","267980.6024999998","3.4837478324999984"
"652","11205","11200","1","11201","14340","2457.219375","0.031943851875","270437.8218749998","3.5156916843749983"
"653","11201","11199","2","11201","14342","2457.219375","0.031943851875","272895.0412499998","3.5476355362499983"
"654","11201","11198","3","11201","14345","2457.219375","0.031943851875","275352.26062499976","3.579579388124998"
"655","11201","11198","6","11204","14351","2457.8774999999996","0.031952407499999995","277810.13812499976","3.611531795624998"
"656","11204","11196","5","11201","14356","2457.219375","0.031943851875","280267.35749999975","3.643475647499998"
"657","11201","11197","6","11203","14362","2457.658125","0.031949555624999994","282725.01562499977","3.675425203124998"
"658","11203","11199","6","11205","14368","2458.096875","0.031955259375","285183.11249999976","3.707380462499998"
"659","11205","11199","3","11202","14371","2457.4387500000003","0.03194670375","287640.5512499997","3.739327166249998"
"660","11202","11196","8","11204","14379","2457.8774999999996","0.031952407499999995","290098.42874999973","3.771279573749998"
"661","11204","11200","7","11207","14386","2458.535625","0.031960963125","292556.96437499975","3.803240536874998"
"662","11207","11205","3","11208","14389","2458.755","0.031963815","295015.71937499975","3.835204351874998"
"663","11208","11203","4","11207","14393","2458.535625","0.031960963125","297474.2549999998","3.867165314999998"
"664","11207","11204","2","11206","14395","2458.3162500000003","0.031958111250000004","299932.57124999975","3.899123426249998"
"665","11206","11204","7","11211","14402","2459.413125","0.031972370624999996","302391.98437499977","3.931095796874998"
"666","11211","11204","1","11205","14403","2458.096875","0.031955259375","304850.08124999976","3.963051056249998"
"667","11205","11196","6","11202","14409","2457.4387500000003","0.03194670375","307307.5199999997","3.994997759999998"
"668","11202","11201","9","11210","14418","2459.19375","0.031969518749999995","309766.7137499997","4.026967278749998"
"669","11210","11201","3","11204","14421","2457.8774999999996","0.031952407499999995","312224.5912499997","4.0589196862499985"
"670","11204","11202","5","11207","14426","2458.535625","0.031960963125","314683.1268749997","4.0908806493749985"
"671","11207","11204","2","11206","14428","2458.3162500000003","0.031958111250000004","317141.4431249997","4.122838760624998"
"672","11206","11198","6","11204","14434","2457.8774999999996","0.031952407499999995","319599.3206249997","4.154791168124999"
"673","11204","11200","7","11207","14441","2458.535625","0.031960963125","322057.8562499997","4.186752131249999"
"674","11207","11202","6","11208","14447","2458.755","0.031963815","324516.6112499997","4.218715946249999"
"675","11208","11199","1","11200","14448","2457.0","0.031941","326973.6112499997","4.250656946249999"
"676","11200","11192","4","11196","14452","2456.1225000000004","0.031929592500000006","329429.7337499997","4.282586538749999"
"677","11196","11190","7","11197","14459","2456.341875","0.031932444375","331886.0756249997","4.314518983124999"
"678","11197","11188","9","11197","14468","2456.341875","0.031932444375","334342.4174999997","4.346451427499999"
"679","11197","11188","2","11190","14470","2454.80625","0.03191248125","336797.2237499997","4.378363908749999"
"680","11190","11185","7","11192","14477","2455.245","0.031918184999999995","339252.4687499997","4.410282093749999"
"681","11192","11189","5","11194","14482","2455.6837499999997","0.03192388875","341708.15249999973","4.442205982499999"
"682","11194","11187","8","11195","14490","2455.903125","0.031926740625","344164.05562499975","4.474132723124999"
"683","11195","11189","2","11191","14492","2455.025625","0.031915333125","346619.08124999976","4.506048056249999"
"684","11191","11186","9","11195","14501","2455.903125","0.031926740625","349074.98437499977","4.537974796874999"
"685","11195","11186","4","11190","14505","2454.80625","0.03191248125","351529.7906249998","4.569887278124999"
"686","11190","11184","7","11191","14512","2455.025625","0.031915333125","353984.8162499998","4.601802611249999"
"687","11191","11183","9","11192","14521","2455.245","0.031918184999999995","356440.0612499998","4.6337207962499996"
"688","11192","11185","6","11191","14527","2455.025625","0.031915333125","358895.0868749998","4.665636129375"
"689","11191","11183","1","11184","14528","2453.49","0.03189536999999999","361348.5768749998","4.697531499375"
"690","11184","11180","1","11181","14529","2452.8318750000003","0.031886814375","363801.40874999977","4.72941831375"
"691","11181","11175","1","11176","14530","2451.735","0.031872555","366253.14374999976","4.76129086875"
"692","11176","11170","5","11175","14535","2451.515625","0.031869703124999996","368704.65937499976","4.793160571875"
"693","11175","11167","9","11176","14544","2451.735","0.031872555","371156.39437499974","4.825033126875"
"694","11176","11174","3","11177","14547","2451.9543750000003","0.031875406875","373608.3487499997","4.8569085337499995"
"695","11177","11169","3","11172","14550","2450.8575","0.0318611475","376059.2062499997","4.888769681249999"
"696","11172","11165","1","11166","14551","2449.54125","0.03184403625","378508.7474999997","4.920613717499999"
"697","11166","11162","2","11164","14553","2449.1025","0.0318383325","380957.8499999997","4.952452049999999"
"698","11164","11156","9","11165","14562","2449.321875","0.031841184375","383407.1718749997","4.984293234374999"
"699","11165","11161","3","11164","14565","2449.1025","0.0318383325","385856.2743749997","5.016131566874998"
"700","11164","11162","8","11170","14573","2450.41875","0.03185544375","388306.6931249997","5.047987010624998"
"701","11170","11162","1","11163","14574","2448.883125","0.031835480624999996","390755.5762499997","5.079822491249998"
"702","11163","11162","6","11168","14580","2449.98","0.03184974","393205.5562499997","5.111672231249998"
"703","11168","11163","2","11165","14582","2449.321875","0.031841184375","395654.8781249997","5.143513415624998"
"704","11165","11163","7","11170","14589","2450.41875","0.03185544375","398105.2968749997","5.175368859374998"
"705","11170","11166","9","11175","14598","2451.515625","0.031869703124999996","400556.8124999997","5.207238562499998"
"706","11175","11169","7","11176","14605","2451.735","0.031872555","403008.5474999997","5.239111117499998"
"707","11176","11168","2","11170","14607","2450.41875","0.03185544375","405458.9662499997","5.270966561249997"
"708","11170","11167","3","11170","14610","2450.41875","0.03185544375","407909.3849999997","5.302822004999997"
"709","11170","11162","1","11163","14611","2448.883125","0.031835480624999996","410358.2681249997","5.334657485624997"
"710","11163","11158","3","11161","14614","2448.444375","0.031829776875","412806.71249999973","5.366487262499997"
"711","11161","11153","5","11158","14619","2447.78625","0.03182122125","415254.49874999974","5.3983084837499975"
"712","11158","11153","4","11157","14623","2447.566875","0.031818369374999995","417702.06562499976","5.430126853124998"
"713","11157","11156","9","11165","14632","2449.321875","0.031841184375","420151.3874999998","5.4619680374999975"
"714","11165","11163","2","11165","14634","2449.321875","0.031841184375","422600.7093749998","5.493809221874997"
"715","11165","11158","8","11166","14642","2449.54125","0.03184403625","425050.2506249998","5.525653258124997"
"716","11166","11157","6","11163","14648","2448.883125","0.031835480624999996","427499.1337499998","5.557488738749997"
"717","11163","11162","4","11166","14652","2449.54125","0.03184403625","429948.6749999998","5.589332774999997"
"718","11166","11165","2","11167","14654","2449.760625","0.03184688812499999","432398.4356249998","5.621179663124997"
"719","11167","11163","8","11171","14662","2450.6381250000004","0.031858295625000005","434849.0737499998","5.653037958749997"
"720","11171","11166","1","11167","14663","2449.760625","0.03184688812499999","437298.8343749998","5.684884846874997"
"721","11167","11159","5","11164","14668","2449.1025","0.0318383325","439747.9368749998","5.716723179374997"
"722","11164","11161","1","11162","14669","2448.66375","0.03183262875","442196.6006249998","5.748555808124997"
"723","11162","11161","6","11167","14675","2449.760625","0.03184688812499999","444646.3612499998","5.780402696249997"
"724","11167","11165","1","11166","14676","2449.54125","0.03184403625","447095.9024999998","5.812246732499997"
"725","11166","11158","9","11167","14685","2449.760625","0.03184688812499999","449545.6631249998","5.844093620624997"
"726","11167","11160","6","11166","14691","2449.54125","0.03184403625","451995.2043749998","5.875937656874997"
"727","11166","11160","9","11169","14700","2450.1993749999997","0.031852591874999996","454445.4037499998","5.907790248749997"
"728","11169","11168","7","11175","14707","2451.515625","0.031869703124999996","456896.9193749998","5.939659951874997"
"729","11175","11171","9","11180","14716","2452.6125","0.0318839625","459349.5318749998","5.9715439143749975"
"730","11180","11172","4","11176","14720","2451.735","0.031872555","461801.2668749998","6.003416469374997"
"731","11176","11167","2","11169","14722","2450.1993749999997","0.031852591874999996","464251.4662499998","6.0352690612499975"
"732","11169","11167","8","11175","14730","2451.515625","0.031869703124999996","466702.9818749998","6.067138764374998"
"733","11175","11167","3","11170","14733","2450.41875","0.03185544375","469153.40062499983","6.0989942081249975"
"734","11170","11164","2","11166","14735","2449.54125","0.03184403625","471602.94187499984","6.130838244374997"
"735","11166","11158","2","11160","14737","2448.225","0.031826925","474051.1668749998","6.162665169374997"
"736","11160","11158","7","11165","14744","2449.321875","0.031841184375","476500.48874999984","6.194506353749997"
"737","11165","11162","6","11168","14750","2449.98","0.03184974","478950.4687499998","6.226356093749997"
"738","11168","11164","4","11168","14754","2449.98","0.03184974","481400.4487499998","6.258205833749997"
"739","11168","11159","6","11165","14760","2449.321875","0.031841184375","483849.77062499983","6.290047018124997"
"740","11165","11159","5","11164","14765","2449.1025","0.0318383325","486298.8731249998","6.321885350624997"
"741","11164","11155","3","11158","14768","2447.78625","0.03182122125","488746.6593749998","6.353706571874997"
"742","11158","11155","8","11163","14776","2448.883125","0.031835480624999996","491195.5424999998","6.385542052499997"
"743","11163","11161","9","11170","14785","2450.41875","0.03185544375","493645.9612499998","6.417397496249997"
"744","11170","11164","7","11171","14792","2450.6381250000004","0.031858295625000005","496096.5993749998","6.449255791874997"
"745","11171","11170","6","11176","14798","2451.735","0.031872555","498548.3343749998","6.481128346874996"
"746","11176","11169","2","11171","14800","2450.6381250000004","0.031858295625000005","500998.9724999998","6.512986642499996"
"747","11171","11168","1","11169","14801","2450.1993749999997","0.031852591874999996","503449.1718749998","6.544839234374996"
"748","11169","11164","2","11166","14803","2449.54125","0.03184403625","505898.71312499983","6.576683270624996"
"749","11166","11158","2","11160","14805","2448.225","0.031826925","508346.9381249998","6.608510195624996"
"750","11160","11155","3","11158","14808","2447.78625","0.03182122125","510794.7243749998","6.6403314168749965"
"751","11158","11150","2","11152","14810","2446.4700000000003","0.031804110000000003","513241.1943749998","6.672135526874997"
"752","11152","11148","7","11155","14817","2447.128125","0.031812665625","515688.3224999998","6.703948192499997"
"753","11155","11151","1","11152","14818","2446.4700000000003","0.031804110000000003","518134.79249999975","6.735752302499997"
"754","11152","11145","1","11146","14819","2445.1537500000004","0.03178699875","520579.94624999975","6.767539301249998"
"755","11146","11139","1","11140","14820","2443.8375","0.031769887499999996","523023.78374999977","6.799309188749998"
"756","11140","11133","2","11135","14822","2442.740625","0.031755628125","525466.5243749998","6.831064816874998"
"757","11135","11126","7","11133","14829","2442.301875","0.031749924375","527908.8262499998","6.8628147412499985"
"758","11133","11124","4","11128","14833","2441.205","0.031735664999999996","530350.0312499998","6.894550406249999"
"759","11128","11127","2","11129","14835","2441.4243749999996","0.03173851687499999","532791.4556249997","6.926288923124999"
"760","11129","11124","6","11130","14841","2441.64375","0.03174136875","535233.0993749998","6.958030291874999"
"761","11130","11124","6","11130","14847","2441.64375","0.03174136875","537674.7431249998","6.989771660624998"
"762","11130","11125","5","11130","14852","2441.64375","0.03174136875","540116.3868749999","7.021513029374998"
"763","11130","11124","5","11129","14857","2441.4243749999996","0.03173851687499999","542557.8112499998","7.0532515462499985"
"764","11129","11122","7","11129","14864","2441.4243749999996","0.03173851687499999","544999.2356249997","7.084990063124999"
"765","11129","11120","5","11125","14869","2440.546875","0.031727109375","547439.7824999997","7.116717172499999"
"766","11125","11118","3","11121","14872","2439.6693750000004","0.031715701875","549879.4518749998","7.148432874374999"
"767","11121","11119","7","11126","14879","2440.76625","0.03172996125","552320.2181249998","7.180162835624999"
"768","11126","11120","3","11123","14882","2440.1081249999997","0.031721405625","554760.3262499998","7.211884241249999"
"769","11123","11119","6","11125","14888","2440.546875","0.031727109375","557200.8731249998","7.243611350624999"
"770","11125","11122","6","11128","14894","2441.205","0.031735664999999996","559642.0781249998","7.275347015624999"
"771","11128","11126","8","11134","14902","2442.52125","0.031752776249999996","562084.5993749998","7.307099791874999"
"772","11134","11125","5","11130","14907","2441.64375","0.03174136875","564526.2431249998","7.338841160624999"
"773","11130","11121","7","11128","14914","2441.205","0.031735664999999996","566967.4481249998","7.370576825624999"
"774","11128","11127","6","11133","14920","2442.301875","0.031749924375","569409.7499999998","7.402326749999999"
"775","11133","11124","7","11131","14927","2441.8631250000003","0.031744220625","571851.6131249998","7.434070970624999"
"776","11131","11124","3","11127","14930","2440.9856250000003","0.031732813125","574292.5987499998","7.465803783749999"
"777","11127","11119","9","11128","14939","2441.205","0.031735664999999996","576733.8037499997","7.49753944875"
"778","11128","11119","5","11124","14944","2440.3275","0.0317242575","579174.1312499997","7.529263706249999"
"779","11124","11116","7","11123","14951","2440.1081249999997","0.031721405625","581614.2393749998","7.5609851118749996"
"780","11123","11118","8","11126","14959","2440.76625","0.03172996125","584055.0056249998","7.5927150731249995"
"781","11126","11120","7","11127","14966","2440.9856250000003","0.031732813125","586495.9912499997","7.62444788625"
"782","11127","11122","9","11131","14975","2441.8631250000003","0.031744220625","588937.8543749998","7.656192106874999"
"783","11131","11126","9","11135","14984","2442.740625","0.031755628125","591380.5949999997","7.687947735"
"784","11135","11129","6","11135","14990","2442.740625","0.031755628125","593823.3356249997","7.719703363125"
"785","11135","11134","7","11141","14997","2444.056875","0.031772739375","596267.3924999997","7.7514761025"
"786","11141","11136","7","11143","15004","2444.495625","0.031778443125","598711.8881249997","7.783254545625"
"787","11143","11138","5","11143","15009","2444.495625","0.031778443125","601156.3837499997","7.81503298875"
"788","11143","11138","5","11143","15014","2444.495625","0.031778443125","603600.8793749997","7.8468114318749995"
"789","11143","11136","2","11138","15016","2443.39875","0.031764183749999994","606044.2781249997","7.8785756156249995"
"790","11138","11133","4","11137","15020","2443.179375","0.031761331875","608487.4574999997","7.910336947499999"
"791","11137","11135","6","11141","15026","2444.056875","0.031772739375","610931.5143749997","7.942109686874999"
"792","11141","11138","9","11147","15035","2445.373125","0.031789850625","613376.8874999997","7.973899537499999"
"793","11147","11139","4","11143","15039","2444.495625","0.031778443125","615821.3831249997","8.005677980624998"
"794","11143","11137","2","11139","15041","2443.618125","0.031767035624999995","618265.0012499997","8.037445016249999"
"795","11139","11134","6","11140","15047","2443.8375","0.031769887499999996","620708.8387499998","8.069214903749998"
"796","11140","11131","5","11136","15052","2442.96","0.03175848","623151.7987499997","8.100973383749999"
"797","11136","11134","8","11142","15060","2444.27625","0.03177559125","625596.0749999997","8.132748974999998"
"798","11142","11140","5","11145","15065","2444.934375","0.031784146874999995","628041.0093749997","8.164533121874998"
"799","11145","11136","9","11145","15074","2444.934375","0.031784146874999995","630485.9437499996","8.196317268749997"
"800","11145","11141","4","11145","15078","2444.934375","0.031784146874999995","632930.8781249996","8.228101415624996"
"801","11145","11140","4","11144","15082","2444.7149999999997","0.031781294999999994","635375.5931249995","8.259882710624996"
"802","11144","11142","6","11148","15088","2445.5924999999997","0.03179270249999999","637821.1856249996","8.291675413124997"
"803","11148","11140","3","11143","15091","2444.495625","0.031778443125","640265.6812499996","8.323453856249998"
"804","11143","11135","1","11136","15092","2442.96","0.03175848","642708.6412499995","8.355212336249998"
"805","11136","11133","4","11137","15096","2443.179375","0.031761331875","645151.8206249995","8.386973668124998"
"806","11137","11133","3","11136","15099","2442.96","0.03175848","647594.7806249994","8.418732148124999"
"807","11136","11131","9","11140","15108","2443.8375","0.031769887499999996","650038.6181249995","8.450502035624998"
"808","11140","11131","6","11137","15114","2443.179375","0.031761331875","652481.7974999994","8.482263367499998"
"809","11137","11135","8","11143","15122","2444.495625","0.031778443125","654926.2931249994","8.514041810624999"
"810","11143","11141","3","11144","15125","2444.7149999999997","0.031781294999999994","657371.0081249994","8.545823105624999"
"811","11144","11140","8","11148","15133","2445.5924999999997","0.03179270249999999","659816.6006249994","8.577615808125"
"812","11148","11146","6","11152","15139","2446.4700000000003","0.031804110000000003","662263.0706249994","8.609419918124999"
"813","11152","11143","6","11149","15145","2445.811875","0.03179555437499999","664708.8824999994","8.641215472499999"
"814","11149","11144","6","11150","15151","2446.03125","0.03179840625","667154.9137499994","8.673013878749998"
"815","11150","11149","8","11157","15159","2447.566875","0.031818369374999995","669602.4806249994","8.704832248124998"
"816","11157","11152","3","11155","15162","2447.128125","0.031812665625","672049.6087499994","8.736644913749998"
"817","11155","11152","7","11159","15169","2448.005625","0.031824073125","674497.6143749994","8.768468986874998"
"818","11159","11158","8","11166","15177","2449.54125","0.03184403625","676947.1556249994","8.800313023124998"
"819","11166","11158","8","11166","15185","2449.54125","0.03184403625","679396.6968749994","8.832157059374998"
"820","11166","11160","3","11163","15188","2448.883125","0.031835480624999996","681845.5799999995","8.863992539999998"
"821","11163","11159","6","11165","15194","2449.321875","0.031841184375","684294.9018749995","8.895833724374999"
"822","11165","11161","5","11166","15199","2449.54125","0.03184403625","686744.4431249995","8.927677760624999"
"823","11166","11163","1","11164","15200","2449.1025","0.0318383325","689193.5456249996","8.959516093124998"
"824","11164","11158","8","11166","15208","2449.54125","0.03184403625","691643.0868749996","8.991360129374998"
"825","11166","11160","5","11165","15213","2449.321875","0.031841184375","694092.4087499996","9.023201313749999"
"826","11165","11157","8","11165","15221","2449.321875","0.031841184375","696541.7306249996","9.055042498125"
"827","11165","11156","6","11162","15227","2448.66375","0.03183262875","698990.3943749996","9.086875126874999"
"828","11162","11154","4","11158","15231","2447.78625","0.03182122125","701438.1806249996","9.118696348124999"
"829","11158","11150","4","11154","15235","2446.9087499999996","0.03180981374999999","703885.0893749995","9.150506161874999"
"830","11154","11146","2","11148","15237","2445.5924999999997","0.03179270249999999","706330.6818749995","9.182298864375"
"831","11148","11147","8","11155","15245","2447.128125","0.031812665625","708777.8099999996","9.21411153"
"832","11155","11153","8","11161","15253","2448.444375","0.031829776875","711226.2543749996","9.245941306875"
"833","11161","11156","3","11159","15256","2448.005625","0.031824073125","713674.2599999995","9.27776538"
"834","11159","11154","8","11162","15264","2448.66375","0.03183262875","716122.9237499995","9.30959800875"
"835","11162","11153","6","11159","15270","2448.005625","0.031824073125","718570.9293749995","9.341422081874999"
"836","11159","11158","9","11167","15279","2449.760625","0.03184688812499999","721020.6899999995","9.373268969999998"
"837","11167","11164","1","11165","15280","2449.321875","0.031841184375","723470.0118749995","9.405110154374999"
"838","11165","11161","5","11166","15285","2449.54125","0.03184403625","725919.5531249995","9.436954190624999"
"839","11166","11162","2","11164","15287","2449.1025","0.0318383325","728368.6556249995","9.468792523124998"
"840","11164","11158","2","11160","15289","2448.225","0.031826925","730816.8806249995","9.500619448124999"
"841","11160","11151","8","11159","15297","2448.005625","0.031824073125","733264.8862499995","9.532443521249998"
"842","11159","11154","3","11157","15300","2447.566875","0.031818369374999995","735712.4531249995","9.564261890624998"
"843","11157","11148","3","11151","15303","2446.250625","0.031801258125","738158.7037499995","9.596063148749998"
"844","11151","11147","5","11152","15308","2446.4700000000003","0.031804110000000003","740605.1737499995","9.627867258749998"
"845","11152","11144","2","11146","15310","2445.1537500000004","0.03178699875","743050.3274999995","9.659654257499998"
"846","11146","11137","4","11141","15314","2444.056875","0.031772739375","745494.3843749996","9.691426996874998"
"847","11141","11134","3","11137","15317","2443.179375","0.031761331875","747937.5637499995","9.723188328749998"
"848","11137","11128","6","11134","15323","2442.52125","0.031752776249999996","750380.0849999995","9.754941104999999"
"849","11134","11126","7","11133","15330","2442.301875","0.031749924375","752822.3868749995","9.786691029374998"
"850","11133","11125","2","11127","15332","2440.9856250000003","0.031732813125","755263.3724999995","9.818423842499998"
"851","11127","11121","2","11123","15334","2440.1081249999997","0.031721405625","757703.4806249995","9.850145248124997"
"852","11123","11118","2","11120","15336","2439.45","0.031712849999999994","760142.9306249995","9.881858098124997"
"853","11120","11114","6","11120","15342","2439.45","0.031712849999999994","762582.3806249994","9.913570948124997"
"854","11120","11115","6","11121","15348","2439.6693750000004","0.031715701875","765022.0499999995","9.945286649999996"
"855","11121","11113","7","11120","15355","2439.45","0.031712849999999994","767461.4999999994","9.976999499999996"
"856","11120","11113","1","11114","15356","2438.13375","0.03169573875","769899.6337499995","10.008695238749997"
"857","11114","11112","6","11118","15362","2439.01125","0.03170714625","772338.6449999994","10.040402384999997"
"858","11118","11117","3","11120","15365","2439.45","0.031712849999999994","774778.0949999994","10.072115234999997"
"859","11120","11115","3","11118","15368","2439.01125","0.03170714625","777217.1062499994","10.103822381249996"
"860","11118","11114","1","11115","15369","2438.353125","0.031698590625","779655.4593749994","10.135520971874996"
"861","11115","11112","9","11121","15378","2439.6693750000004","0.031715701875","782095.1287499995","10.167236673749995"
"862","11121","11120","8","11128","15386","2441.205","0.031735664999999996","784536.3337499994","10.198972338749995"
"863","11128","11122","9","11131","15395","2441.8631250000003","0.031744220625","786978.1968749994","10.230716559374995"
"864","11131","11125","4","11129","15399","2441.4243749999996","0.03173851687499999","789419.6212499994","10.262455076249996"
"865","11129","11125","7","11132","15406","2442.0825","0.0317470725","791861.7037499994","10.294202148749996"
"866","11132","11127","2","11129","15408","2441.4243749999996","0.03173851687499999","794303.1281249993","10.325940665624996"
"867","11129","11125","7","11132","15415","2442.0825","0.0317470725","796745.2106249994","10.357687738124996"
"868","11132","11130","9","11139","15424","2443.618125","0.031767035624999995","799188.8287499994","10.389454773749996"
"869","11139","11138","8","11146","15432","2445.1537500000004","0.03178699875","801633.9824999995","10.421241772499997"
"870","11146","11143","8","11151","15440","2446.250625","0.031801258125","804080.2331249994","10.453043030624997"
"871","11151","11148","4","11152","15444","2446.4700000000003","0.031804110000000003","806526.7031249994","10.484847140624996"
"872","11152","11146","8","11154","15452","2446.9087499999996","0.03180981374999999","808973.6118749994","10.516656954374996"
"873","11154","11151","3","11154","15455","2446.9087499999996","0.03180981374999999","811420.5206249993","10.548466768124996"
"874","11154","11148","2","11150","15457","2446.03125","0.03179840625","813866.5518749993","10.580265174374995"
"875","11150","11142","9","11151","15466","2446.250625","0.031801258125","816312.8024999993","10.612066432499995"
"876","11151","11150","6","11156","15472","2447.3475000000003","0.0318155175","818760.1499999993","10.643881949999995"
"877","11156","11149","6","11155","15478","2447.128125","0.031812665625","821207.2781249994","10.675694615624996"
"878","11155","11152","5","11157","15483","2447.566875","0.031818369374999995","823654.8449999994","10.707512984999996"
"879","11157","11155","2","11157","15485","2447.566875","0.031818369374999995","826102.4118749994","10.739331354374995"
"880","11157","11154","8","11162","15493","2448.66375","0.03183262875","828551.0756249994","10.771163983124994"
"881","11162","11157","5","11162","15498","2448.66375","0.03183262875","830999.7393749993","10.802996611874994"
"882","11162","11160","2","11162","15500","2448.66375","0.03183262875","833448.4031249993","10.834829240624993"
"883","11162","11159","4","11163","15504","2448.883125","0.031835480624999996","835897.2862499993","10.866664721249993"
"884","11163","11157","8","11165","15512","2449.321875","0.031841184375","838346.6081249993","10.898505905624994"
"885","11165","11160","9","11169","15521","2450.1993749999997","0.031852591874999996","840796.8074999993","10.930358497499993"
"886","11169","11168","3","11171","15524","2450.6381250000004","0.031858295625000005","843247.4456249994","10.962216793124993"
"887","11171","11164","4","11168","15528","2449.98","0.03184974","845697.4256249993","10.994066533124993"
"888","11168","11161","8","11169","15536","2450.1993749999997","0.031852591874999996","848147.6249999993","11.025919124999993"
"889","11169","11162","1","11163","15537","2448.883125","0.031835480624999996","850596.5081249994","11.057754605624993"
"890","11163","11154","5","11159","15542","2448.005625","0.031824073125","853044.5137499993","11.089578678749993"
"891","11159","11158","5","11163","15547","2448.883125","0.031835480624999996","855493.3968749994","11.121414159374993"
"892","11163","11155","6","11161","15553","2448.444375","0.031829776875","857941.8412499994","11.153243936249993"
"893","11161","11152","7","11159","15560","2448.005625","0.031824073125","860389.8468749993","11.185068009374993"
"894","11159","11156","9","11165","15569","2449.321875","0.031841184375","862839.1687499994","11.216909193749993"
"895","11165","11159","4","11163","15573","2448.883125","0.031835480624999996","865288.0518749994","11.248744674374993"
"896","11163","11154","4","11158","15577","2447.78625","0.03182122125","867735.8381249994","11.280565895624994"
"897","11158","11154","8","11162","15585","2448.66375","0.03183262875","870184.5018749994","11.312398524374993"
"898","11162","11154","5","11159","15590","2448.005625","0.031824073125","872632.5074999994","11.344222597499993"
"899","11159","11156","2","11158","15592","2447.78625","0.03182122125","875080.2937499994","11.376043818749993"
"900","11158","11149","1","11150","15593","2446.03125","0.03179840625","877526.3249999994","11.407842224999992"
"901","11150","11144","2","11146","15595","2445.1537500000004","0.03178699875","879971.4787499994","11.439629223749993"
"902","11146","11138","3","11141","15598","2444.056875","0.031772739375","882415.5356249994","11.471401963124993"
"903","11141","11137","5","11142","15603","2444.27625","0.03177559125","884859.8118749994","11.503177554374993"
"904","11142","11137","7","11144","15610","2444.7149999999997","0.031781294999999994","887304.5268749994","11.534958849374993"
"905","11144","11138","3","11141","15613","2444.056875","0.031772739375","889748.5837499994","11.566731588749994"
"906","11141","11138","9","11147","15622","2445.373125","0.031789850625","892193.9568749995","11.598521439374993"
"907","11147","11141","9","11150","15631","2446.03125","0.03179840625","894639.9881249995","11.630319845624992"
"908","11150","11142","5","11147","15636","2445.373125","0.031789850625","897085.3612499995","11.662109696249992"
"909","11147","11138","5","11143","15641","2444.495625","0.031778443125","899529.8568749995","11.693888139374993"
"910","11143","11136","7","11143","15648","2444.495625","0.031778443125","901974.3524999995","11.725666582499993"
"911","11143","11138","3","11141","15651","2444.056875","0.031772739375","904418.4093749995","11.757439321874994"
"912","11141","11135","2","11137","15653","2443.179375","0.031761331875","906861.5887499994","11.789200653749994"
"913","11137","11131","4","11135","15657","2442.740625","0.031755628125","909304.3293749994","11.820956281874993"
"914","11135","11133","5","11138","15662","2443.39875","0.031764183749999994","911747.7281249994","11.852720465624992"
"915","11138","11131","1","11132","15663","2442.0825","0.0317470725","914189.8106249995","11.884467538124992"
"916","11132","11123","2","11125","15665","2440.546875","0.031727109375","916630.3574999995","11.916194647499992"
"917","11125","11120","4","11124","15669","2440.3275","0.0317242575","919070.6849999995","11.947918904999993"
"918","11124","11123","6","11129","15675","2441.4243749999996","0.03173851687499999","921512.1093749994","11.979657421874993"
"919","11129","11122","2","11124","15677","2440.3275","0.0317242575","923952.4368749994","12.011381679374994"
"920","11124","11123","4","11127","15681","2440.9856250000003","0.031732813125","926393.4224999994","12.043114492499994"
"921","11127","11121","9","11130","15690","2441.64375","0.03174136875","928835.0662499995","12.074855861249993"
"922","11130","11126","1","11127","15691","2440.9856250000003","0.031732813125","931276.0518749994","12.106588674374994"
"923","11127","11121","6","11127","15697","2440.9856250000003","0.031732813125","933717.0374999994","12.138321487499994"
"924","11127","11122","2","11124","15699","2440.3275","0.0317242575","936157.3649999994","12.170045744999994"
"925","11124","11118","8","11126","15707","2440.76625","0.03172996125","938598.1312499994","12.201775706249995"
"926","11126","11125","9","11134","15716","2442.52125","0.031752776249999996","941040.6524999994","12.233528482499995"
"927","11134","11133","9","11142","15725","2444.27625","0.03177559125","943484.9287499994","12.265304073749995"
"928","11142","11134","5","11139","15730","2443.618125","0.031767035624999995","945928.5468749994","12.297071109374995"
"929","11139","11136","1","11137","15731","2443.179375","0.031761331875","948371.7262499994","12.328832441249995"
"930","11137","11135","5","11140","15736","2443.8375","0.031769887499999996","950815.5637499994","12.360602328749994"
"931","11140","11133","7","11140","15743","2443.8375","0.031769887499999996","953259.4012499994","12.392372216249994"
"932","11140","11132","8","11140","15751","2443.8375","0.031769887499999996","955703.2387499994","12.424142103749993"
"933","11140","11132","4","11136","15755","2442.96","0.03175848","958146.1987499994","12.455900583749994"
"934","11136","11134","6","11140","15761","2443.8375","0.031769887499999996","960590.0362499994","12.487670471249993"
"935","11140","11131","4","11135","15765","2442.740625","0.031755628125","963032.7768749994","12.519426099374993"
"936","11135","11127","1","11128","15766","2441.205","0.031735664999999996","965473.9818749994","12.551161764374992"
"937","11128","11124","1","11125","15767","2440.546875","0.031727109375","967914.5287499994","12.582888873749992"
"938","11125","11117","2","11119","15769","2439.2306249999997","0.03170999812499999","970353.7593749993","12.614598871874993"
"939","11119","11117","8","11125","15777","2440.546875","0.031727109375","972794.3062499993","12.646325981249992"
"940","11125","11122","1","11123","15778","2440.1081249999997","0.031721405625","975234.4143749994","12.678047386874992"
"941","11123","11114","1","11115","15779","2438.353125","0.031698590625","977672.7674999994","12.709745977499992"
"942","11115","11106","3","11109","15782","2437.036875","0.031681479374999995","980109.8043749994","12.741427456874993"
"943","11109","11103","6","11109","15788","2437.036875","0.031681479374999995","982546.8412499994","12.773108936249994"
"944","11109","11100","4","11104","15792","2435.9399999999996","0.031667219999999996","984982.7812499993","12.804776156249993"
"945","11104","11099","6","11105","15798","2436.159375","0.031670071875","987418.9406249993","12.836446228124993"
"946","11105","11103","4","11107","15802","2436.598125","0.031675775625","989855.5387499994","12.868122003749994"
"947","11107","11103","8","11111","15810","2437.475625","0.031687183125","992293.0143749993","12.899809186874993"
"948","11111","11108","5","11113","15815","2437.914375","0.03169288687499999","994730.9287499994","12.931502073749993"
"949","11113","11109","9","11118","15824","2439.01125","0.03170714625","997169.9399999994","12.963209219999992"
"950","11118","11116","2","11118","15826","2439.01125","0.03170714625","999608.9512499993","12.994916366249992"
"951","11118","11112","1","11113","15827","2437.914375","0.03169288687499999","1002046.8656249994","13.026609253124992"
"952","11113","11104","3","11107","15830","2436.598125","0.031675775625","1004483.4637499994","13.058285028749992"
"953","11107","11099","6","11105","15836","2436.159375","0.031670071875","1006919.6231249995","13.089955100624993"
"954","11105","11101","6","11107","15842","2436.598125","0.031675775625","1009356.2212499995","13.121630876249993"
"955","11107","11101","6","11107","15848","2436.598125","0.031675775625","1011792.8193749995","13.153306651874994"
"956","11107","11099","2","11101","15850","2435.281875","0.031658664375","1014228.1012499995","13.184965316249993"
"957","11101","11095","8","11103","15858","2435.720625","0.031664368124999995","1016663.8218749994","13.216629684374993"
"958","11103","11098","9","11107","15867","2436.598125","0.031675775625","1019100.4199999995","13.248305459999994"
"959","11107","11103","9","11112","15876","2437.695","0.031690035","1021538.1149999994","13.279995494999994"
"960","11112","11108","6","11114","15882","2438.13375","0.03169573875","1023976.2487499994","13.311691233749995"
"961","11114","11109","2","11111","15884","2437.475625","0.031687183125","1026413.7243749994","13.343378416874994"
"962","11111","11105","5","11110","15889","2437.25625","0.031684331249999996","1028850.9806249994","13.375062748124995"
"963","11110","11102","9","11111","15898","2437.475625","0.031687183125","1031288.4562499993","13.406749931249994"
"964","11111","11103","1","11104","15899","2435.9399999999996","0.031667219999999996","1033724.3962499993","13.438417151249993"
"965","11104","11100","7","11107","15906","2436.598125","0.031675775625","1036160.9943749993","13.470092926874994"
"966","11107","11100","5","11105","15911","2436.159375","0.031670071875","1038597.1537499994","13.501762998749994"
"967","11105","11100","6","11106","15917","2436.3787500000003","0.031672923750000005","1041033.5324999994","13.533435922499994"
"968","11106","11104","9","11113","15926","2437.914375","0.03169288687499999","1043471.4468749994","13.565128809374993"
"969","11113","11108","7","11115","15933","2438.353125","0.031698590625","1045909.7999999995","13.596827399999993"
"970","11115","11108","1","11109","15934","2437.036875","0.031681479374999995","1048346.8368749995","13.628508879374994"
"971","11109","11104","1","11105","15935","2436.159375","0.031670071875","1050782.9962499994","13.660178951249994"
"972","11105","11097","4","11101","15939","2435.281875","0.031658664375","1053218.2781249995","13.691837615624994"
"973","11101","11094","4","11098","15943","2434.6237499999997","0.031650108749999996","1055652.9018749995","13.723487724374994"
"974","11098","11097","2","11099","15945","2434.843125","0.031652960625","1058087.7449999994","13.755140684999994"
"975","11099","11093","7","11100","15952","2435.0625","0.0316558125","1060522.8074999994","13.786796497499994"
"976","11100","11094","3","11097","15955","2434.404375","0.031647256875","1062957.2118749993","13.818443754374995"
"977","11097","11088","7","11095","15962","2433.965625","0.03164155312499999","1065391.1774999993","13.850085307499995"
"978","11095","11093","8","11101","15970","2435.281875","0.031658664375","1067826.4593749994","13.881743971874995"
"979","11101","11097","7","11104","15977","2435.9399999999996","0.031667219999999996","1070262.3993749993","13.913411191874994"
"980","11104","11100","1","11101","15978","2435.281875","0.031658664375","1072697.6812499994","13.945069856249994"
"981","11101","11096","6","11102","15984","2435.5012500000003","0.03166151625","1075133.1824999994","13.976731372499994"
"982","11102","11095","5","11100","15989","2435.0625","0.0316558125","1077568.2449999994","14.008387184999995"
"983","11100","11094","9","11103","15998","2435.720625","0.031664368124999995","1080003.9656249995","14.040051553124995"
"984","11103","11094","3","11097","16001","2434.404375","0.031647256875","1082438.3699999994","14.071698809999996"
"985","11097","11095","8","11103","16009","2435.720625","0.031664368124999995","1084874.0906249995","14.103363178124996"
"986","11103","11094","8","11102","16017","2435.5012500000003","0.03166151625","1087309.5918749995","14.135024694374996"
"987","11102","11095","5","11100","16022","2435.0625","0.0316558125","1089744.6543749995","14.166680506874997"
"988","11100","11094","3","11097","16025","2434.404375","0.031647256875","1092179.0587499994","14.198327763749997"
"989","11097","11092","6","11098","16031","2434.6237499999997","0.031650108749999996","1094613.6824999994","14.229977872499997"
"990","11098","11089","9","11098","16040","2434.6237499999997","0.031650108749999996","1097048.3062499994","14.261627981249998"
"991","11098","11093","9","11102","16049","2435.5012500000003","0.03166151625","1099483.8074999994","14.293289497499998"
"992","11102","11098","6","11104","16055","2435.9399999999996","0.031667219999999996","1101919.7474999994","14.324956717499997"
"993","11104","11098","1","11099","16056","2434.843125","0.031652960625","1104354.5906249993","14.356609678124997"
"994","11099","11095","4","11099","16060","2434.843125","0.031652960625","1106789.4337499992","14.388262638749996"
"995","11099","11091","3","11094","16063","2433.7462499999997","0.03163870124999999","1109223.1799999992","14.419901339999996"
"996","11094","11090","3","11093","16066","2433.526875","0.031635849375","1111656.7068749992","14.451537189374996"
"997","11093","11091","8","11099","16074","2434.843125","0.031652960625","1114091.549999999","14.483190149999995"
"998","11099","11094","9","11103","16083","2435.720625","0.031664368124999995","1116527.2706249992","14.514854518124995"
"999","11103","11102","1","11103","16084","2435.720625","0.031664368124999995","1118962.9912499993","14.546518886249995"
"1000","11103","11098","3","11101","16087","2435.281875","0.031658664375","1121398.2731249994","14.578177550624995"
"1001","11101","11097","6","11103","16093","2435.720625","0.031664368124999995","1123833.9937499994","14.609841918749995"
"1002","11103","11102","3","11105","16096","2436.159375","0.031670071875","1126270.1531249995","14.641511990624995"
"1003","11105","11101","2","11103","16098","2435.720625","0.031664368124999995","1128705.8737499996","14.673176358749995"
"1004","11103","11102","8","11110","16106","2437.25625","0.031684331249999996","1131143.1299999997","14.704860689999995"
"1005","11110","11105","5","11110","16111","2437.25625","0.031684331249999996","1133580.3862499997","14.736545021249995"
"1006","11110","11101","8","11109","16119","2437.036875","0.031681479374999995","1136017.4231249997","14.768226500624996"
"1007","11109","11104","7","11111","16126","2437.475625","0.031687183125","1138454.8987499997","14.799913683749995"
"1008","11111","11108","4","11112","16130","2437.695","0.031690035","1140892.5937499998","14.831603718749996"
"1009","11112","11103","4","11107","16134","2436.598125","0.031675775625","1143329.1918749998","14.863279494374996"
"1010","11107","11102","7","11109","16141","2437.036875","0.031681479374999995","1145766.2287499998","14.894960973749997"
"1011","11109","11105","5","11110","16146","2437.25625","0.031684331249999996","1148203.4849999999","14.926645304999997"
"1012","11110","11103","1","11104","16147","2435.9399999999996","0.031667219999999996","1150639.4249999998","14.958312524999997"
"1013","11104","11100","9","11109","16156","2437.036875","0.031681479374999995","1153076.4618749998","14.989994004374998"
"1014","11109","11104","2","11106","16158","2436.3787500000003","0.031672923750000005","1155512.8406249997","15.021666928124997"
"1015","11106","11105","1","11106","16159","2436.3787500000003","0.031672923750000005","1157949.2193749996","15.053339851874997"
"1016","11106","11098","2","11100","16161","2435.0625","0.0316558125","1160384.2818749996","15.084995664374997"
"1017","11100","11098","4","11102","16165","2435.5012500000003","0.03166151625","1162819.7831249996","15.116657180624998"
"1018","11102","11099","2","11101","16167","2435.281875","0.031658664375","1165255.0649999997","15.148315844999997"
"1019","11101","11100","4","11104","16171","2435.9399999999996","0.031667219999999996","1167691.0049999997","15.179983064999997"
"1020","11104","11098","2","11100","16173","2435.0625","0.0316558125","1170126.0674999997","15.211638877499997"
"1021","11100","11095","9","11104","16182","2435.9399999999996","0.031667219999999996","1172562.0074999996","15.243306097499996"
"1022","11104","11095","7","11102","16189","2435.5012500000003","0.03166151625","1174997.5087499996","15.274967613749997"
"1023","11102","11101","9","11110","16198","2437.25625","0.031684331249999996","1177434.7649999997","15.306651944999997"
"1024","11110","11101","9","11110","16207","2437.25625","0.031684331249999996","1179872.0212499998","15.338336276249997"
"1025","11110","11102","4","11106","16211","2436.3787500000003","0.031672923750000005","1182308.3999999997","15.370009199999997"
"1026","11106","11105","7","11112","16218","2437.695","0.031690035","1184746.0949999997","15.401699234999997"
"1027","11112","11103","1","11104","16219","2435.9399999999996","0.031667219999999996","1187182.0349999997","15.433366454999996"
"1028","11104","11098","6","11104","16225","2435.9399999999996","0.031667219999999996","1189617.9749999996","15.465033674999995"
"1029","11104","11096","2","11098","16227","2434.6237499999997","0.031650108749999996","1192052.5987499997","15.496683783749996"
"1030","11098","11097","4","11101","16231","2435.281875","0.031658664375","1194487.8806249998","15.528342448124995"
"1031","11101","11099","1","11100","16232","2435.0625","0.0316558125","1196922.9431249998","15.559998260624996"
"1032","11100","11096","1","11097","16233","2434.404375","0.031647256875","1199357.3474999997","15.591645517499996"
"1033","11097","11093","5","11098","16238","2434.6237499999997","0.031650108749999996","1201791.9712499997","15.623295626249996"
"1034","11098","11096","4","11100","16242","2435.0625","0.0316558125","1204227.0337499997","15.654951438749997"
"1035","11100","11094","2","11096","16244","2434.1850000000004","0.031644405","1206661.2187499998","15.686595843749997"
"1036","11096","11092","6","11098","16250","2434.6237499999997","0.031650108749999996","1209095.8424999998","15.718245952499997"
"1037","11098","11093","1","11094","16251","2433.7462499999997","0.03163870124999999","1211529.5887499999","15.749884653749996"
"1038","11094","11085","1","11086","16252","2431.99125","0.031615886249999996","1213961.5799999998","15.781500539999996"
"1039","11086","11077","1","11078","16253","2430.23625","0.03159307125","1216391.81625","15.813093611249997"
"1040","11078","11069","8","11077","16261","2430.0168750000003","0.031590219375","1218821.833125","15.844683830624996"
"1041","11077","11076","3","11079","16264","2430.4556249999996","0.031595923124999994","1221252.2887499998","15.876279753749996"
"1042","11079","11074","4","11078","16268","2430.23625","0.03159307125","1223682.525","15.907872824999997"
"1043","11078","11072","8","11080","16276","2430.675","0.031598775","1226113.2","15.939471599999997"
"1044","11080","11073","9","11082","16285","2431.11375","0.03160447875","1228544.31375","15.971076078749997"
"1045","11082","11076","2","11078","16287","2430.23625","0.03159307125","1230974.55","16.002669149999996"
"1046","11078","11072","3","11075","16290","2429.578125","0.031584515625","1233404.128125","16.034253665624995"
"1047","11075","11072","4","11076","16294","2429.7975","0.0315873675","1235833.9256250001","16.065841033124993"
"1048","11076","11072","9","11081","16303","2430.8943750000003","0.031601626875000004","1238264.82","16.09744265999999"
"1049","11081","11075","7","11082","16310","2431.11375","0.03160447875","1240695.93375","16.129047138749993"
"1050","11082","11081","5","11086","16315","2431.99125","0.031615886249999996","1243127.925","16.16066302499999"
"1051","11086","11083","9","11092","16324","2433.3075","0.031632997499999996","1245561.2325000002","16.192296022499992"
"1052","11092","11083","2","11085","16326","2431.771875","0.031613034374999995","1247993.0043750003","16.22390905687499"
"1053","11085","11081","6","11087","16332","2432.210625","0.031618738125","1250425.2150000003","16.255527794999992"
"1054","11087","11081","8","11089","16340","2432.649375","0.031624441875","1252857.8643750004","16.28715223687499"
"1055","11089","11086","6","11092","16346","2433.3075","0.031632997499999996","1255291.1718750005","16.318785234374992"
"1056","11092","11084","7","11091","16353","2433.088125","0.031630145625","1257724.2600000005","16.350415379999994"
"1057","11091","11088","3","11091","16356","2433.088125","0.031630145625","1260157.3481250005","16.382045525624996"
"1058","11091","11087","8","11095","16364","2433.965625","0.03164155312499999","1262591.3137500004","16.413687078749994"
"1059","11095","11086","3","11089","16367","2432.649375","0.031624441875","1265023.9631250005","16.445311520624994"
"1060","11089","11085","2","11087","16369","2432.210625","0.031618738125","1267456.1737500005","16.476930258749995"
"1061","11087","11086","6","11092","16375","2433.3075","0.031632997499999996","1269889.4812500007","16.508563256249996"
"1062","11092","11090","1","11091","16376","2433.088125","0.031630145625","1272322.5693750007","16.540193401874998"
"1063","11091","11087","5","11092","16381","2433.3075","0.031632997499999996","1274755.8768750008","16.571826399375"
"1064","11092","11086","7","11093","16388","2433.526875","0.031635849375","1277189.4037500008","16.60346224875"
"1065","11093","11086","6","11092","16394","2433.3075","0.031632997499999996","1279622.7112500009","16.63509524625"
"1066","11092","11091","9","11100","16403","2435.0625","0.0316558125","1282057.7737500009","16.66675105875"
"1067","11100","11093","4","11097","16407","2434.404375","0.031647256875","1284492.1781250008","16.698398315625"
"1068","11097","11093","6","11099","16413","2434.843125","0.031652960625","1286927.0212500007","16.73005127625"
"1069","11099","11091","4","11095","16417","2433.965625","0.03164155312499999","1289360.9868750006","16.761692829374997"
"1070","11095","11093","5","11098","16422","2434.6237499999997","0.031650108749999996","1291795.6106250007","16.793342938124997"
"1071","11098","11096","1","11097","16423","2434.404375","0.031647256875","1294230.0150000006","16.824990194999998"
"1072","11097","11091","5","11096","16428","2434.1850000000004","0.031644405","1296664.2000000007","16.8566346"
"1073","11096","11088","7","11095","16435","2433.965625","0.03164155312499999","1299098.1656250006","16.888276153125"
"1074","11095","11091","6","11097","16441","2434.404375","0.031647256875","1301532.5700000005","16.91992341"
"1075","11097","11095","5","11100","16446","2435.0625","0.0316558125","1303967.6325000005","16.951579222499998"
"1076","11100","11094","1","11095","16447","2433.965625","0.03164155312499999","1306401.5981250005","16.983220775624996"
"1077","11095","11091","7","11098","16454","2434.6237499999997","0.031650108749999996","1308836.2218750005","17.014870884374997"
"1078","11098","11094","4","11098","16458","2434.6237499999997","0.031650108749999996","1311270.8456250005","17.046520993124997"
"1079","11098","11095","6","11101","16464","2435.281875","0.031658664375","1313706.1275000006","17.078179657499998"
"1080","11101","11094","4","11098","16468","2434.6237499999997","0.031650108749999996","1316140.7512500007","17.109829766249998"
"1081","11098","11092","7","11099","16475","2434.843125","0.031652960625","1318575.5943750006","17.141482726874997"
"1082","11099","11092","1","11093","16476","2433.526875","0.031635849375","1321009.1212500005","17.173118576249998"
"1083","11093","11092","8","11100","16484","2435.0625","0.0316558125","1323444.1837500005","17.204774388749996"
"1084","11100","11098","5","11103","16489","2435.720625","0.031664368124999995","1325879.9043750006","17.236438756874996"
"1085","11103","11102","7","11109","16496","2437.036875","0.031681479374999995","1328316.9412500006","17.268120236249995"
"1086","11109","11104","2","11106","16498","2436.3787500000003","0.031672923750000005","1330753.3200000005","17.299793159999997"
"1087","11106","11104","5","11109","16503","2437.036875","0.031681479374999995","1333190.3568750005","17.331474639374996"
"1088","11109","11103","4","11107","16507","2436.598125","0.031675775625","1335626.9550000005","17.363150414999996"
"1089","11107","11099","6","11105","16513","2436.159375","0.031670071875","1338063.1143750006","17.394820486874995"
"1090","11105","11096","1","11097","16514","2434.404375","0.031647256875","1340497.5187500005","17.426467743749996"
"1091","11097","11094","8","11102","16522","2435.5012500000003","0.03166151625","1342933.0200000005","17.458129259999996"
"1092","11102","11101","6","11107","16528","2436.598125","0.031675775625","1345369.6181250005","17.489805035624997"
"1093","11107","11101","5","11106","16533","2436.3787500000003","0.031672923750000005","1347805.9968750004","17.521477959374998"
"1094","11106","11101","4","11105","16537","2436.159375","0.031670071875","1350242.1562500005","17.553148031249997"
"1095","11105","11104","6","11110","16543","2437.25625","0.031684331249999996","1352679.4125000006","17.584832362499995"
"1096","11110","11104","4","11108","16547","2436.8175","0.0316786275","1355116.2300000004","17.616510989999995"
"1097","11108","11103","4","11107","16551","2436.598125","0.031675775625","1357552.8281250005","17.648186765624995"
"1098","11107","11100","4","11104","16555","2435.9399999999996","0.031667219999999996","1359988.7681250004","17.679853985624995"
"1099","11104","11101","6","11107","16561","2436.598125","0.031675775625","1362425.3662500004","17.711529761249995"
"1100","11107","11102","3","11105","16564","2436.159375","0.031670071875","1364861.5256250005","17.743199833124994"
"1101","11105","11098","8","11106","16572","2436.3787500000003","0.031672923750000005","1367297.9043750004","17.774872756874995"
"1102","11106","11102","7","11109","16579","2437.036875","0.031681479374999995","1369734.9412500004","17.806554236249994"
"1103","11109","11100","2","11102","16581","2435.5012500000003","0.03166151625","1372170.4425000004","17.838215752499995"
"1104","11102","11100","8","11108","16589","2436.8175","0.0316786275","1374607.2600000002","17.869894379999995"
"1105","11108","11100","8","11108","16597","2436.8175","0.0316786275","1377044.0775000001","17.901573007499994"
"1106","11108","11101","4","11105","16601","2436.159375","0.031670071875","1379480.2368750002","17.933243079374993"
"1107","11105","11098","2","11100","16603","2435.0625","0.0316558125","1381915.2993750002","17.96489889187499"
"1108","11100","11093","4","11097","16607","2434.404375","0.031647256875","1384349.70375","17.996546148749992"
"1109","11097","11092","1","11093","16608","2433.526875","0.031635849375","1386783.230625","18.028181998124992"
"1110","11093","11089","5","11094","16613","2433.7462499999997","0.03163870124999999","1389216.9768750002","18.059820699374992"
"1111","11094","11091","7","11098","16620","2434.6237499999997","0.031650108749999996","1391651.6006250002","18.091470808124992"
"1112","11098","11096","5","11101","16625","2435.281875","0.031658664375","1394086.8825000003","18.123129472499993"
"1113","11101","11093","1","11094","16626","2433.7462499999997","0.03163870124999999","1396520.6287500004","18.154768173749993"
"1114","11094","11091","1","11092","16627","2433.3075","0.031632997499999996","1398953.9362500005","18.186401171249994"
"1115","11092","11091","4","11095","16631","2433.965625","0.03164155312499999","1401387.9018750004","18.218042724374993"
"1116","11095","11094","4","11098","16635","2434.6237499999997","0.031650108749999996","1403822.5256250005","18.249692833124993"
"1117","11098","11093","1","11094","16636","2433.7462499999997","0.03163870124999999","1406256.2718750006","18.281331534374992"
"1118","11094","11090","7","11097","16643","2434.404375","0.031647256875","1408690.6762500005","18.312978791249993"
"1119","11097","11091","5","11096","16648","2434.1850000000004","0.031644405","1411124.8612500005","18.344623196249994"
"1120","11096","11095","2","11097","16650","2434.404375","0.031647256875","1413559.2656250005","18.376270453124995"
"1121","11097","11090","9","11099","16659","2434.843125","0.031652960625","1415994.1087500004","18.407923413749995"
"1122","11099","11090","6","11096","16665","2434.1850000000004","0.031644405","1418428.2937500004","18.439567818749996"
"1123","11096","11094","7","11101","16672","2435.281875","0.031658664375","1420863.5756250005","18.471226483124997"
"1124","11101","11094","3","11097","16675","2434.404375","0.031647256875","1423297.9800000004","18.50287374"
"1125","11097","11093","8","11101","16683","2435.281875","0.031658664375","1425733.2618750005","18.534532404375"
"1126","11101","11099","1","11100","16684","2435.0625","0.0316558125","1428168.3243750005","18.566188216875"
"1127","11100","11091","7","11098","16691","2434.6237499999997","0.031650108749999996","1430602.9481250006","18.597838325625"
"1128","11098","11094","6","11100","16697","2435.0625","0.0316558125","1433038.0106250006","18.629494138124997"
"1129","11100","11092","2","11094","16699","2433.7462499999997","0.03163870124999999","1435471.7568750007","18.661132839374996"
"1130","11094","11089","3","11092","16702","2433.3075","0.031632997499999996","1437905.0643750008","18.692765836874997"
"1131","11092","11084","3","11087","16705","2432.210625","0.031618738125","1440337.2750000008","18.724384575"
"1132","11087","11083","8","11091","16713","2433.088125","0.031630145625","1442770.3631250008","18.756014720625"
"1133","11091","11086","9","11095","16722","2433.965625","0.03164155312499999","1445204.3287500008","18.78765627375"
"1134","11095","11094","5","11099","16727","2434.843125","0.031652960625","1447639.1718750007","18.819309234374998"
"1135","11099","11097","3","11100","16730","2435.0625","0.0316558125","1450074.2343750007","18.850965046874997"
"1136","11100","11095","7","11102","16737","2435.5012500000003","0.03166151625","1452509.7356250007","18.882626563124997"
"1137","11102","11096","7","11103","16744","2435.720625","0.031664368124999995","1454945.4562500007","18.914290931249997"
"1138","11103","11100","5","11105","16749","2436.159375","0.031670071875","1457381.6156250008","18.945961003124996"
"1139","11105","11098","7","11105","16756","2436.159375","0.031670071875","1459817.7750000008","18.977631074999994"
"1140","11105","11103","2","11105","16758","2436.159375","0.031670071875","1462253.934375001","19.009301146874993"
"1141","11105","11100","6","11106","16764","2436.3787500000003","0.031672923750000005","1464690.3131250008","19.040974070624994"
"1142","11106","11100","2","11102","16766","2435.5012500000003","0.03166151625","1467125.8143750008","19.072635586874995"
"1143","11102","11098","2","11100","16768","2435.0625","0.0316558125","1469560.8768750008","19.104291399374993"
"1144","11100","11096","9","11105","16777","2436.159375","0.031670071875","1471997.0362500008","19.135961471249992"
"1145","11105","11101","9","11110","16786","2437.25625","0.031684331249999996","1474434.292500001","19.16764580249999"
"1146","11110","11102","6","11108","16792","2436.8175","0.0316786275","1476871.1100000008","19.19932442999999"
"1147","11108","11106","8","11114","16800","2438.13375","0.03169573875","1479309.2437500008","19.23102016874999"
"1148","11114","11108","3","11111","16803","2437.475625","0.031687183125","1481746.7193750008","19.26270735187499"
"1149","11111","11102","4","11106","16807","2436.3787500000003","0.031672923750000005","1484183.0981250007","19.29438027562499"
"1150","11106","11099","5","11104","16812","2435.9399999999996","0.031667219999999996","1486619.0381250007","19.32604749562499"
"1151","11104","11098","1","11099","16813","2434.843125","0.031652960625","1489053.8812500006","19.35770045624999"
"1152","11099","11090","4","11094","16817","2433.7462499999997","0.03163870124999999","1491487.6275000006","19.38933915749999"
"1153","11094","11087","2","11089","16819","2432.649375","0.031624441875","1493920.2768750007","19.42096359937499"
"1154","11089","11081","8","11089","16827","2432.649375","0.031624441875","1496352.9262500007","19.45258804124999"
"1155","11089","11082","3","11085","16830","2431.771875","0.031613034374999995","1498784.6981250008","19.484201075624988"
"1156","11085","11080","8","11088","16838","2432.43","0.03162159","1501217.1281250007","19.515822665624988"
"1157","11088","11085","8","11093","16846","2433.526875","0.031635849375","1503650.6550000007","19.547458514999988"
"1158","11093","11084","5","11089","16851","2432.649375","0.031624441875","1506083.3043750008","19.579082956874988"
"1159","11089","11086","9","11095","16860","2433.965625","0.03164155312499999","1508517.2700000007","19.610724509999987"
"1160","11095","11092","6","11098","16866","2434.6237499999997","0.031650108749999996","1510951.8937500007","19.642374618749987"
"1161","11098","11089","3","11092","16869","2433.3075","0.031632997499999996","1513385.2012500009","19.674007616249988"
"1162","11092","11087","7","11094","16876","2433.7462499999997","0.03163870124999999","1515818.947500001","19.705646317499987"
"1163","11094","11086","8","11094","16884","2433.7462499999997","0.03163870124999999","1518252.693750001","19.737285018749986"
"1164","11094","11087","4","11091","16888","2433.088125","0.031630145625","1520685.781875001","19.768915164374988"
"1165","11091","11086","7","11093","16895","2433.526875","0.031635849375","1523119.308750001","19.80055101374999"
"1166","11093","11090","6","11096","16901","2434.1850000000004","0.031644405","1525553.493750001","19.83219541874999"
"1167","11096","11093","7","11100","16908","2435.0625","0.0316558125","1527988.556250001","19.86385123124999"
"1168","11100","11097","6","11103","16914","2435.720625","0.031664368124999995","1530424.2768750011","19.89551559937499"
"1169","11103","11098","7","11105","16921","2436.159375","0.031670071875","1532860.4362500012","19.927185671249987"
"1170","11105","11098","5","11103","16926","2435.720625","0.031664368124999995","1535296.1568750013","19.958850039374987"
"1171","11103","11100","7","11107","16933","2436.598125","0.031675775625","1537732.7550000013","19.990525814999987"
"1172","11107","11105","1","11106","16934","2436.3787500000003","0.031672923750000005","1540169.1337500012","20.02219873874999"
"1173","11106","11104","3","11107","16937","2436.598125","0.031675775625","1542605.7318750012","20.05387451437499"
"1174","11107","11103","4","11107","16941","2436.598125","0.031675775625","1545042.3300000012","20.08555028999999"
"1175","11107","11101","9","11110","16950","2437.25625","0.031684331249999996","1547479.5862500013","20.117234621249988"
"1176","11110","11106","5","11111","16955","2437.475625","0.031687183125","1549917.0618750013","20.14892180437499"
"1177","11111","11104","2","11106","16957","2436.3787500000003","0.031672923750000005","1552353.4406250012","20.18059472812499"
"1178","11106","11104","7","11111","16964","2437.475625","0.031687183125","1554790.9162500012","20.212281911249992"
"1179","11111","11103","5","11108","16969","2436.8175","0.0316786275","1557227.733750001","20.24396053874999"
"1180","11108","11103","6","11109","16975","2437.036875","0.031681479374999995","1559664.770625001","20.27564201812499"
"1181","11109","11105","4","11109","16979","2437.036875","0.031681479374999995","1562101.807500001","20.30732349749999"
"1182","11109","11105","4","11109","16983","2437.036875","0.031681479374999995","1564538.844375001","20.33900497687499"
"1183","11109","11100","2","11102","16985","2435.5012500000003","0.03166151625","1566974.345625001","20.37066649312499"
"1184","11102","11095","9","11104","16994","2435.9399999999996","0.031667219999999996","1569410.285625001","20.40233371312499"
"1185","11104","11096","7","11103","17001","2435.720625","0.031664368124999995","1571846.006250001","20.43399808124999"
"1186","11103","11096","6","11102","17007","2435.5012500000003","0.03166151625","1574281.507500001","20.46565959749999"
"1187","11102","11098","9","11107","17016","2436.598125","0.031675775625","1576718.105625001","20.49733537312499"
"1188","11107","11099","9","11108","17025","2436.8175","0.0316786275","1579154.923125001","20.52901400062499"
"1189","11108","11105","1","11106","17026","2436.3787500000003","0.031672923750000005","1581591.3018750008","20.56068692437499"
"1190","11106","11105","1","11106","17027","2436.3787500000003","0.031672923750000005","1584027.6806250007","20.592359848124993"
"1191","11106","11099","8","11107","17035","2436.598125","0.031675775625","1586464.2787500008","20.624035623749993"
"1192","11107","11102","7","11109","17042","2437.036875","0.031681479374999995","1588901.3156250007","20.655717103124992"
"1193","11109","11103","4","11107","17046","2436.598125","0.031675775625","1591337.9137500008","20.687392878749993"
"1194","11107","11099","7","11106","17053","2436.3787500000003","0.031672923750000005","1593774.2925000007","20.719065802499994"
"1195","11106","11105","2","11107","17055","2436.598125","0.031675775625","1596210.8906250007","20.750741578124995"
"1196","11107","11102","8","11110","17063","2437.25625","0.031684331249999996","1598648.1468750008","20.782425909374993"
"1197","11110","11107","3","11110","17066","2437.25625","0.031684331249999996","1601085.403125001","20.81411024062499"
"1198","11110","11108","3","11111","17069","2437.475625","0.031687183125","1603522.8787500008","20.845797423749993"
"1199","11111","11107","2","11109","17071","2437.036875","0.031681479374999995","1605959.9156250008","20.87747890312499"
"1200","11109","11106","6","11112","17077","2437.695","0.031690035","1608397.610625001","20.909168938124992"
"1201","11112","11103","1","11104","17078","2435.9399999999996","0.031667219999999996","1610833.5506250008","20.94083615812499"
"1202","11104","11101","3","11104","17081","2435.9399999999996","0.031667219999999996","1613269.4906250008","20.97250337812499"
"1203","11104","11097","6","11103","17087","2435.720625","0.031664368124999995","1615705.2112500009","21.00416774624999"
"1204","11103","11094","7","11101","17094","2435.281875","0.031658664375","1618140.493125001","21.035826410624992"
"1205","11101","11098","4","11102","17098","2435.5012500000003","0.03166151625","1620575.994375001","21.067487926874993"
"1206","11102","11096","1","11097","17099","2434.404375","0.031647256875","1623010.3987500009","21.099135183749993"
"1207","11097","11095","4","11099","17103","2434.843125","0.031652960625","1625445.2418750008","21.130788144374993"
"1208","11099","11095","4","11099","17107","2434.843125","0.031652960625","1627880.0850000007","21.162441104999992"
"1209","11099","11098","5","11103","17112","2435.720625","0.031664368124999995","1630315.8056250007","21.194105473124992"
"1210","11103","11094","4","11098","17116","2434.6237499999997","0.031650108749999996","1632750.4293750008","21.225755581874992"
"1211","11098","11089","1","11090","17117","2432.86875","0.03162729375","1635183.2981250007","21.25738287562499"
"1212","11090","11085","5","11090","17122","2432.86875","0.03162729375","1637616.1668750006","21.28901016937499"
"1213","11090","11085","7","11092","17129","2433.3075","0.031632997499999996","1640049.4743750007","21.32064316687499"
"1214","11092","11084","4","11088","17133","2432.43","0.03162159","1642481.9043750006","21.35226475687499"
"1215","11088","11086","2","11088","17135","2432.43","0.03162159","1644914.3343750006","21.38388634687499"
"1216","11088","11082","2","11084","17137","2431.5525","0.03161018249999999","1647345.8868750005","21.41549652937499"
"1217","11084","11083","5","11088","17142","2432.43","0.03162159","1649778.3168750005","21.44711811937499"
"1218","11088","11079","9","11088","17151","2432.43","0.03162159","1652210.7468750004","21.47873970937499"
"1219","11088","11087","6","11093","17157","2433.526875","0.031635849375","1654644.2737500004","21.510375558749992"
"1220","11093","11091","5","11096","17162","2434.1850000000004","0.031644405","1657078.4587500005","21.542019963749993"
"1221","11096","11088","4","11092","17166","2433.3075","0.031632997499999996","1659511.7662500006","21.573652961249994"
"1222","11092","11086","3","11089","17169","2432.649375","0.031624441875","1661944.4156250006","21.605277403124994"
"1223","11089","11081","7","11088","17176","2432.43","0.03162159","1664376.8456250005","21.636898993124994"
"1224","11088","11082","7","11089","17183","2432.649375","0.031624441875","1666809.4950000006","21.668523434999994"
"1225","11089","11086","5","11091","17188","2433.088125","0.031630145625","1669242.5831250006","21.700153580624995"
"1226","11091","11090","1","11091","17189","2433.088125","0.031630145625","1671675.6712500006","21.731783726249997"
"1227","11091","11090","5","11095","17194","2433.965625","0.03164155312499999","1674109.6368750005","21.763425279374996"
"1228","11095","11088","5","11093","17199","2433.526875","0.031635849375","1676543.1637500005","21.795061128749996"
"1229","11093","11087","6","11093","17205","2433.526875","0.031635849375","1678976.6906250005","21.826696978124996"
"1230","11093","11088","3","11091","17208","2433.088125","0.031630145625","1681409.7787500005","21.858327123749998"
"1231","11091","11083","1","11084","17209","2431.5525","0.03161018249999999","1683841.3312500005","21.889937306249998"
"1232","11084","11083","8","11091","17217","2433.088125","0.031630145625","1686274.4193750005","21.921567451875"
"1233","11091","11085","6","11091","17223","2433.088125","0.031630145625","1688707.5075000005","21.9531975975"
"1234","11091","11090","3","11093","17226","2433.526875","0.031635849375","1691141.0343750005","21.984833446875"
"1235","11093","11087","7","11094","17233","2433.7462499999997","0.03163870124999999","1693574.7806250006","22.016472148125"
"1236","11094","11086","5","11091","17238","2433.088125","0.031630145625","1696007.8687500006","22.048102293750002"
"1237","11091","11090","5","11095","17243","2433.965625","0.03164155312499999","1698441.8343750006","22.079743846875"
"1238","11095","11093","9","11102","17252","2435.5012500000003","0.03166151625","1700877.3356250005","22.111405363125"
"1239","11102","11098","7","11105","17259","2436.159375","0.031670071875","1703313.4950000006","22.143075435"
"1240","11105","11096","9","11105","17268","2436.159375","0.031670071875","1705749.6543750006","22.174745506875"
"1241","11105","11103","6","11109","17274","2437.036875","0.031681479374999995","1708186.6912500006","22.206426986249998"
"1242","11109","11104","1","11105","17275","2436.159375","0.031670071875","1710622.8506250007","22.238097058124996"
"1243","11105","11102","2","11104","17277","2435.9399999999996","0.031667219999999996","1713058.7906250006","22.269764278124995"
"1244","11104","11103","6","11109","17283","2437.036875","0.031681479374999995","1715495.8275000006","22.301445757499994"
"1245","11109","11103","2","11105","17285","2436.159375","0.031670071875","1717931.9868750006","22.333115829374993"
"1246","11105","11104","2","11106","17287","2436.3787500000003","0.031672923750000005","1720368.3656250006","22.364788753124994"
"1247","11106","11101","6","11107","17293","2436.598125","0.031675775625","1722804.9637500006","22.396464528749995"
"1248","11107","11105","5","11110","17298","2437.25625","0.031684331249999996","1725242.2200000007","22.428148859999993"
"1249","11110","11105","9","11114","17307","2438.13375","0.03169573875","1727680.3537500007","22.459844598749992"
"1250","11114","11106","1","11107","17308","2436.598125","0.031675775625","1730116.9518750007","22.491520374374993"
"1251","11107","11100","9","11109","17317","2437.036875","0.031681479374999995","1732553.9887500007","22.523201853749992"
"1252","11109","11101","4","11105","17321","2436.159375","0.031670071875","1734990.1481250008","22.55487192562499"
"1253","11105","11103","1","11104","17322","2435.9399999999996","0.031667219999999996","1737426.0881250007","22.58653914562499"
"1254","11104","11101","2","11103","17324","2435.720625","0.031664368124999995","1739861.8087500008","22.61820351374999"
"1255","11103","11100","8","11108","17332","2436.8175","0.0316786275","1742298.6262500007","22.64988214124999"
"1256","11108","11099","9","11108","17341","2436.8175","0.0316786275","1744735.4437500006","22.68156076874999"
"1257","11108","11100","8","11108","17349","2436.8175","0.0316786275","1747172.2612500004","22.71323939624999"
"1258","11108","11102","2","11104","17351","2435.9399999999996","0.031667219999999996","1749608.2012500004","22.744906616249988"
"1259","11104","11097","1","11098","17352","2434.6237499999997","0.031650108749999996","1752042.8250000004","22.77655672499999"
"1260","11098","11091","5","11096","17357","2434.1850000000004","0.031644405","1754477.0100000005","22.80820112999999"
"1261","11096","11092","2","11094","17359","2433.7462499999997","0.03163870124999999","1756910.7562500006","22.83983983124999"
"1262","11094","11086","3","11089","17362","2432.649375","0.031624441875","1759343.4056250006","22.87146427312499"
"1263","11089","11086","6","11092","17368","2433.3075","0.031632997499999996","1761776.7131250007","22.90309727062499"
"1264","11092","11088","9","11097","17377","2434.404375","0.031647256875","1764211.1175000006","22.93474452749999"
"1265","11097","11088","5","11093","17382","2433.526875","0.031635849375","1766644.6443750006","22.96638037687499"
"1266","11093","11085","7","11092","17389","2433.3075","0.031632997499999996","1769077.9518750007","22.99801337437499"
"1267","11092","11084","2","11086","17391","2431.99125","0.031615886249999996","1771509.9431250007","23.02962926062499"
"1268","11086","11084","3","11087","17394","2432.210625","0.031618738125","1773942.1537500008","23.06124799874999"
"1269","11087","11080","2","11082","17396","2431.11375","0.03160447875","1776373.2675000008","23.092852477499992"
"1270","11082","11080","7","11087","17403","2432.210625","0.031618738125","1778805.4781250008","23.124471215624993"
"1271","11087","11081","2","11083","17405","2431.333125","0.031607330625","1781236.8112500007","23.156078546249994"
"1272","11083","11079","9","11088","17414","2432.43","0.03162159","1783669.2412500007","23.187700136249994"
"1273","11088","11087","4","11091","17418","2433.088125","0.031630145625","1786102.3293750007","23.219330281874996"
"1274","11091","11087","2","11089","17420","2432.649375","0.031624441875","1788534.9787500007","23.250954723749995"
"1275","11089","11080","1","11081","17421","2430.8943750000003","0.031601626875000004","1790965.8731250006","23.282556350624994"
"1276","11081","11072","5","11077","17426","2430.0168750000003","0.031590219375","1793395.8900000006","23.314146569999995"
"1277","11077","11071","1","11072","17427","2428.92","0.03157596","1795824.8100000005","23.345722529999996"
"1278","11072","11064","5","11069","17432","2428.2618749999997","0.031567404375","1798253.0718750006","23.377289934374996"
"1279","11069","11064","9","11073","17441","2429.1393749999997","0.031578811874999994","1800682.2112500006","23.408868746249997"
"1280","11073","11068","6","11074","17447","2429.35875","0.031581663749999996","1803111.5700000005","23.440450409999997"
"1281","11074","11072","3","11075","17450","2429.578125","0.031584515625","1805541.1481250005","23.472034925624996"
"1282","11075","11070","5","11075","17455","2429.578125","0.031584515625","1807970.7262500005","23.503619441249995"
"1283","11075","11073","6","11079","17461","2430.4556249999996","0.031595923124999994","1810401.1818750005","23.535215364374995"
"1284","11079","11078","8","11086","17469","2431.99125","0.031615886249999996","1812833.1731250004","23.566831250624993"
"1285","11086","11085","4","11089","17473","2432.649375","0.031624441875","1815265.8225000005","23.598455692499993"
"1286","11089","11082","7","11089","17480","2432.649375","0.031624441875","1817698.4718750005","23.630080134374992"
"1287","11089","11080","4","11084","17484","2431.5525","0.03161018249999999","1820130.0243750005","23.661690316874992"
"1288","11084","11079","6","11085","17490","2431.771875","0.031613034374999995","1822561.7962500006","23.69330335124999"
"1289","11085","11084","4","11088","17494","2432.43","0.03162159","1824994.2262500005","23.72492494124999"
"1290","11088","11085","9","11094","17503","2433.7462499999997","0.03163870124999999","1827427.9725000006","23.75656364249999"
"1291","11094","11085","1","11086","17504","2431.99125","0.031615886249999996","1829859.9637500006","23.78817952874999"
"1292","11086","11077","5","11082","17509","2431.11375","0.03160447875","1832291.0775000006","23.81978400749999"
"1293","11082","11075","1","11076","17510","2429.7975","0.0315873675","1834720.8750000007","23.85137137499999"
"1294","11076","11068","4","11072","17514","2428.92","0.03157596","1837149.7950000006","23.88294733499999"
"1295","11072","11064","7","11071","17521","2428.7006250000004","0.031573108125000006","1839578.4956250007","23.91452044312499"
"1296","11071","11070","8","11078","17529","2430.23625","0.03159307125","1842008.7318750008","23.94611351437499"
"1297","11078","11070","4","11074","17533","2429.35875","0.031581663749999996","1844438.0906250007","23.97769517812499"
"1298","11074","11071","6","11077","17539","2430.0168750000003","0.031590219375","1846868.1075000006","24.00928539749999"
"1299","11077","11068","5","11073","17544","2429.1393749999997","0.031578811874999994","1849297.2468750007","24.04086420937499"
"1300","11073","11067","3","11070","17547","2428.48125","0.03157025625","1851725.7281250006","24.07243446562499"
"1301","11070","11062","5","11067","17552","2427.823125","0.031561700624999994","1854153.5512500007","24.103996166249992"
"1302","11067","11063","9","11072","17561","2428.92","0.03157596","1856582.4712500006","24.135572126249993"
"1303","11072","11068","4","11072","17565","2428.92","0.03157596","1859011.3912500006","24.167148086249995"
"1304","11072","11071","1","11072","17566","2428.92","0.03157596","1861440.3112500005","24.198724046249996"
"1305","11072","11065","8","11073","17574","2429.1393749999997","0.031578811874999994","1863869.4506250005","24.230302858124997"
"1306","11073","11064","9","11073","17583","2429.1393749999997","0.031578811874999994","1866298.5900000005","24.261881669999998"
"1307","11073","11065","6","11071","17589","2428.7006250000004","0.031573108125000006","1868727.2906250006","24.293454778124996"
"1308","11071","11065","2","11067","17591","2427.823125","0.031561700624999994","1871155.1137500007","24.325016478749998"
"1309","11067","11062","7","11069","17598","2428.2618749999997","0.031567404375","1873583.3756250008","24.356583883124998"
"1310","11069","11067","7","11074","17605","2429.35875","0.031581663749999996","1876012.7343750007","24.388165546874998"
"1311","11074","11073","2","11075","17607","2429.578125","0.031584515625","1878442.3125000007","24.419750062499997"
"1312","11075","11068","4","11072","17611","2428.92","0.03157596","1880871.2325000006","24.451326022499998"
"1313","11072","11066","7","11073","17618","2429.1393749999997","0.031578811874999994","1883300.3718750007","24.482904834375"
"1314","11073","11068","9","11077","17627","2430.0168750000003","0.031590219375","1885730.3887500006","24.51449505375"
"1315","11077","11074","8","11082","17635","2431.11375","0.03160447875","1888161.5025000006","24.5460995325"
"1316","11082","11075","3","11078","17638","2430.23625","0.03159307125","1890591.7387500007","24.577692603750002"
"1317","11078","11075","7","11082","17645","2431.11375","0.03160447875","1893022.8525000007","24.609297082500003"
"1318","11082","11081","5","11086","17650","2431.99125","0.031615886249999996","1895454.8437500007","24.64091296875"
"1319","11086","11077","5","11082","17655","2431.11375","0.03160447875","1897885.9575000007","24.672517447500002"
"1320","11082","11081","3","11084","17658","2431.5525","0.03161018249999999","1900317.5100000007","24.704127630000002"
"1321","11084","11076","1","11077","17659","2430.0168750000003","0.031590219375","1902747.5268750007","24.735717849375003"
"1322","11077","11069","4","11073","17663","2429.1393749999997","0.031578811874999994","1905176.6662500007","24.767296661250004"
"1323","11073","11065","4","11069","17667","2428.2618749999997","0.031567404375","1907604.9281250008","24.798864065625004"
"1324","11069","11065","7","11072","17674","2428.92","0.03157596","1910033.8481250007","24.830440025625006"
"1325","11072","11070","5","11075","17679","2429.578125","0.031584515625","1912463.4262500007","24.862024541250005"
"1326","11075","11069","1","11070","17680","2428.48125","0.03157025625","1914891.9075000007","24.893594797500004"
"1327","11070","11069","5","11074","17685","2429.35875","0.031581663749999996","1917321.2662500006","24.925176461250004"
"1328","11074","11065","7","11072","17692","2428.92","0.03157596","1919750.1862500005","24.956752421250005"
"1329","11072","11063","6","11069","17698","2428.2618749999997","0.031567404375","1922178.4481250006","24.988319825625005"
"1330","11069","11061","8","11069","17706","2428.2618749999997","0.031567404375","1924606.7100000007","25.019887230000005"
"1331","11069","11064","4","11068","17710","2428.0425","0.031564552499999995","1927034.7525000006","25.051451782500006"
"1332","11068","11062","9","11071","17719","2428.7006250000004","0.031573108125000006","1929463.4531250007","25.083024890625005"
"1333","11071","11068","5","11073","17724","2429.1393749999997","0.031578811874999994","1931892.5925000007","25.114603702500006"
"1334","11073","11066","1","11067","17725","2427.823125","0.031561700624999994","1934320.4156250008","25.146165403125007"
"1335","11067","11062","6","11068","17731","2428.0425","0.031564552499999995","1936748.4581250008","25.177729955625008"
"1336","11068","11066","2","11068","17733","2428.0425","0.031564552499999995","1939176.5006250008","25.20929450812501"
"1337","11068","11060","3","11063","17736","2426.945625","0.031550293125","1941603.4462500007","25.24084480125001"
"1338","11063","11058","9","11067","17745","2427.823125","0.031561700624999994","1944031.2693750008","25.27240650187501"
"1339","11067","11061","9","11070","17754","2428.48125","0.03157025625","1946459.7506250008","25.30397675812501"
"1340","11070","11062","3","11065","17757","2427.384375","0.031555996875","1948887.1350000007","25.33553275500001"
"1341","11065","11059","4","11063","17761","2426.945625","0.031550293125","1951314.0806250006","25.36708304812501"
"1342","11063","11061","2","11063","17763","2426.945625","0.031550293125","1953741.0262500006","25.39863334125001"
"1343","11063","11057","8","11065","17771","2427.384375","0.031555996875","1956168.4106250005","25.43018933812501"
"1344","11065","11061","9","11070","17780","2428.48125","0.03157025625","1958596.8918750004","25.46175959437501"
"1345","11070","11069","1","11070","17781","2428.48125","0.03157025625","1961025.3731250004","25.49332985062501"
"1346","11070","11068","8","11076","17789","2429.7975","0.0315873675","1963455.1706250005","25.524917218125008"
"1347","11076","11072","2","11074","17791","2429.35875","0.031581663749999996","1965884.5293750004","25.556498881875008"
"1348","11074","11066","3","11069","17794","2428.2618749999997","0.031567404375","1968312.7912500005","25.588066286250008"
"1349","11069","11066","8","11074","17802","2429.35875","0.031581663749999996","1970742.1500000004","25.619647950000008"
"1350","11074","11070","1","11071","17803","2428.7006250000004","0.031573108125000006","1973170.8506250004","25.651221058125007"
"1351","11071","11068","7","11075","17810","2429.578125","0.031584515625","1975600.4287500004","25.682805573750006"
"1352","11075","11067","1","11068","17811","2428.0425","0.031564552499999995","1978028.4712500004","25.714370126250007"
"1353","11068","11065","8","11073","17819","2429.1393749999997","0.031578811874999994","1980457.6106250004","25.745948938125007"
"1354","11073","11067","3","11070","17822","2428.48125","0.03157025625","1982886.0918750004","25.777519194375007"
"1355","11070","11064","2","11066","17824","2427.60375","0.03155884875","1985313.6956250004","25.809078043125005"
"1356","11066","11057","5","11062","17829","2426.72625","0.03154744125","1987740.4218750005","25.840625484375007"
"1357","11062","11059","6","11065","17835","2427.384375","0.031555996875","1990167.8062500004","25.872181481250006"
"1358","11065","11058","5","11063","17840","2426.945625","0.031550293125","1992594.7518750003","25.903731774375007"
"1359","11063","11055","3","11058","17843","2425.84875","0.03153603375","1995020.6006250002","25.93526780812501"
"1360","11058","11049","8","11057","17851","2425.629375","0.031533181874999996","1997446.2300000002","25.96680099000001"
"1361","11057","11052","5","11057","17856","2425.629375","0.031533181874999996","1999871.8593750002","25.998334171875012"
"1362","11057","11056","4","11060","17860","2426.2875","0.0315417375","2002298.1468750003","26.02987590937501"
"1363","11060","11058","5","11063","17865","2426.945625","0.031550293125","2004725.0925000003","26.061426202500012"
"1364","11063","11061","6","11067","17871","2427.823125","0.031561700624999994","2007152.9156250004","26.092987903125014"
"1365","11067","11058","2","11060","17873","2426.2875","0.0315417375","2009579.2031250005","26.124529640625013"
"1366","11060","11056","7","11063","17880","2426.945625","0.031550293125","2012006.1487500004","26.156079933750014"
"1367","11063","11055","2","11057","17882","2425.629375","0.031533181874999996","2014431.7781250004","26.187613115625016"
"1368","11057","11048","2","11050","17884","2424.09375","0.031513218749999995","2016855.8718750004","26.219126334375016"
"1369","11050","11046","2","11048","17886","2423.6549999999997","0.03150751499999999","2019279.5268750004","26.250633849375017"
"1370","11048","11043","5","11048","17891","2423.6549999999997","0.03150751499999999","2021703.1818750005","26.28214136437502"
"1371","11048","11043","4","11047","17895","2423.435625","0.031504663125","2024126.6175000004","26.313646027500017"
"1372","11047","11045","1","11046","17896","2423.2162500000004","0.031501811250000004","2026549.8337500005","26.345147838750016"
"1373","11046","11040","8","11048","17904","2423.6549999999997","0.03150751499999999","2028973.4887500005","26.376655353750017"
"1374","11048","11044","3","11047","17907","2423.435625","0.031504663125","2031396.9243750004","26.408160016875016"
"1375","11047","11038","6","11044","17913","2422.7774999999997","0.031496107499999995","2033819.7018750005","26.439656124375016"
"1376","11044","11036","2","11038","17915","2421.46125","0.031478996249999995","2036241.1631250004","26.471135120625018"
"1377","11038","11035","6","11041","17921","2422.119375","0.031487551875","2038663.2825000004","26.502622672500017"
"1378","11041","11038","1","11039","17922","2421.680625","0.031481848124999996","2041084.9631250005","26.534104520625018"
"1379","11039","11035","4","11039","17926","2421.680625","0.031481848124999996","2043506.6437500005","26.56558636875002"
"1380","11039","11035","1","11036","17927","2421.0225","0.0314732925","2045927.6662500005","26.597059661250018"
"1381","11036","11032","2","11034","17929","2420.58375","0.03146758875","2048348.2500000005","26.62852725000002"
"1382","11034","11029","9","11038","17938","2421.46125","0.031478996249999995","2050769.7112500004","26.66000624625002"
"1383","11038","11033","9","11042","17947","2422.33875","0.03149040375","2053192.0500000005","26.69149665000002"
"1384","11042","11038","3","11041","17950","2422.119375","0.031487551875","2055614.1693750005","26.72298420187502"
"1385","11041","11032","3","11035","17953","2420.803125","0.031470440625","2058034.9725000006","26.75445464250002"
"1386","11035","11026","3","11029","17956","2419.4868749999996","0.03145332937499999","2060454.4593750006","26.78590797187502"
"1387","11029","11020","1","11021","17957","2417.7318750000004","0.031430514375","2062872.1912500006","26.81733848625002"
"1388","11021","11019","2","11021","17959","2417.7318750000004","0.031430514375","2065289.9231250007","26.84876900062502"
"1389","11021","11018","5","11023","17964","2418.1706249999997","0.03143621812499999","2067708.0937500007","26.880205218750017"
"1390","11023","11019","1","11020","17965","2417.5125","0.031427662499999995","2070125.6062500007","26.911632881250018"
"1391","11020","11012","9","11021","17974","2417.7318750000004","0.031430514375","2072543.3381250007","26.943063395625018"
"1392","11021","11018","7","11025","17981","2418.609375","0.031441921875","2074961.9475000007","26.974505317500018"
"1393","11025","11018","8","11026","17989","2418.82875","0.03144477375","2077380.7762500008","27.005950091250018"
"1394","11026","11017","6","11023","17995","2418.1706249999997","0.03143621812499999","2079798.9468750008","27.037386309375016"
"1395","11023","11021","4","11025","17999","2418.609375","0.031441921875","2082217.5562500008","27.068828231250016"
"1396","11025","11021","2","11023","18001","2418.1706249999997","0.03143621812499999","2084635.7268750009","27.100264449375015"
"1397","11023","11017","6","11023","18007","2418.1706249999997","0.03143621812499999","2087053.897500001","27.131700667500013"
"1398","11023","11020","2","11022","18009","2417.95125","0.03143336625","2089471.8487500008","27.163134033750012"
"1399","11022","11016","1","11017","18010","2416.854375","0.031419106875","2091888.703125001","27.19455314062501"
"1400","11017","11011","1","11012","18011","2415.7575","0.0314048475","2094304.460625001","27.22595798812501"
"1401","11012","11008","2","11010","18013","2415.31875","0.03139914375","2096719.779375001","27.25735713187501"
"1402","11010","11007","4","11011","18017","2415.538125","0.031401995625","2099135.3175000013","27.28875912750001"
"1403","11011","11005","8","11013","18025","2415.976875","0.031407699374999994","2101551.2943750015","27.32016682687501"
"1404","11013","11008","2","11010","18027","2415.31875","0.03139914375","2103966.6131250015","27.35156597062501"
"1405","11010","11006","2","11008","18029","2414.88","0.03139344","2106381.4931250014","27.38295941062501"
"1406","11008","11006","8","11014","18037","2416.19625","0.031410551249999995","2108797.6893750015","27.41436996187501"
"1407","11014","11009","5","11014","18042","2416.19625","0.031410551249999995","2111213.8856250015","27.445780513125012"
"1408","11014","11013","4","11017","18046","2416.854375","0.031419106875","2113630.7400000016","27.47719962000001"
"1409","11017","11016","7","11023","18053","2418.1706249999997","0.03143621812499999","2116048.9106250014","27.50863583812501"
"1410","11023","11019","4","11023","18057","2418.1706249999997","0.03143621812499999","2118467.081250001","27.540072056250008"
"1411","11023","11015","2","11017","18059","2416.854375","0.031419106875","2120883.9356250013","27.571491163125007"
"1412","11017","11016","4","11020","18063","2417.5125","0.031427662499999995","2123301.4481250015","27.602918825625007"
"1413","11020","11014","2","11016","18065","2416.635","0.031416255000000004","2125718.0831250013","27.634335080625007"
"1414","11016","11014","2","11016","18067","2416.635","0.031416255000000004","2128134.718125001","27.665751335625007"
"1415","11016","11013","1","11014","18068","2416.19625","0.031410551249999995","2130550.914375001","27.69716188687501"
"1416","11014","11010","1","11011","18069","2415.538125","0.031401995625","2132966.452500001","27.72856388250001"
"1417","11011","11010","6","11016","18075","2416.635","0.031416255000000004","2135383.087500001","27.75998013750001"
"1418","11016","11011","5","11016","18080","2416.635","0.031416255000000004","2137799.7225000006","27.79139639250001"
"1419","11016","11011","4","11015","18084","2416.415625","0.031413403124999996","2140216.1381250005","27.82280979562501"
"1420","11015","11007","8","11015","18092","2416.415625","0.031413403124999996","2142632.5537500004","27.85422319875001"
"1421","11015","11010","6","11016","18098","2416.635","0.031416255000000004","2145049.18875","27.88563945375001"
"1422","11016","11007","5","11012","18103","2415.7575","0.0314048475","2147464.94625","27.91704430125001"
"1423","11012","11004","6","11010","18109","2415.31875","0.03139914375","2149880.265","27.94844344500001"
"1424","11010","11007","7","11014","18116","2416.19625","0.031410551249999995","2152296.46125","27.97985399625001"
"1425","11014","11005","7","11012","18123","2415.7575","0.0314048475","2154712.21875","28.01125884375001"
"1426","11012","11004","6","11010","18129","2415.31875","0.03139914375","2157127.5375","28.04265798750001"
"1427","11010","11006","3","11009","18132","2415.099375","0.031396291874999996","2159542.6368750003","28.074054279375012"
"1428","11009","11004","1","11005","18133","2414.221875","0.031384884375","2161956.85875","28.105439163750013"
"1429","11005","10997","9","11006","18142","2414.4412500000003","0.03138773625","2164371.3000000003","28.136826900000013"
"1430","11006","10997","5","11002","18147","2413.5637500000003","0.03137632875","2166784.8637500005","28.168203228750013"
"1431","11002","10999","6","11005","18153","2414.221875","0.031384884375","2169199.0856250003","28.199588113125014"
"1432","11005","10998","4","11002","18157","2413.5637500000003","0.03137632875","2171612.6493750005","28.230964441875013"
"1433","11002","10996","1","10997","18158","2412.466875","0.031362069374999996","2174025.1162500004","28.262326511250013"
"1434","10997","10995","9","11004","18167","2414.0024999999996","0.03138203249999999","2176439.1187500004","28.293708543750014"
"1435","11004","10997","2","10999","18169","2412.905625","0.031367773125","2178852.0243750005","28.325076316875016"
"1436","10999","10991","5","10996","18174","2412.2475000000004","0.0313592175","2181264.2718750006","28.356435534375017"
"1437","10996","10991","9","11000","18183","2413.125","0.031370625","2183677.3968750006","28.387806159375018"
"1438","11000","10993","8","11001","18191","2413.344375","0.031373476875","2186090.7412500004","28.419179636250018"
"1439","11001","11000","9","11009","18200","2415.099375","0.031396291874999996","2188505.8406250007","28.45057592812502"
"1440","11009","11007","5","11012","18205","2415.7575","0.0314048475","2190921.5981250005","28.48198077562502"
"1441","11012","11006","8","11014","18213","2416.19625","0.031410551249999995","2193337.7943750005","28.51339132687502"
"1442","11014","11006","3","11009","18216","2415.099375","0.031396291874999996","2195752.8937500007","28.54478761875002"
"1443","11009","11005","6","11011","18222","2415.538125","0.031401995625","2198168.4318750007","28.57618961437502"
"1444","11011","11002","7","11009","18229","2415.099375","0.031396291874999996","2200583.531250001","28.607585906250023"
"1445","11009","11007","6","11013","18235","2415.976875","0.031407699374999994","2202999.508125001","28.63899360562502"
"1446","11013","11011","5","11016","18240","2416.635","0.031416255000000004","2205416.143125001","28.67040986062502"
"1447","11016","11009","1","11010","18241","2415.31875","0.03139914375","2207831.461875001","28.701809004375022"
"1448","11010","11001","4","11005","18245","2414.221875","0.031384884375","2210245.683750001","28.733193888750023"
"1449","11005","10999","3","11002","18248","2413.5637500000003","0.03137632875","2212659.247500001","28.764570217500022"
"1450","11002","10997","4","11001","18252","2413.344375","0.031373476875","2215072.591875001","28.795943694375023"
"1451","11001","10996","6","11002","18258","2413.5637500000003","0.03137632875","2217486.155625001","28.827320023125022"
"1452","11002","10999","2","11001","18260","2413.344375","0.031373476875","2219899.500000001","28.858693500000022"
"1453","11001","10994","7","11001","18267","2413.344375","0.031373476875","2222312.844375001","28.890066976875023"
"1454","11001","10995","2","10997","18269","2412.466875","0.031362069374999996","2224725.3112500007","28.921429046250022"
"1455","10997","10991","2","10993","18271","2411.589375","0.031350661875","2227136.9006250007","28.95277970812502"
"1456","10993","10988","5","10993","18276","2411.589375","0.031350661875","2229548.4900000007","28.98413037000002"
"1457","10993","10991","5","10996","18281","2412.2475000000004","0.0313592175","2231960.7375000007","29.01548958750002"
"1458","10996","10987","5","10992","18286","2411.37","0.03134781","2234372.107500001","29.04683739750002"
"1459","10992","10991","6","10997","18292","2412.466875","0.031362069374999996","2236784.574375001","29.07819946687502"
"1460","10997","10995","9","11004","18301","2414.0024999999996","0.03138203249999999","2239198.5768750007","29.10958149937502"
"1461","11004","10996","8","11004","18309","2414.0024999999996","0.03138203249999999","2241612.5793750007","29.140963531875023"
"1462","11004","10999","5","11004","18314","2414.0024999999996","0.03138203249999999","2244026.5818750006","29.172345564375025"
"1463","11004","10997","2","10999","18316","2412.905625","0.031367773125","2246439.4875000007","29.203713337500027"
"1464","10999","10993","2","10995","18318","2412.028125","0.03135636562499999","2248851.515625001","29.235069703125028"
"1465","10995","10990","5","10995","18323","2412.028125","0.03135636562499999","2251263.543750001","29.26642606875003"
"1466","10995","10986","6","10992","18329","2411.37","0.03134781","2253674.913750001","29.29777387875003"
"1467","10992","10988","5","10993","18334","2411.589375","0.031350661875","2256086.503125001","29.329124540625028"
"1468","10993","10991","5","10996","18339","2412.2475000000004","0.0313592175","2258498.7506250013","29.360483758125028"
"1469","10996","10991","4","10995","18343","2412.028125","0.03135636562499999","2260910.7787500015","29.39184012375003"
"1470","10995","10987","5","10992","18348","2411.37","0.03134781","2263322.1487500016","29.42318793375003"
"1471","10992","10991","1","10992","18349","2411.37","0.03134781","2265733.5187500017","29.45453574375003"
"1472","10992","10988","4","10992","18353","2411.37","0.03134781","2268144.888750002","29.48588355375003"
"1473","10992","10989","2","10991","18355","2411.150625","0.031344958125","2270556.0393750016","29.51722851187503"
"1474","10991","10987","9","10996","18364","2412.2475000000004","0.0313592175","2272968.2868750016","29.54858772937503"
"1475","10996","10988","9","10997","18373","2412.466875","0.031362069374999996","2275380.7537500015","29.57994979875003"
"1476","10997","10988","2","10990","18375","2410.93125","0.03134210625","2277791.6850000015","29.61129190500003"
"1477","10990","10983","7","10990","18382","2410.93125","0.03134210625","2280202.6162500014","29.64263401125003"
"1478","10990","10982","4","10986","18386","2410.05375","0.03133069875","2282612.6700000013","29.673964710000032"
"1479","10986","10978","2","10980","18388","2408.7375","0.031313587500000004","2285021.407500001","29.705278297500033"
"1480","10980","10975","1","10976","18389","2407.86","0.03130218","2287429.267500001","29.736580477500034"
"1481","10976","10969","1","10970","18390","2406.54375","0.03128506875","2289835.811250001","29.767865546250036"
"1482","10970","10967","5","10972","18395","2406.9825","0.0312907725","2292242.793750001","29.799156318750036"
"1483","10972","10968","5","10973","18400","2407.2018749999997","0.031293624374999995","2294649.995625001","29.830449943125036"
"1484","10973","10965","3","10968","18403","2406.105","0.031279364999999996","2297056.100625001","29.861729308125035"
"1485","10968","10966","9","10975","18412","2407.640625","0.031299328125","2299463.741250001","29.893028636250037"
"1486","10975","10966","2","10968","18414","2406.105","0.031279364999999996","2301869.846250001","29.924308001250036"
"1487","10968","10959","4","10963","18418","2405.008125","0.031265105625","2304274.854375001","29.955573106875036"
"1488","10963","10957","7","10964","18425","2405.2275","0.0312679575","2306680.081875001","29.986841064375035"
"1489","10964","10960","2","10962","18427","2404.78875","0.03126225375","2309084.870625001","30.018103318125036"
"1490","10962","10959","7","10966","18434","2405.66625","0.03127366125","2311490.5368750007","30.049376979375037"
"1491","10966","10964","7","10971","18441","2406.7631250000004","0.031287920625","2313897.3000000007","30.080664900000038"
"1492","10971","10967","6","10973","18447","2407.2018749999997","0.031293624374999995","2316304.5018750005","30.111958524375037"
"1493","10973","10968","5","10973","18452","2407.2018749999997","0.031293624374999995","2318711.7037500003","30.143252148750037"
"1494","10973","10966","8","10974","18460","2407.42125","0.03129647625","2321119.1250000005","30.174548625000035"
"1495","10974","10966","5","10971","18465","2406.7631250000004","0.031287920625","2323525.8881250005","30.205836545625036"
"1496","10971","10962","8","10970","18473","2406.54375","0.03128506875","2325932.4318750007","30.237121614375038"
"1497","10970","10968","1","10969","18474","2406.3243749999997","0.03128221687499999","2328338.7562500006","30.268403831250037"
"1498","10969","10968","9","10977","18483","2408.0793750000003","0.031305031875","2330746.8356250008","30.299708863125037"
"1499","10977","10974","2","10976","18485","2407.86","0.03130218","2333154.6956250006","30.331011043125038"
"1500","10976","10967","9","10976","18494","2407.86","0.03130218","2335562.5556250005","30.36231322312504"
"1501","10976","10969","8","10977","18502","2408.0793750000003","0.031305031875","2337970.6350000007","30.39361825500004"
"1502","10977","10974","3","10977","18505","2408.0793750000003","0.031305031875","2340378.714375001","30.42492328687504"
"1503","10977","10971","5","10976","18510","2407.86","0.03130218","2342786.574375001","30.45622546687504"
"1504","10976","10969","2","10971","18512","2406.7631250000004","0.031287920625","2345193.337500001","30.48751338750004"
"1505","10971","10964","4","10968","18516","2406.105","0.031279364999999996","2347599.442500001","30.51879275250004"
"1506","10968","10967","2","10969","18518","2406.3243749999997","0.03128221687499999","2350005.7668750007","30.55007496937504"
"1507","10969","10968","2","10970","18520","2406.54375","0.03128506875","2352412.310625001","30.58136003812504"
"1508","10970","10969","2","10971","18522","2406.7631250000004","0.031287920625","2354819.073750001","30.612647958750042"
"1509","10971","10967","6","10973","18528","2407.2018749999997","0.031293624374999995","2357226.2756250007","30.64394158312504"
"1510","10973","10965","9","10974","18537","2407.42125","0.03129647625","2359633.696875001","30.67523805937504"
"1511","10974","10967","6","10973","18543","2407.2018749999997","0.031293624374999995","2362040.8987500006","30.70653168375004"
"1512","10973","10964","5","10969","18548","2406.3243749999997","0.03128221687499999","2364447.2231250005","30.73781390062504"
"1513","10969","10961","1","10962","18549","2404.78875","0.03126225375","2366852.0118750003","30.76907615437504"
"1514","10962","10957","1","10958","18550","2403.91125","0.03125084625","2369255.923125","30.80032700062504"
"1515","10958","10950","2","10952","18552","2402.5950000000003","0.031233735000000002","2371658.5181250004","30.83156073562504"
"1516","10952","10943","2","10945","18554","2401.059375","0.031213771874999997","2374059.5775000006","30.86277450750004"
"1517","10945","10938","1","10939","18555","2399.743125","0.031196660624999997","2376459.3206250006","30.893971168125038"
"1518","10939","10937","2","10939","18557","2399.743125","0.031196660624999997","2378859.0637500007","30.925167828750038"
"1519","10939","10931","4","10935","18561","2398.865625","0.031185253124999996","2381257.9293750008","30.956353081875037"
"1520","10935","10927","6","10933","18567","2398.426875","0.031179549375","2383656.3562500007","30.987532631250037"
"1521","10933","10924","7","10931","18574","2397.9881250000003","0.031173845625000002","2386054.344375001","31.018706476875035"
"1522","10931","10929","8","10937","18582","2399.304375","0.031190956875000002","2388453.6487500006","31.049897433750036"
"1523","10937","10934","5","10939","18587","2399.743125","0.031196660624999997","2390853.3918750007","31.081094094375036"
"1524","10939","10936","5","10941","18592","2400.181875","0.031202364375","2393253.5737500004","31.112296458750038"
"1525","10941","10933","2","10935","18594","2398.865625","0.031185253124999996","2395652.4393750005","31.143481711875037"
"1526","10935","10932","5","10937","18599","2399.304375","0.031190956875000002","2398051.7437500004","31.174672668750038"
"1527","10937","10934","5","10939","18604","2399.743125","0.031196660624999997","2400451.4868750004","31.205869329375037"
"1528","10939","10935","6","10941","18610","2400.181875","0.031202364375","2402851.66875","31.23707169375004"
"1529","10941","10932","6","10938","18616","2399.52375","0.031193808749999996","2405251.1925000004","31.26826550250004"
"1530","10938","10932","9","10941","18625","2400.181875","0.031202364375","2407651.374375","31.29946786687504"
"1531","10941","10936","5","10941","18630","2400.181875","0.031202364375","2410051.55625","31.330670231250043"
"1532","10941","10935","5","10940","18635","2399.9625","0.0311995125","2412451.51875","31.36186974375004"
"1533","10940","10933","8","10941","18643","2400.181875","0.031202364375","2414851.7006249996","31.393072108125043"
"1534","10941","10935","3","10938","18646","2399.52375","0.031193808749999996","2417251.2243749998","31.424265916875044"
"1535","10938","10934","9","10943","18655","2400.620625","0.031208068125","2419651.8449999997","31.455473985000044"
"1536","10943","10939","2","10941","18657","2400.181875","0.031202364375","2422052.0268749995","31.486676349375045"
"1537","10941","10938","6","10944","18663","2400.8399999999997","0.031210919999999993","2424452.8668749994","31.517887269375045"
"1538","10944","10942","7","10949","18670","2401.936875","0.031225179374999995","2426854.8037499995","31.549112448750044"
"1539","10949","10940","4","10944","18674","2400.8399999999997","0.031210919999999993","2429255.6437499993","31.580323368750044"
"1540","10944","10939","5","10944","18679","2400.8399999999997","0.031210919999999993","2431656.483749999","31.611534288750043"
"1541","10944","10936","5","10941","18684","2400.181875","0.031202364375","2434056.665624999","31.642736653125045"
"1542","10941","10935","4","10939","18688","2399.743125","0.031196660624999997","2436456.408749999","31.673933313750045"
"1543","10939","10938","3","10941","18691","2400.181875","0.031202364375","2438856.590624999","31.705135678125046"
"1544","10941","10936","6","10942","18697","2400.40125","0.031205216249999997","2441256.991874999","31.736340894375047"
"1545","10942","10936","6","10942","18703","2400.40125","0.031205216249999997","2443657.393124999","31.767546110625048"
"1546","10942","10934","9","10943","18712","2400.620625","0.031208068125","2446058.013749999","31.79875417875005"
"1547","10943","10941","1","10942","18713","2400.40125","0.031205216249999997","2448458.414999999","31.82995939500005"
"1548","10942","10933","8","10941","18721","2400.181875","0.031202364375","2450858.596874999","31.86116175937505"
"1549","10941","10938","7","10945","18728","2401.059375","0.031213771874999997","2453259.656249999","31.89237553125005"
"1550","10945","10944","7","10951","18735","2402.375625","0.031230883125","2455662.031874999","31.92360641437505"
"1551","10951","10946","7","10953","18742","2402.814375","0.031236586874999996","2458064.846249999","31.95484300125005"
"1552","10953","10949","4","10953","18746","2402.814375","0.031236586874999996","2460467.660624999","31.98607958812505"
"1553","10953","10947","4","10951","18750","2402.375625","0.031230883125","2462870.036249999","32.01731047125005"
"1554","10951","10942","8","10950","18758","2402.15625","0.03122803125","2465272.192499999","32.04853850250005"
"1555","10950","10946","8","10954","18766","2403.0337499999996","0.031239438749999994","2467675.226249999","32.07977794125005"
"1556","10954","10948","7","10955","18773","2403.253125","0.031242290625000002","2470078.4793749987","32.11102023187505"
"1557","10955","10952","3","10955","18776","2403.253125","0.031242290625000002","2472481.7324999985","32.142262522500054"
"1558","10955","10950","5","10955","18781","2403.253125","0.031242290625000002","2474884.9856249983","32.17350481312506"
"1559","10955","10946","9","10955","18790","2403.253125","0.031242290625000002","2477288.238749998","32.20474710375006"
"1560","10955","10947","7","10954","18797","2403.0337499999996","0.031239438749999994","2479691.272499998","32.23598654250006"
"1561","10954","10947","5","10952","18802","2402.5950000000003","0.031233735000000002","2482093.8674999983","32.26722027750006"
"1562","10952","10948","4","10952","18806","2402.5950000000003","0.031233735000000002","2484496.4624999985","32.29845401250006"
"1563","10952","10946","6","10952","18812","2402.5950000000003","0.031233735000000002","2486899.0574999987","32.32968774750006"
"1564","10952","10944","7","10951","18819","2402.375625","0.031230883125","2489301.4331249986","32.36091863062506"
"1565","10951","10943","4","10947","18823","2401.498125","0.031219475625","2491702.9312499985","32.39213810625006"
"1566","10947","10944","3","10947","18826","2401.498125","0.031219475625","2494104.4293749984","32.42335758187506"
"1567","10947","10940","9","10949","18835","2401.936875","0.031225179374999995","2496506.3662499986","32.45458276125006"
"1568","10949","10943","1","10944","18836","2400.8399999999997","0.031210919999999993","2498907.2062499984","32.48579368125006"
"1569","10944","10942","7","10949","18843","2401.936875","0.031225179374999995","2501309.1431249985","32.51701886062506"
"1570","10949","10947","3","10950","18846","2402.15625","0.03122803125","2503711.2993749985","32.54824689187506"
"1571","10950","10943","6","10949","18852","2401.936875","0.031225179374999995","2506113.2362499987","32.57947207125006"
"1572","10949","10945","7","10952","18859","2402.5950000000003","0.031233735000000002","2508515.831249999","32.61070580625006"
"1573","10952","10950","8","10958","18867","2403.91125","0.03125084625","2510919.742499999","32.64195665250006"
"1574","10958","10951","2","10953","18869","2402.814375","0.031236586874999996","2513322.556874999","32.67319323937507"
"1575","10953","10947","5","10952","18874","2402.5950000000003","0.031233735000000002","2515725.151874999","32.70442697437507"
"1576","10952","10943","6","10949","18880","2401.936875","0.031225179374999995","2518127.088749999","32.73565215375007"
"1577","10949","10944","9","10953","18889","2402.814375","0.031236586874999996","2520529.9031249993","32.76688874062507"
"1578","10953","10947","6","10953","18895","2402.814375","0.031236586874999996","2522932.7174999993","32.798125327500074"
"1579","10953","10945","3","10948","18898","2401.7174999999997","0.031222327499999994","2525334.434999999","32.82934765500007"
"1580","10948","10946","9","10955","18907","2403.253125","0.031242290625000002","2527737.688124999","32.86058994562507"
"1581","10955","10948","7","10955","18914","2403.253125","0.031242290625000002","2530140.9412499988","32.891832236250075"
"1582","10955","10953","6","10959","18920","2404.130625","0.03125369812499999","2532545.071874999","32.923085934375074"
"1583","10959","10956","9","10965","18929","2405.446875","0.031270809375","2534950.518749999","32.954356743750076"
"1584","10965","10963","4","10967","18933","2405.885625","0.031276513124999995","2537356.404374999","32.985633256875076"
"1585","10967","10961","7","10968","18940","2406.105","0.031279364999999996","2539762.509374999","33.01691262187508"
"1586","10968","10961","3","10964","18943","2405.2275","0.0312679575","2542167.736874999","33.04818057937508"
"1587","10964","10958","5","10963","18948","2405.008125","0.031265105625","2544572.744999999","33.07944568500008"
"1588","10963","10959","8","10967","18956","2405.885625","0.031276513124999995","2546978.6306249993","33.11072219812508"
"1589","10967","10964","9","10973","18965","2407.2018749999997","0.031293624374999995","2549385.832499999","33.142015822500085"
"1590","10973","10969","9","10978","18974","2408.29875","0.031307883749999994","2551794.131249999","33.17332370625009"
"1591","10978","10969","2","10971","18976","2406.7631250000004","0.031287920625","2554200.894374999","33.204611626875085"
"1592","10971","10965","9","10974","18985","2407.42125","0.03129647625","2556608.3156249993","33.235908103125084"
"1593","10974","10970","8","10978","18993","2408.29875","0.031307883749999994","2559016.6143749994","33.26721598687509"
"1594","10978","10970","3","10973","18996","2407.2018749999997","0.031293624374999995","2561423.816249999","33.29850961125009"
"1595","10973","10968","2","10970","18998","2406.54375","0.03128506875","2563830.3599999994","33.32979468000009"
"1596","10970","10961","7","10968","19005","2406.105","0.031279364999999996","2566236.4649999994","33.361074045000095"
"1597","10968","10962","4","10966","19009","2405.66625","0.03127366125","2568642.131249999","33.39234770625009"
"1598","10966","10958","7","10965","19016","2405.446875","0.031270809375","2571047.578124999","33.423618515625094"
"1599","10965","10959","8","10967","19024","2405.885625","0.031276513124999995","2573453.463749999","33.454895028750094"
"1600","10967","10960","7","10967","19031","2405.885625","0.031276513124999995","2575859.3493749993","33.486171541875095"
"1601","10967","10963","1","10964","19032","2405.2275","0.0312679575","2578264.5768749993","33.517439499375094"
"1602","10964","10961","5","10966","19037","2405.66625","0.03127366125","2580670.243124999","33.54871316062509"
"1603","10966","10960","7","10967","19044","2405.885625","0.031276513124999995","2583076.128749999","33.57998967375009"
"1604","10967","10963","5","10968","19049","2406.105","0.031279364999999996","2585482.233749999","33.611269038750095"
"1605","10968","10967","9","10976","19058","2407.86","0.03130218","2587890.093749999","33.64257121875009"
"1606","10976","10969","4","10973","19062","2407.2018749999997","0.031293624374999995","2590297.295624999","33.673864843125095"
"1607","10973","10964","1","10965","19063","2405.446875","0.031270809375","2592702.742499999","33.7051356525001"
"1608","10965","10960","4","10964","19067","2405.2275","0.0312679575","2595107.969999999","33.736403610000096"
"1609","10964","10956","9","10965","19076","2405.446875","0.031270809375","2597513.4168749987","33.7676744193751"
"1610","10965","10963","5","10968","19081","2406.105","0.031279364999999996","2599919.5218749987","33.7989537843751"
"1611","10968","10959","7","10966","19088","2405.66625","0.03127366125","2602325.1881249985","33.8302274456251"
"1612","10966","10964","7","10971","19095","2406.7631250000004","0.031287920625","2604731.9512499985","33.861515366250096"
"1613","10971","10969","5","10974","19100","2407.42125","0.03129647625","2607139.3724999987","33.892811842500095"
"1614","10974","10968","6","10974","19106","2407.42125","0.03129647625","2609546.793749999","33.92410831875009"
"1615","10974","10969","4","10973","19110","2407.2018749999997","0.031293624374999995","2611953.9956249986","33.955401943125096"
"1616","10973","10972","4","10976","19114","2407.86","0.03130218","2614361.8556249985","33.986704123125094"
"1617","10976","10972","2","10974","19116","2407.42125","0.03129647625","2616769.2768749986","34.01800059937509"
"1618","10974","10972","5","10977","19121","2408.0793750000003","0.031305031875","2619177.356249999","34.04930563125009"
"1619","10977","10973","5","10978","19126","2408.29875","0.031307883749999994","2621585.654999999","34.080613515000096"
"1620","10978","10977","3","10980","19129","2408.7375","0.031313587500000004","2623994.3924999987","34.1119271025001"
"1621","10980","10977","8","10985","19137","2409.834375","0.031327846874999996","2626404.226874999","34.1432549493751"
"1622","10985","10977","6","10983","19143","2409.395625","0.031322143125","2628813.6224999987","34.1745770925001"
"1623","10983","10979","9","10988","19152","2410.4925","0.0313364025","2631224.114999999","34.205913495000104"
"1624","10988","10987","2","10989","19154","2410.711875","0.031339254375","2633634.826874999","34.2372527493751"
"1625","10989","10982","9","10991","19163","2411.150625","0.031344958125","2636045.9774999986","34.2685977075001"
"1626","10991","10986","5","10991","19168","2411.150625","0.031344958125","2638457.1281249984","34.299942665625096"
"1627","10991","10985","2","10987","19170","2410.273125","0.031333550625","2640867.4012499982","34.331276216250096"
"1628","10987","10985","6","10991","19176","2411.150625","0.031344958125","2643278.551874998","34.36262117437509"
"1629","10991","10986","2","10988","19178","2410.4925","0.0313364025","2645689.044374998","34.393957576875096"
"1630","10988","10984","6","10990","19184","2410.93125","0.03134210625","2648099.975624998","34.4252996831251"
"1631","10990","10982","6","10988","19190","2410.4925","0.0313364025","2650510.4681249983","34.4566360856251"
"1632","10988","10987","2","10989","19192","2410.711875","0.031339254375","2652921.1799999983","34.4879753400001"
"1633","10989","10987","1","10988","19193","2410.4925","0.0313364025","2655331.6724999985","34.5193117425001"
"1634","10988","10983","3","10986","19196","2410.05375","0.03133069875","2657741.7262499984","34.5506424412501"
"1635","10986","10982","6","10988","19202","2410.4925","0.0313364025","2660152.2187499986","34.5819788437501"
"1636","10988","10979","6","10985","19208","2409.834375","0.031327846874999996","2662562.0531249987","34.6133066906251"
"1637","10985","10978","9","10987","19217","2410.273125","0.031333550625","2664972.3262499985","34.6446402412501"
"1638","10987","10984","1","10985","19218","2409.834375","0.031327846874999996","2667382.1606249986","34.6759680881251"
"1639","10985","10976","6","10982","19224","2409.17625","0.03131929125","2669791.3368749986","34.7072873793751"
"1640","10982","10974","1","10975","19225","2407.640625","0.031299328125","2672198.9774999986","34.738586707500104"
"1641","10975","10967","2","10969","19227","2406.3243749999997","0.03128221687499999","2674605.3018749985","34.7698689243751"
"1642","10969","10966","3","10969","19230","2406.3243749999997","0.03128221687499999","2677011.6262499983","34.8011511412501"
"1643","10969","10968","9","10977","19239","2408.0793750000003","0.031305031875","2679419.7056249985","34.8324561731251"
"1644","10977","10974","5","10979","19244","2408.5181249999996","0.031310735624999995","2681828.2237499985","34.8637669087501"
"1645","10979","10974","3","10977","19247","2408.0793750000003","0.031305031875","2684236.3031249987","34.8950719406251"
"1646","10977","10973","8","10981","19255","2408.9568750000003","0.031316439375000005","2686645.259999999","34.9263883800001"
"1647","10981","10980","2","10982","19257","2409.17625","0.03131929125","2689054.436249999","34.9577076712501"
"1648","10982","10975","9","10984","19266","2409.615","0.031324994999999994","2691464.051249999","34.9890326662501"
"1649","10984","10982","3","10985","19269","2409.834375","0.031327846874999996","2693873.885624999","35.0203605131251"
"1650","10985","10977","3","10980","19272","2408.7375","0.031313587500000004","2696282.623124999","35.0516741006251"
"1651","10980","10978","8","10986","19280","2410.05375","0.03133069875","2698692.676874999","35.0830047993751"
"1652","10986","10980","7","10987","19287","2410.273125","0.031333550625","2701102.949999999","35.1143383500001"
"1653","10987","10981","1","10982","19288","2409.17625","0.03131929125","2703512.126249999","35.1456576412501"
"1654","10982","10974","8","10982","19296","2409.17625","0.03131929125","2705921.302499999","35.1769769325001"
"1655","10982","10979","4","10983","19300","2409.395625","0.031322143125","2708330.6981249987","35.2082990756251"
"1656","10983","10976","9","10985","19309","2409.834375","0.031327846874999996","2710740.532499999","35.2396269225001"
"1657","10985","10979","4","10983","19313","2409.395625","0.031322143125","2713149.9281249987","35.2709490656251"
"1658","10983","10982","2","10984","19315","2409.615","0.031324994999999994","2715559.543124999","35.3022740606251"
"1659","10984","10975","7","10982","19322","2409.17625","0.03131929125","2717968.719374999","35.3335933518751"
"1660","10982","10978","4","10982","19326","2409.17625","0.03131929125","2720377.895624999","35.3649126431251"
"1661","10982","10980","1","10981","19327","2408.9568750000003","0.031316439375000005","2722786.852499999","35.3962290825001"
"1662","10981","10978","6","10984","19333","2409.615","0.031324994999999994","2725196.4674999993","35.4275540775001"
"1663","10984","10976","1","10977","19334","2408.0793750000003","0.031305031875","2727604.5468749995","35.4588591093751"
"1664","10977","10972","5","10977","19339","2408.0793750000003","0.031305031875","2730012.6262499997","35.4901641412501"
"1665","10977","10974","9","10983","19348","2409.395625","0.031322143125","2732422.0218749996","35.5214862843751"
"1666","10983","10981","1","10982","19349","2409.17625","0.03131929125","2734831.1981249996","35.5528055756251"
"1667","10982","10975","5","10980","19354","2408.7375","0.031313587500000004","2737239.9356249995","35.5841191631251"
"1668","10980","10978","5","10983","19359","2409.395625","0.031322143125","2739649.3312499993","35.615441306250105"
"1669","10983","10982","4","10986","19363","2410.05375","0.03133069875","2742059.3849999993","35.6467720050001"
"1670","10986","10984","2","10986","19365","2410.05375","0.03133069875","2744469.4387499993","35.6781027037501"
"1671","10986","10984","7","10991","19372","2411.150625","0.031344958125","2746880.589374999","35.709447661875096"
"1672","10991","10986","7","10993","19379","2411.589375","0.031350661875","2749292.178749999","35.7407983237501"
"1673","10993","10984","2","10986","19381","2410.05375","0.03133069875","2751702.232499999","35.772129022500096"
"1674","10986","10984","2","10986","19383","2410.05375","0.03133069875","2754112.286249999","35.80345972125009"
"1675","10986","10984","4","10988","19387","2410.4925","0.0313364025","2756522.778749999","35.834796123750095"
"1676","10988","10986","6","10992","19393","2411.37","0.03134781","2758934.1487499992","35.866143933750095"
"1677","10992","10991","1","10992","19394","2411.37","0.03134781","2761345.5187499993","35.897491743750095"
"1678","10992","10983","5","10988","19399","2410.4925","0.0313364025","2763756.0112499995","35.9288281462501"
"1679","10988","10979","7","10986","19406","2410.05375","0.03133069875","2766166.0649999995","35.960158845000095"
"1680","10986","10985","4","10989","19410","2410.711875","0.031339254375","2768576.7768749995","35.99149809937509"
"1681","10989","10984","8","10992","19418","2411.37","0.03134781","2770988.1468749996","36.02284590937509"
"1682","10992","10987","5","10992","19423","2411.37","0.03134781","2773399.5168749997","36.05419371937509"
"1683","10992","10985","3","10988","19426","2410.4925","0.0313364025","2775810.009375","36.085530121875095"
"1684","10988","10982","5","10987","19431","2410.273125","0.031333550625","2778220.2824999997","36.116863672500095"
"1685","10987","10984","5","10989","19436","2410.711875","0.031339254375","2780630.994375","36.14820292687509"
"1686","10989","10982","1","10983","19437","2409.395625","0.031322143125","2783040.3899999997","36.179525070000096"
"1687","10983","10978","3","10981","19440","2408.9568750000003","0.031316439375000005","2785449.346875","36.21084150937509"
"1688","10981","10972","4","10976","19444","2407.86","0.03130218","2787857.2068749997","36.24214368937509"
"1689","10976","10968","5","10973","19449","2407.2018749999997","0.031293624374999995","2790264.4087499995","36.273437313750094"
"1690","10973","10966","7","10973","19456","2407.2018749999997","0.031293624374999995","2792671.6106249993","36.3047309381251"
"1691","10973","10966","8","10974","19464","2407.42125","0.03129647625","2795079.0318749994","36.336027414375096"
"1692","10974","10969","1","10970","19465","2406.54375","0.03128506875","2797485.5756249996","36.3673124831251"
"1693","10970","10967","4","10971","19469","2406.7631250000004","0.031287920625","2799892.3387499996","36.398600403750095"
"1694","10971","10962","5","10967","19474","2405.885625","0.031276513124999995","2802298.2243749998","36.429876916875095"
"1695","10967","10958","6","10964","19480","2405.2275","0.0312679575","2804703.451875","36.461144874375094"
"1696","10964","10957","8","10965","19488","2405.446875","0.031270809375","2807108.8987499997","36.492415683750096"
"1697","10965","10963","9","10972","19497","2406.9825","0.0312907725","2809515.8812499996","36.523706456250096"
"1698","10972","10964","2","10966","19499","2405.66625","0.03127366125","2811921.5474999994","36.554980117500094"
"1699","10966","10958","6","10964","19505","2405.2275","0.0312679575","2814326.7749999994","36.58624807500009"
"1700","10964","10963","5","10968","19510","2406.105","0.031279364999999996","2816732.8799999994","36.617527440000096"
"1701","10968","10964","2","10966","19512","2405.66625","0.03127366125","2819138.546249999","36.64880110125009"
"1702","10966","10965","2","10967","19514","2405.885625","0.031276513124999995","2821544.4318749993","36.680077614375094"
"1703","10967","10965","6","10971","19520","2406.7631250000004","0.031287920625","2823951.1949999994","36.71136553500009"
"1704","10971","10962","3","10965","19523","2405.446875","0.031270809375","2826356.6418749993","36.74263634437509"
"1705","10965","10961","7","10968","19530","2406.105","0.031279364999999996","2828762.7468749993","36.773915709375096"
"1706","10968","10961","8","10969","19538","2406.3243749999997","0.03128221687499999","2831169.071249999","36.805197926250095"
"1707","10969","10960","9","10969","19547","2406.3243749999997","0.03128221687499999","2833575.395624999","36.836480143125094"
"1708","10969","10962","4","10966","19551","2405.66625","0.03127366125","2835981.0618749987","36.86775380437509"
"1709","10966","10965","4","10969","19555","2406.3243749999997","0.03128221687499999","2838387.3862499986","36.89903602125009"
"1710","10969","10961","5","10966","19560","2405.66625","0.03127366125","2840793.0524999984","36.93030968250009"
"1711","10966","10962","7","10969","19567","2406.3243749999997","0.03128221687499999","2843199.376874998","36.96159189937509"
"1712","10969","10965","6","10971","19573","2406.7631250000004","0.031287920625","2845606.1399999983","36.992879820000084"
"1713","10971","10968","3","10971","19576","2406.7631250000004","0.031287920625","2848012.9031249983","37.02416774062508"
"1714","10971","10968","1","10969","19577","2406.3243749999997","0.03128221687499999","2850419.227499998","37.05544995750008"
"1715","10969","10965","2","10967","19579","2405.885625","0.031276513124999995","2852825.1131249983","37.08672647062508"
"1716","10967","10958","2","10960","19581","2404.35","0.031256549999999994","2855229.4631249984","37.11798302062508"
"1717","10960","10953","5","10958","19586","2403.91125","0.03125084625","2857633.3743749983","37.149233866875086"
"1718","10958","10955","2","10957","19588","2403.691875","0.031247994374999997","2860037.0662499983","37.18048186125009"
"1719","10957","10952","5","10957","19593","2403.691875","0.031247994374999997","2862440.7581249983","37.21172985562509"
"1720","10957","10949","4","10953","19597","2402.814375","0.031236586874999996","2864843.5724999984","37.24296644250009"
"1721","10953","10952","6","10958","19603","2403.91125","0.03125084625","2867247.4837499983","37.274217288750094"
"1722","10958","10949","1","10950","19604","2402.15625","0.03122803125","2869649.6399999983","37.305445320000096"
"1723","10950","10948","1","10949","19605","2401.936875","0.031225179374999995","2872051.5768749984","37.336670499375096"
"1724","10949","10945","1","10946","19606","2401.2787500000004","0.031216623750000002","2874452.8556249985","37.367887123125094"
"1725","10946","10937","1","10938","19607","2399.52375","0.031193808749999996","2876852.3793749986","37.39908093187509"
"1726","10938","10931","2","10933","19609","2398.426875","0.031179549375","2879250.8062499985","37.43026048125009"
"1727","10933","10929","9","10938","19618","2399.52375","0.031193808749999996","2881650.3299999987","37.461454290000084"
"1728","10938","10930","4","10934","19622","2398.64625","0.031182401249999995","2884048.976249999","37.492636691250084"
"1729","10934","10929","6","10935","19628","2398.865625","0.031185253124999996","2886447.841874999","37.523821944375086"
"1730","10935","10927","9","10936","19637","2399.085","0.031188104999999997","2888846.926874999","37.555010049375085"
"1731","10936","10927","9","10936","19646","2399.085","0.031188104999999997","2891246.011874999","37.58619815437508"
"1732","10936","10934","9","10943","19655","2400.620625","0.031208068125","2893646.632499999","37.61740622250008"
"1733","10943","10934","1","10935","19656","2398.865625","0.031185253124999996","2896045.498124999","37.64859147562508"
"1734","10935","10931","6","10937","19662","2399.304375","0.031190956875000002","2898444.802499999","37.67978243250008"
"1735","10937","10928","8","10936","19670","2399.085","0.031188104999999997","2900843.887499999","37.71097053750008"
"1736","10936","10934","5","10939","19675","2399.743125","0.031196660624999997","2903243.630624999","37.74216719812508"
"1737","10939","10934","3","10937","19678","2399.304375","0.031190956875000002","2905642.9349999987","37.77335815500008"
"1738","10937","10932","4","10936","19682","2399.085","0.031188104999999997","2908042.0199999986","37.80454626000008"
"1739","10936","10931","8","10939","19690","2399.743125","0.031196660624999997","2910441.7631249987","37.83574292062508"
"1740","10939","10931","4","10935","19694","2398.865625","0.031185253124999996","2912840.6287499988","37.86692817375008"
"1741","10935","10933","5","10938","19699","2399.52375","0.031193808749999996","2915240.152499999","37.89812198250008"
"1742","10938","10937","2","10939","19701","2399.743125","0.031196660624999997","2917639.895624999","37.92931864312508"
"1743","10939","10937","8","10945","19709","2401.059375","0.031213771874999997","2920040.954999999","37.96053241500008"
"1744","10945","10940","7","10947","19716","2401.498125","0.031219475625","2922442.453124999","37.99175189062508"
"1745","10947","10945","9","10954","19725","2403.0337499999996","0.031239438749999994","2924845.486874999","38.02299132937508"
"1746","10954","10949","5","10954","19730","2403.0337499999996","0.031239438749999994","2927248.520624999","38.05423076812508"
"1747","10954","10949","3","10952","19733","2402.5950000000003","0.031233735000000002","2929651.115624999","38.08546450312508"
"1748","10952","10951","1","10952","19734","2402.5950000000003","0.031233735000000002","2932053.7106249994","38.11669823812508"
"1749","10952","10950","6","10956","19740","2403.4725000000003","0.031245142500000003","2934457.1831249995","38.14794338062508"
"1750","10956","10948","5","10953","19745","2402.814375","0.031236586874999996","2936859.9974999996","38.17917996750008"
"1751","10953","10950","4","10954","19749","2403.0337499999996","0.031239438749999994","2939263.0312499995","38.21041940625008"
"1752","10954","10951","4","10955","19753","2403.253125","0.031242290625000002","2941666.2843749993","38.241661696875084"
"1753","10955","10951","1","10952","19754","2402.5950000000003","0.031233735000000002","2944068.8793749996","38.272895431875085"
"1754","10952","10946","5","10951","19759","2402.375625","0.031230883125","2946471.2549999994","38.30412631500008"
"1755","10951","10944","6","10950","19765","2402.15625","0.03122803125","2948873.4112499994","38.335354346250085"
"1756","10950","10943","8","10951","19773","2402.375625","0.031230883125","2951275.7868749993","38.36658522937508"
"1757","10951","10942","7","10949","19780","2401.936875","0.031225179374999995","2953677.7237499994","38.39781040875008"
"1758","10949","10940","3","10943","19783","2400.620625","0.031208068125","2956078.3443749994","38.42901847687508"
"1759","10943","10934","9","10943","19792","2400.620625","0.031208068125","2958478.9649999994","38.460226545000076"
"1760","10943","10941","1","10942","19793","2400.40125","0.031205216249999997","2960879.3662499995","38.49143176125008"
"1761","10942","10934","9","10943","19802","2400.620625","0.031208068125","2963279.9868749995","38.52263982937507"
"1762","10943","10934","5","10939","19807","2399.743125","0.031196660624999997","2965679.7299999995","38.55383649000007"
"1763","10939","10937","8","10945","19815","2401.059375","0.031213771874999997","2968080.7893749997","38.585050261875075"
"1764","10945","10943","8","10951","19823","2402.375625","0.031230883125","2970483.1649999996","38.61628114500007"
"1765","10951","10945","7","10952","19830","2402.5950000000003","0.031233735000000002","2972885.76","38.647514880000074"
"1766","10952","10949","5","10954","19835","2403.0337499999996","0.031239438749999994","2975288.7937499997","38.67875431875007"
"1767","10954","10951","3","10954","19838","2403.0337499999996","0.031239438749999994","2977691.8274999997","38.70999375750007"
"1768","10954","10946","2","10948","19840","2401.7174999999997","0.031222327499999994","2980093.5449999995","38.74121608500007"
"1769","10948","10941","3","10944","19843","2400.8399999999997","0.031210919999999993","2982494.3849999993","38.77242700500007"
"1770","10944","10939","2","10941","19845","2400.181875","0.031202364375","2984894.566874999","38.80362936937507"
"1771","10941","10934","3","10937","19848","2399.304375","0.031190956875000002","2987293.871249999","38.83482032625007"
"1772","10937","10931","9","10940","19857","2399.9625","0.0311995125","2989693.833749999","38.86601983875007"
"1773","10940","10932","3","10935","19860","2398.865625","0.031185253124999996","2992092.699374999","38.89720509187507"
"1774","10935","10927","8","10935","19868","2398.865625","0.031185253124999996","2994491.564999999","38.928390345000075"
"1775","10935","10932","3","10935","19871","2398.865625","0.031185253124999996","2996890.430624999","38.95957559812508"
"1776","10935","10934","9","10943","19880","2400.620625","0.031208068125","2999291.051249999","38.990783666250074"
"1777","10943","10938","5","10943","19885","2400.620625","0.031208068125","3001691.671874999","39.02199173437507"
"1778","10943","10937","2","10939","19887","2399.743125","0.031196660624999997","3004091.414999999","39.05318839500007"
"1779","10939","10930","7","10937","19894","2399.304375","0.031190956875000002","3006490.719374999","39.08437935187507"
"1780","10937","10933","9","10942","19903","2400.40125","0.031205216249999997","3008891.120624999","39.11558456812507"
"1781","10942","10935","2","10937","19905","2399.304375","0.031190956875000002","3011290.424999999","39.14677552500007"
"1782","10937","10936","4","10940","19909","2399.9625","0.0311995125","3013690.387499999","39.177975037500076"
"1783","10940","10938","3","10941","19912","2400.181875","0.031202364375","3016090.5693749986","39.209177401875074"
"1784","10941","10938","2","10940","19914","2399.9625","0.0311995125","3018490.5318749985","39.24037691437508"
"1785","10940","10933","9","10942","19923","2400.40125","0.031205216249999997","3020890.9331249986","39.27158213062508"
"1786","10942","10941","3","10944","19926","2400.8399999999997","0.031210919999999993","3023291.7731249984","39.30279305062508"
"1787","10944","10936","8","10944","19934","2400.8399999999997","0.031210919999999993","3025692.6131249983","39.334003970625076"
"1788","10944","10941","3","10944","19937","2400.8399999999997","0.031210919999999993","3028093.453124998","39.365214890625076"
"1789","10944","10936","3","10939","19940","2399.743125","0.031196660624999997","3030493.196249998","39.396411551250075"
"1790","10939","10936","9","10945","19949","2401.059375","0.031213771874999997","3032894.2556249984","39.42762532312508"
"1791","10945","10940","4","10944","19953","2400.8399999999997","0.031210919999999993","3035295.095624998","39.45883624312508"
"1792","10944","10940","2","10942","19955","2400.40125","0.031205216249999997","3037695.4968749983","39.49004145937508"
"1793","10942","10941","8","10949","19963","2401.936875","0.031225179374999995","3040097.4337499985","39.52126663875008"
"1794","10949","10945","9","10954","19972","2403.0337499999996","0.031239438749999994","3042500.4674999984","39.55250607750008"
"1795","10954","10951","3","10954","19975","2403.0337499999996","0.031239438749999994","3044903.5012499983","39.583745516250076"
"1796","10954","10950","6","10956","19981","2403.4725000000003","0.031245142500000003","3047306.9737499985","39.614990658750074"
"1797","10956","10948","4","10952","19985","2402.5950000000003","0.031233735000000002","3049709.5687499987","39.646224393750074"
"1798","10952","10949","4","10953","19989","2402.814375","0.031236586874999996","3052112.383124999","39.67746098062508"
"1799","10953","10951","6","10957","19995","2403.691875","0.031247994374999997","3054516.074999999","39.70870897500008"
"1800","10957","10956","6","10962","20001","2404.78875","0.03126225375","3056920.8637499986","39.73997122875008"
"1801","10962","5962","0","5962","20001","1307.91375","0.01700287875","3058228.7774999985","39.75697410750008"
"1802","5962","5957","9","5966","20010","1308.79125","0.01701428625","3059537.568749998","39.77398839375008"
"1803","5966","5960","2","5962","20012","1307.91375","0.01700287875","3060845.482499998","39.79099127250008"
"1804","5962","5954","7","5961","20019","1307.694375","0.017000026875","3062153.176874998","39.80799129937508"
"1805","5961","5956","3","5959","20022","1307.255625","0.016994323125","3063460.4324999982","39.82498562250008"
"1806","5959","5956","1","5957","20023","1306.8168749999998","0.016988619374999996","3064767.2493749983","39.84197424187508"
"1807","5957","5956","2","5958","20025","1307.03625","0.01699147125","3066074.285624998","39.85896571312508"
"1808","5958","5949","1","5950","20026","1305.28125","0.01696865625","3067379.566874998","39.87593436937508"
"1809","5950","5943","5","5948","20031","1304.8425000000002","0.016962952500000003","3068684.409374998","39.89289732187508"
"1810","5948","5939","7","5946","20038","1304.4037500000002","0.01695724875","3069988.813124998","39.909854570625086"
"1811","5946","5941","5","5946","20043","1304.4037500000002","0.01695724875","3071293.216874998","39.92681181937509"
"1812","5946","5945","3","5948","20046","1304.8425000000002","0.016962952500000003","3072598.059374998","39.94377477187509"
"1813","5948","5944","1","5945","20047","1304.184375","0.016954396875","3073902.243749998","39.96072916875009"
"1814","5945","5937","5","5942","20052","1303.52625","0.016945841249999996","3075205.769999998","39.97767501000009"
"1815","5942","5940","3","5943","20055","1303.7456250000002","0.016948693125","3076509.515624998","39.99462370312509"
"1816","5943","5937","2","5939","20057","1302.868125","0.016937285625","3077812.383749998","40.01156098875009"
"1817","5939","5933","3","5936","20060","1302.21","0.01692873","3079114.593749998","40.02848971875009"
"1818","5936","5935","7","5942","20067","1303.52625","0.016945841249999996","3080418.1199999982","40.04543556000009"
"1819","5942","5933","1","5934","20068","1301.77125","0.01692302625","3081719.8912499985","40.062358586250085"
"1820","5934","5933","2","5935","20070","1301.990625","0.016925878125","3083021.8818749986","40.079284464375085"
"1821","5935","5927","3","5930","20073","1300.89375","0.01691161875","3084322.7756249984","40.096196083125086"
"1822","5930","5929","4","5933","20077","1301.551875","0.016920174375","3085624.3274999983","40.11311625750009"
"1823","5933","5931","9","5940","20086","1303.0875","0.0169401375","3086927.414999998","40.13005639500009"
"1824","5940","5933","5","5938","20091","1302.64875","0.01693443375","3088230.0637499983","40.14699082875009"
"1825","5938","5934","3","5937","20094","1302.429375","0.016931581874999997","3089532.493124998","40.16392241062509"
"1826","5937","5929","1","5930","20095","1300.89375","0.01691161875","3090833.386874998","40.18083402937509"
"1827","5930","5921","9","5930","20104","1300.89375","0.01691161875","3092134.280624998","40.19774564812509"
"1828","5930","5927","8","5935","20112","1301.990625","0.016925878125","3093436.271249998","40.21467152625009"
"1829","5935","5934","8","5942","20120","1303.52625","0.016945841249999996","3094739.797499998","40.23161736750009"
"1830","5942","5933","8","5941","20128","1303.306875","0.016942989375","3096043.104374998","40.248560356875096"
"1831","5941","5940","4","5944","20132","1303.965","0.016951545","3097347.0693749976","40.265511901875094"
"1832","5944","5935","3","5938","20135","1302.64875","0.01693443375","3098649.718124998","40.282446335625096"
"1833","5938","5936","7","5943","20142","1303.7456250000002","0.016948693125","3099953.463749998","40.2993950287501"
"1834","5943","5937","3","5940","20145","1303.0875","0.0169401375","3101256.5512499977","40.3163351662501"
"1835","5940","5937","2","5939","20147","1302.868125","0.016937285625","3102559.4193749977","40.3332724518751"
"1836","5939","5937","8","5945","20155","1304.184375","0.016954396875","3103863.603749998","40.3502268487501"
"1837","5945","5943","6","5949","20161","1305.0618749999999","0.016965804374999997","3105168.665624998","40.367192653125095"
"1838","5949","5945","4","5949","20165","1305.0618749999999","0.016965804374999997","3106473.727499998","40.38415845750009"
"1839","5949","5943","1","5944","20166","1303.965","0.016951545","3107777.692499998","40.40111000250009"
"1840","5944","5941","4","5945","20170","1304.184375","0.016954396875","3109081.876874998","40.41806439937509"
"1841","5945","5941","1","5942","20171","1303.52625","0.016945841249999996","3110385.4031249983","40.43501024062509"
"1842","5942","5933","4","5937","20175","1302.429375","0.016931581874999997","3111687.832499998","40.45194182250009"
"1843","5937","5933","1","5934","20176","1301.77125","0.01692302625","3112989.6037499984","40.46886484875009"
"1844","5934","5930","7","5937","20183","1302.429375","0.016931581874999997","3114292.033124998","40.485796430625086"
"1845","5937","5930","7","5937","20190","1302.429375","0.016931581874999997","3115594.462499998","40.502728012500086"
"1846","5937","5936","2","5938","20192","1302.64875","0.01693443375","3116897.111249998","40.51966244625009"
"1847","5938","5929","9","5938","20201","1302.64875","0.01693443375","3118199.7599999984","40.53659688000009"
"1848","5938","5934","5","5939","20206","1302.868125","0.016937285625","3119502.6281249984","40.55353416562509"
"1849","5939","5936","6","5942","20212","1303.52625","0.016945841249999996","3120806.1543749985","40.57048000687509"
"1850","5942","5935","5","5940","20217","1303.0875","0.0169401375","3122109.2418749984","40.58742014437509"
"1851","5940","5936","6","5942","20223","1303.52625","0.016945841249999996","3123412.7681249985","40.60436598562509"
"1852","5942","5938","6","5944","20229","1303.965","0.016951545","3124716.7331249984","40.621317530625085"
"1853","5944","5943","7","5950","20236","1305.28125","0.01696865625","3126022.0143749984","40.638286186875085"
"1854","5950","5945","1","5946","20237","1304.4037500000002","0.01695724875","3127326.4181249985","40.65524343562509"
"1855","5946","5938","8","5946","20245","1304.4037500000002","0.01695724875","3128630.8218749985","40.67220068437509"
"1856","5946","5942","4","5946","20249","1304.4037500000002","0.01695724875","3129935.2256249986","40.689157933125095"
"1857","5946","5941","2","5943","20251","1303.7456250000002","0.016948693125","3131238.9712499985","40.7061066262501"
"1858","5943","5939","1","5940","20252","1303.0875","0.0169401375","3132542.0587499985","40.7230467637501"
"1859","5940","5938","3","5941","20255","1303.306875","0.016942989375","3133845.365624998","40.7399897531251"
"1860","5941","5933","5","5938","20260","1302.64875","0.01693443375","3135148.0143749984","40.7569241868751"
"1861","5938","5933","3","5936","20263","1302.21","0.01692873","3136450.2243749984","40.7738529168751"
"1862","5936","5934","9","5943","20272","1303.7456250000002","0.016948693125","3137753.9699999983","40.7908016100001"
"1863","5943","5935","6","5941","20278","1303.306875","0.016942989375","3139057.276874998","40.807744599375106"
"1864","5941","5933","5","5938","20283","1302.64875","0.01693443375","3140359.9256249983","40.82467903312511"
"1865","5938","5931","5","5936","20288","1302.21","0.01692873","3141662.1356249982","40.841607763125104"
"1866","5936","5927","8","5935","20296","1301.990625","0.016925878125","3142964.1262499983","40.858533641250105"
"1867","5935","5927","4","5931","20300","1301.113125","0.016914470625","3144265.2393749985","40.8754481118751"
"1868","5931","5927","1","5928","20301","1300.4550000000002","0.016905915","3145565.6943749986","40.892354026875104"
"1869","5928","5920","8","5928","20309","1300.4550000000002","0.016905915","3146866.1493749986","40.909259941875106"
"1870","5928","5927","7","5934","20316","1301.77125","0.01692302625","3148167.920624999","40.926182968125104"
"1871","5934","5933","5","5938","20321","1302.64875","0.01693443375","3149470.569374999","40.94311740187511"
"1872","5938","5935","6","5941","20327","1303.306875","0.016942989375","3150773.876249999","40.96006039125011"
"1873","5941","5940","8","5948","20335","1304.8425000000002","0.016962952500000003","3152078.7187499986","40.97702334375011"
"1874","5948","5941","3","5944","20338","1303.965","0.016951545","3153382.6837499985","40.99397488875011"
"1875","5944","5936","5","5941","20343","1303.306875","0.016942989375","3154685.990624998","41.01091787812511"
"1876","5941","5940","9","5949","20352","1305.0618749999999","0.016965804374999997","3155991.0524999984","41.02788368250011"
"1877","5949","5945","1","5946","20353","1304.4037500000002","0.01695724875","3157295.4562499984","41.044840931250114"
"1878","5946","5938","4","5942","20357","1303.52625","0.016945841249999996","3158598.9824999985","41.06178677250011"
"1879","5942","5936","4","5940","20361","1303.0875","0.0169401375","3159902.0699999984","41.078726910000114"
"1880","5940","5938","7","5945","20368","1304.184375","0.016954396875","3161206.2543749986","41.095681306875115"
"1881","5945","5936","2","5938","20370","1302.64875","0.01693443375","3162508.903124999","41.11261574062512"
"1882","5938","5937","3","5940","20373","1303.0875","0.0169401375","3163811.9906249987","41.12955587812512"
"1883","5940","5938","5","5943","20378","1303.7456250000002","0.016948693125","3165115.7362499987","41.14650457125012"
"1884","5943","5937","2","5939","20380","1302.868125","0.016937285625","3166418.6043749987","41.16344185687512"
"1885","5939","5931","5","5936","20385","1302.21","0.01692873","3167720.8143749987","41.180370586875114"
"1886","5936","5932","4","5936","20389","1302.21","0.01692873","3169023.0243749986","41.19729931687511"
"1887","5936","5927","3","5930","20392","1300.89375","0.01691161875","3170323.9181249985","41.21421093562511"
"1888","5930","5928","1","5929","20393","1300.6743749999998","0.016908766874999998","3171624.5924999984","41.23111970250011"
"1889","5929","5925","1","5926","20394","1300.0162500000001","0.01690021125","3172924.6087499983","41.248019913750106"
"1890","5926","5919","8","5927","20402","1300.2356249999998","0.016903063124999996","3174224.8443749985","41.264922976875106"
"1891","5927","5926","1","5927","20403","1300.2356249999998","0.016903063124999996","3175525.0799999987","41.281826040000105"
"1892","5927","5920","5","5925","20408","1299.796875","0.016897359375","3176824.8768749987","41.298723399375106"
"1893","5925","5916","3","5919","20411","1298.480625","0.016880248124999997","3178123.3574999985","41.315603647500105"
"1894","5919","5916","4","5920","20415","1298.7","0.016883099999999998","3179422.0574999987","41.332486747500106"
"1895","5920","5911","7","5918","20422","1298.2612500000002","0.016877396250000003","3180720.3187499987","41.34936414375011"
"1896","5918","5913","5","5918","20427","1298.2612500000002","0.016877396250000003","3182018.5799999987","41.36624154000011"
"1897","5918","5914","1","5915","20428","1297.603125","0.016868840625","3183316.1831249986","41.38311038062511"
"1898","5915","5912","2","5914","20430","1297.38375","0.016865988749999998","3184613.5668749986","41.39997636937511"
"1899","5914","5911","1","5912","20431","1296.945","0.016860285","3185910.5118749985","41.41683665437511"
"1900","5912","5911","7","5918","20438","1298.2612500000002","0.016877396250000003","3187208.7731249984","41.43371405062511"
"1901","5918","5914","3","5917","20441","1298.041875","0.016874544374999998","3188506.8149999985","41.45058859500011"
"1902","5917","5911","4","5915","20445","1297.603125","0.016868840625","3189804.4181249985","41.467457435625114"
"1903","5915","5913","3","5916","20448","1297.8225","0.0168716925","3191102.240624998","41.48432912812511"
"1904","5916","5907","1","5908","20449","1296.0675","0.0168488775","3192398.308124998","41.501178005625114"
"1905","5908","5902","3","5905","20452","1295.409375","0.016840321874999998","3193693.717499998","41.518018327500116"
"1906","5905","5904","5","5909","20457","1296.286875","0.016851729375","3194990.004374998","41.534870056875114"
"1907","5909","5900","8","5908","20465","1296.0675","0.0168488775","3196286.071874998","41.55171893437512"
"1908","5908","5900","7","5907","20472","1295.8481249999998","0.016846025624999997","3197581.919999998","41.56856496000012"
"1909","5907","5903","2","5905","20474","1295.409375","0.016840321874999998","3198877.329374998","41.58540528187512"
"1910","5905","5896","9","5905","20483","1295.409375","0.016840321874999998","3200172.7387499977","41.60224560375012"
"1911","5905","5904","8","5912","20491","1296.945","0.016860285","3201469.6837499975","41.61910588875012"
"1912","5912","5908","3","5911","20494","1296.725625","0.016857433124999998","3202766.4093749975","41.63596332187512"
"1913","5911","5906","8","5914","20502","1297.38375","0.016865988749999998","3204063.7931249975","41.652829310625116"
"1914","5914","5905","7","5912","20509","1296.945","0.016860285","3205360.7381249974","41.669689595625115"
"1915","5912","5906","8","5914","20517","1297.38375","0.016865988749999998","3206658.1218749974","41.686555584375114"
"1916","5914","5912","7","5919","20524","1298.480625","0.016880248124999997","3207956.6024999972","41.70343583250011"
"1917","5919","5918","8","5926","20532","1300.0162500000001","0.01690021125","3209256.618749997","41.72033604375011"
"1918","5926","5924","4","5928","20536","1300.4550000000002","0.016905915","3210557.073749997","41.73724195875011"
"1919","5928","5919","8","5927","20544","1300.2356249999998","0.016903063124999996","3211857.3093749974","41.75414502187511"
"1920","5927","5920","6","5926","20550","1300.0162500000001","0.01690021125","3213157.3256249973","41.77104523312511"
"1921","5926","5924","2","5926","20552","1300.0162500000001","0.01690021125","3214457.341874997","41.787945444375104"
"1922","5926","5919","3","5922","20555","1299.1387499999998","0.016888803749999997","3215756.480624997","41.804834248125104"
"1923","5922","5917","4","5921","20559","1298.9193750000002","0.016885951875000003","3217055.399999997","41.8217202000001"
"1924","5921","5914","7","5921","20566","1298.9193750000002","0.016885951875000003","3218354.319374997","41.8386061518751"
"1925","5921","5918","9","5927","20575","1300.2356249999998","0.016903063124999996","3219654.5549999974","41.8555092150001"
"1926","5927","5925","6","5931","20581","1301.113125","0.016914470625","3220955.6681249975","41.872423685625094"
"1927","5931","5928","5","5933","20586","1301.551875","0.016920174375","3222257.2199999974","41.889343860000096"
"1928","5933","5925","7","5932","20593","1301.3324999999998","0.016917322499999995","3223558.5524999974","41.906261182500096"
"1929","5932","5929","3","5932","20596","1301.3324999999998","0.016917322499999995","3224859.8849999974","41.923178505000095"
"1930","5932","5930","9","5939","20605","1302.868125","0.016937285625","3226162.7531249975","41.94011579062509"
"1931","5939","5935","6","5941","20611","1303.306875","0.016942989375","3227466.0599999973","41.9570587800001"
"1932","5941","5936","6","5942","20617","1303.52625","0.016945841249999996","3228769.5862499974","41.974004621250096"
"1933","5942","5933","6","5939","20623","1302.868125","0.016937285625","3230072.4543749974","41.99094190687509"
"1934","5939","5932","3","5935","20626","1301.990625","0.016925878125","3231374.4449999975","42.007867785000094"
"1935","5935","5928","8","5936","20634","1302.21","0.01692873","3232676.6549999975","42.02479651500009"
"1936","5936","5931","3","5934","20637","1301.77125","0.01692302625","3233978.4262499977","42.04171954125009"
"1937","5934","5929","8","5937","20645","1302.429375","0.016931581874999997","3235280.8556249975","42.05865112312509"
"1938","5937","5932","6","5938","20651","1302.64875","0.01693443375","3236583.5043749977","42.07558555687509"
"1939","5938","5937","7","5944","20658","1303.965","0.016951545","3237887.4693749975","42.09253710187509"
"1940","5944","5936","2","5938","20660","1302.64875","0.01693443375","3239190.1181249977","42.10947153562509"
"1941","5938","5937","2","5939","20662","1302.868125","0.016937285625","3240492.9862499977","42.12640882125009"
"1942","5939","5933","3","5936","20665","1302.21","0.01692873","3241795.1962499977","42.143337551250085"
"1943","5936","5935","5","5940","20670","1303.0875","0.0169401375","3243098.2837499976","42.160277688750085"
"1944","5940","5938","5","5943","20675","1303.7456250000002","0.016948693125","3244402.0293749976","42.17722638187509"
"1945","5943","5935","2","5937","20677","1302.429375","0.016931581874999997","3245704.4587499974","42.19415796375009"
"1946","5937","5936","7","5943","20684","1303.7456250000002","0.016948693125","3247008.2043749974","42.21110665687509"
"1947","5943","5939","3","5942","20687","1303.52625","0.016945841249999996","3248311.7306249975","42.22805249812509"
"1948","5942","5936","7","5943","20694","1303.7456250000002","0.016948693125","3249615.4762499975","42.24500119125009"
"1949","5943","5934","1","5935","20695","1301.990625","0.016925878125","3250917.4668749976","42.26192706937509"
"1950","5935","5929","9","5938","20704","1302.64875","0.01693443375","3252220.1156249978","42.27886150312509"
"1951","5938","5935","2","5937","20706","1302.429375","0.016931581874999997","3253522.5449999976","42.29579308500009"
"1952","5937","5931","9","5940","20715","1303.0875","0.0169401375","3254825.6324999975","42.31273322250009"
"1953","5940","5935","8","5943","20723","1303.7456250000002","0.016948693125","3256129.3781249975","42.329681915625095"
"1954","5943","5937","6","5943","20729","1303.7456250000002","0.016948693125","3257433.1237499975","42.3466306087501"
"1955","5943","5934","4","5938","20733","1302.64875","0.01693443375","3258735.7724999976","42.3635650425001"
"1956","5938","5932","1","5933","20734","1301.551875","0.016920174375","3260037.3243749975","42.3804852168751"
"1957","5933","5924","6","5930","20740","1300.89375","0.01691161875","3261338.2181249973","42.3973968356251"
"1958","5930","5925","9","5934","20749","1301.77125","0.01692302625","3262639.9893749976","42.4143198618751"
"1959","5934","5925","9","5934","20758","1301.77125","0.01692302625","3263941.760624998","42.4312428881251"
"1960","5934","5933","4","5937","20762","1302.429375","0.016931581874999997","3265244.1899999976","42.4481744700001"
"1961","5937","5929","7","5936","20769","1302.21","0.01692873","3266546.3999999976","42.465103200000094"
"1962","5936","5927","6","5933","20775","1301.551875","0.016920174375","3267847.9518749975","42.482023374375096"
"1963","5933","5924","3","5927","20778","1300.2356249999998","0.016903063124999996","3269148.1874999977","42.498926437500096"
"1964","5927","5920","8","5928","20786","1300.4550000000002","0.016905915","3270448.6424999977","42.5158323525001"
"1965","5928","5924","7","5931","20793","1301.113125","0.016914470625","3271749.755624998","42.532746823125095"
"1966","5931","5926","5","5931","20798","1301.113125","0.016914470625","3273050.868749998","42.54966129375009"
"1967","5931","5927","9","5936","20807","1302.21","0.01692873","3274353.078749998","42.56659002375009"
"1968","5936","5929","9","5938","20816","1302.64875","0.01693443375","3275655.727499998","42.58352445750009"
"1969","5938","5937","5","5942","20821","1303.52625","0.016945841249999996","3276959.2537499983","42.60047029875009"
"1970","5942","5937","2","5939","20823","1302.868125","0.016937285625","3278262.1218749983","42.61740758437509"
"1971","5939","5938","1","5939","20824","1302.868125","0.016937285625","3279564.9899999984","42.634344870000085"
"1972","5939","5933","1","5934","20825","1301.77125","0.01692302625","3280866.7612499986","42.65126789625008"
"1973","5934","5933","8","5941","20833","1303.306875","0.016942989375","3282170.0681249984","42.668210885625086"
"1974","5941","5935","6","5941","20839","1303.306875","0.016942989375","3283473.374999998","42.68515387500009"
"1975","5941","5936","8","5944","20847","1303.965","0.016951545","3284777.339999998","42.70210542000009"
"1976","5944","5940","9","5949","20856","1305.0618749999999","0.016965804374999997","3286082.401874998","42.719071224375085"
"1977","5949","5948","2","5950","20858","1305.28125","0.01696865625","3287387.683124998","42.736039880625086"
"1978","5950","5944","9","5953","20867","1305.9393750000002","0.016977211875000002","3288693.622499998","42.75301709250009"
"1979","5953","5952","5","5957","20872","1306.8168749999998","0.016988619374999996","3290000.439374998","42.770005711875086"
"1980","5957","5949","2","5951","20874","1305.5006250000001","0.016971508125","3291305.939999998","42.78697722000009"
"1981","5951","5945","3","5948","20877","1304.8425000000002","0.016962952500000003","3292610.782499998","42.80394017250009"
"1982","5948","5946","9","5955","20886","1306.378125","0.016982915624999997","3293917.1606249977","42.82092308812509"
"1983","5955","5946","5","5951","20891","1305.5006250000001","0.016971508125","3295222.6612499976","42.837894596250095"
"1984","5951","5944","7","5951","20898","1305.5006250000001","0.016971508125","3296528.1618749974","42.8548661043751"
"1985","5951","5948","7","5955","20905","1306.378125","0.016982915624999997","3297834.5399999972","42.8718490200001"
"1986","5955","5948","4","5952","20909","1305.7199999999998","0.016974359999999997","3299140.2599999974","42.8888233800001"
"1987","5952","5947","4","5951","20913","1305.5006250000001","0.016971508125","3300445.7606249973","42.9057948881251"
"1988","5951","5948","8","5956","20921","1306.5975","0.0169857675","3301752.3581249975","42.922780655625104"
"1989","5956","5947","8","5955","20929","1306.378125","0.016982915624999997","3303058.7362499973","42.939763571250104"
"1990","5955","5947","4","5951","20933","1305.5006250000001","0.016971508125","3304364.236874997","42.95673507937511"
"1991","5951","5945","3","5948","20936","1304.8425000000002","0.016962952500000003","3305669.079374997","42.97369803187511"
"1992","5948","5942","6","5948","20942","1304.8425000000002","0.016962952500000003","3306973.9218749967","42.99066098437511"
"1993","5948","5941","1","5942","20943","1303.52625","0.016945841249999996","3308277.448124997","43.00760682562511"
"1994","5942","5936","4","5940","20947","1303.0875","0.0169401375","3309580.5356249968","43.02454696312511"
"1995","5940","5936","8","5944","20955","1303.965","0.016951545","3310884.5006249966","43.04149850812511"
"1996","5944","5936","4","5940","20959","1303.0875","0.0169401375","3312187.5881249965","43.05843864562511"
"1997","5940","5937","9","5946","20968","1304.4037500000002","0.01695724875","3313491.9918749966","43.07539589437511"
"1998","5946","5941","4","5945","20972","1304.184375","0.016954396875","3314796.1762499968","43.09235029125011"
"1999","5945","5936","5","5941","20977","1303.306875","0.016942989375","3316099.4831249965","43.10929328062512"
"2000","5941","5939","5","5944","20982","1303.965","0.016951545","3317403.4481249964","43.126244825625115"
"2001","5944","5942","1","5943","20983","1303.7456250000002","0.016948693125","3318707.1937499964","43.14319351875012"
"2002","5943","5941","7","5948","20990","1304.8425000000002","0.016962952500000003","3320012.036249996","43.16015647125012"
"2003","5948","5943","6","5949","20996","1305.0618749999999","0.016965804374999997","3321317.0981249963","43.177122275625116"
"2004","5949","5943","1","5944","20997","1303.965","0.016951545","3322621.063124996","43.194073820625114"
"2005","5944","5941","5","5946","21002","1304.4037500000002","0.01695724875","3323925.466874996","43.21103106937512"
"2006","5946","5939","3","5942","21005","1303.52625","0.016945841249999996","3325228.9931249963","43.22797691062512"
"2007","5942","5937","3","5940","21008","1303.0875","0.0169401375","3326532.080624996","43.24491704812512"
"2008","5940","5931","7","5938","21015","1302.64875","0.01693443375","3327834.7293749964","43.26185148187512"
"2009","5938","5935","3","5938","21018","1302.64875","0.01693443375","3329137.3781249966","43.27878591562512"
"2010","5938","5937","8","5945","21026","1304.184375","0.016954396875","3330441.5624999967","43.29574031250012"
"2011","5945","5941","3","5944","21029","1303.965","0.016951545","3331745.5274999966","43.31269185750012"
"2012","5944","5943","1","5944","21030","1303.965","0.016951545","3333049.4924999964","43.32964340250012"
"2013","5944","5939","8","5947","21038","1304.6231249999998","0.016960100625","3334354.1156249964","43.34660350312512"
"2014","5947","5942","2","5944","21040","1303.965","0.016951545","3335658.080624996","43.363555048125114"
"2015","5944","5936","9","5945","21049","1304.184375","0.016954396875","3336962.2649999964","43.380509445000115"
"2016","5945","5937","7","5944","21056","1303.965","0.016951545","3338266.2299999963","43.39746099000011"
"2017","5944","5942","4","5946","21060","1304.4037500000002","0.01695724875","3339570.6337499963","43.414418238750116"
"2018","5946","5944","3","5947","21063","1304.6231249999998","0.016960100625","3340875.2568749962","43.431378339375115"
"2019","5947","5944","8","5952","21071","1305.7199999999998","0.016974359999999997","3342180.9768749964","43.448352699375114"
"2020","5952","5945","4","5949","21075","1305.0618749999999","0.016965804374999997","3343486.0387499966","43.46531850375011"
"2021","5949","5943","1","5944","21076","1303.965","0.016951545","3344790.0037499964","43.48227004875011"
"2022","5944","5937","5","5942","21081","1303.52625","0.016945841249999996","3346093.5299999965","43.49921589000011"
"2023","5942","5940","6","5946","21087","1304.4037500000002","0.01695724875","3347397.9337499966","43.51617313875011"
"2024","5946","5943","6","5949","21093","1305.0618749999999","0.016965804374999997","3348702.9956249967","43.53313894312511"
"2025","5949","5945","4","5949","21097","1305.0618749999999","0.016965804374999997","3350008.057499997","43.55010474750011"
"2026","5949","5947","6","5953","21103","1305.9393750000002","0.016977211875000002","3351313.996874997","43.56708195937511"
"2027","5953","5951","4","5955","21107","1306.378125","0.016982915624999997","3352620.3749999967","43.58406487500011"
"2028","5955","5951","4","5955","21111","1306.378125","0.016982915624999997","3353926.7531249966","43.60104779062511"
"2029","5955","5949","5","5954","21116","1306.1587499999998","0.016980063749999996","3355232.9118749965","43.61802785437511"
"2030","5954","5948","1","5949","21117","1305.0618749999999","0.016965804374999997","3356537.9737499966","43.634993658750105"
"2031","5949","5945","4","5949","21121","1305.0618749999999","0.016965804374999997","3357843.0356249968","43.6519594631251"
"2032","5949","5942","4","5946","21125","1304.4037500000002","0.01695724875","3359147.439374997","43.668916711875106"
"2033","5946","5939","7","5946","21132","1304.4037500000002","0.01695724875","3360451.843124997","43.68587396062511"
"2034","5946","5941","5","5946","21137","1304.4037500000002","0.01695724875","3361756.246874997","43.70283120937511"
"2035","5946","5945","9","5954","21146","1306.1587499999998","0.016980063749999996","3363062.405624997","43.71981127312511"
"2036","5954","5948","8","5956","21154","1306.5975","0.0169857675","3364369.003124997","43.73679704062511"
"2037","5956","5947","1","5948","21155","1304.8425000000002","0.016962952500000003","3365673.845624997","43.753759993125115"
"2038","5948","5940","5","5945","21160","1304.184375","0.016954396875","3366978.029999997","43.770714390000116"
"2039","5945","5940","2","5942","21162","1303.52625","0.016945841249999996","3368281.556249997","43.787660231250115"
"2040","5942","5938","1","5939","21163","1302.868125","0.016937285625","3369584.424374997","43.80459751687511"
"2041","5939","5930","6","5936","21169","1302.21","0.01692873","3370886.634374997","43.82152624687511"
"2042","5936","5932","5","5937","21174","1302.429375","0.016931581874999997","3372189.063749997","43.83845782875011"
"2043","5937","5933","8","5941","21182","1303.306875","0.016942989375","3373492.3706249967","43.85540081812511"
"2044","5941","5933","7","5940","21189","1303.0875","0.0169401375","3374795.4581249966","43.87234095562511"
"2045","5940","5936","9","5945","21198","1304.184375","0.016954396875","3376099.642499997","43.88929535250011"
"2046","5945","5936","7","5943","21205","1303.7456250000002","0.016948693125","3377403.388124997","43.906244045625115"
"2047","5943","5937","6","5943","21211","1303.7456250000002","0.016948693125","3378707.133749997","43.92319273875012"
"2048","5943","5934","1","5935","21212","1301.990625","0.016925878125","3380009.124374997","43.94011861687512"
"2049","5935","5932","1","5933","21213","1301.551875","0.016920174375","3381310.6762499968","43.95703879125012"
"2050","5933","5925","6","5931","21219","1301.113125","0.016914470625","3382611.789374997","43.97395326187512"
"2051","5931","5923","5","5928","21224","1300.4550000000002","0.016905915","3383912.244374997","43.99085917687512"
"2052","5928","5919","5","5924","21229","1299.5774999999999","0.016894507499999996","3385211.821874997","44.00775368437512"
"2053","5924","5919","3","5922","21232","1299.1387499999998","0.016888803749999997","3386510.960624997","44.02464248812512"
"2054","5922","5916","5","5921","21237","1298.9193750000002","0.016885951875000003","3387809.879999997","44.041528440000114"
"2055","5921","5918","1","5919","21238","1298.480625","0.016880248124999997","3389108.360624997","44.05840868812511"
"2056","5919","5914","3","5917","21241","1298.041875","0.016874544374999998","3390406.402499997","44.07528323250011"
"2057","5917","5916","5","5921","21246","1298.9193750000002","0.016885951875000003","3391705.321874997","44.09216918437511"
"2058","5921","5919","8","5927","21254","1300.2356249999998","0.016903063124999996","3393005.5574999973","44.10907224750011"
"2059","5927","5920","9","5929","21263","1300.6743749999998","0.016908766874999998","3394306.2318749973","44.12598101437511"
"2060","5929","5927","3","5930","21266","1300.89375","0.01691161875","3395607.125624997","44.14289263312511"
"2061","5930","5922","1","5923","21267","1299.3581250000002","0.016891655625","3396906.483749997","44.15978428875011"
"2062","5923","5920","4","5924","21271","1299.5774999999999","0.016894507499999996","3398206.061249997","44.17667879625011"
"2063","5924","5919","2","5921","21273","1298.9193750000002","0.016885951875000003","3399504.980624997","44.193564748125105"
"2064","5921","5919","9","5928","21282","1300.4550000000002","0.016905915","3400805.435624997","44.21047066312511"
"2065","5928","5926","5","5931","21287","1301.113125","0.016914470625","3402106.5487499973","44.227385133750104"
"2066","5931","5927","2","5929","21289","1300.6743749999998","0.016908766874999998","3403407.223124997","44.2442939006251"
"2067","5929","5925","5","5930","21294","1300.89375","0.01691161875","3404708.116874997","44.2612055193751"
"2068","5930","5926","7","5933","21301","1301.551875","0.016920174375","3406009.668749997","44.278125693750106"
"2069","5933","5925","1","5926","21302","1300.0162500000001","0.01690021125","3407309.684999997","44.2950259050001"
"2070","5926","5920","6","5926","21308","1300.0162500000001","0.01690021125","3408609.7012499967","44.3119261162501"
"2071","5926","5925","6","5931","21314","1301.113125","0.016914470625","3409910.814374997","44.328840586875096"
"2072","5931","5927","6","5933","21320","1301.551875","0.016920174375","3411212.3662499967","44.3457607612501"
"2073","5933","5929","5","5934","21325","1301.77125","0.01692302625","3412514.137499997","44.362683787500096"
"2074","5934","5928","9","5937","21334","1302.429375","0.016931581874999997","3413816.5668749968","44.379615369375095"
"2075","5937","5934","4","5938","21338","1302.64875","0.01693443375","3415119.215624997","44.3965498031251"
"2076","5938","5936","8","5944","21346","1303.965","0.016951545","3416423.180624997","44.413501348125095"
"2077","5944","5943","7","5950","21353","1305.28125","0.01696865625","3417728.461874997","44.430470004375096"
"2078","5950","5941","3","5944","21356","1303.965","0.016951545","3419032.4268749966","44.44742154937509"
"2079","5944","5943","2","5945","21358","1304.184375","0.016954396875","3420336.611249997","44.464375946250094"
"2080","5945","5943","6","5949","21364","1305.0618749999999","0.016965804374999997","3421641.673124997","44.48134175062509"
"2081","5949","5947","5","5952","21369","1305.7199999999998","0.016974359999999997","3422947.393124997","44.49831611062509"
"2082","5952","5947","3","5950","21372","1305.28125","0.01696865625","3424252.674374997","44.51528476687509"
"2083","5950","5949","9","5958","21381","1307.03625","0.01699147125","3425559.710624997","44.53227623812509"
"2084","5958","5955","7","5962","21388","1307.91375","0.01700287875","3426867.624374997","44.54927911687509"
"2085","5962","5953","3","5956","21391","1306.5975","0.0169857675","3428174.221874997","44.566264884375094"
"2086","5956","5954","4","5958","21395","1307.03625","0.01699147125","3429481.258124997","44.583256355625096"
"2087","5958","5957","2","5959","21397","1307.255625","0.016994323125","3430788.513749997","44.60025067875009"
"2088","5959","5951","9","5960","21406","1307.475","0.016997174999999996","3432095.988749997","44.617247853750094"
"2089","5960","5958","1","5959","21407","1307.255625","0.016994323125","3433403.2443749974","44.63424217687509"
"2090","5959","5954","5","5959","21412","1307.255625","0.016994323125","3434710.4999999977","44.65123650000009"
"2091","5959","5956","8","5964","21420","1308.3525","0.017008582499999998","3436018.8524999977","44.668245082500086"
"2092","5964","5957","2","5959","21422","1307.255625","0.016994323125","3437326.108124998","44.68523940562508"
"2093","5959","5958","3","5961","21425","1307.694375","0.017000026875","3438633.802499998","44.702239432500086"
"2094","5961","5955","7","5962","21432","1307.91375","0.01700287875","3439941.7162499977","44.719242311250085"
"2095","5962","5955","1","5956","21433","1306.5975","0.0169857675","3441248.313749998","44.73622807875009"
"2096","5956","5948","3","5951","21436","1305.5006250000001","0.016971508125","3442553.8143749977","44.75319958687509"
"2097","5951","5942","5","5947","21441","1304.6231249999998","0.016960100625","3443858.4374999977","44.77015968750009"
"2098","5947","5942","6","5948","21447","1304.8425000000002","0.016962952500000003","3445163.2799999975","44.78712264000009"
"2099","5948","5943","6","5949","21453","1305.0618749999999","0.016965804374999997","3446468.3418749976","44.80408844437509"
"2100","5949","5940","6","5946","21459","1304.4037500000002","0.01695724875","3447772.7456249977","44.82104569312509"
"2101","5946","5937","4","5941","21463","1303.306875","0.016942989375","3449076.0524999974","44.8379886825001"
"2102","5941","5933","5","5938","21468","1302.64875","0.01693443375","3450378.7012499976","44.8549231162501"
"2103","5938","5937","2","5939","21470","1302.868125","0.016937285625","3451681.5693749976","44.8718604018751"
"2104","5939","5934","3","5937","21473","1302.429375","0.016931581874999997","3452983.9987499975","44.888791983750096"
"2105","5937","5932","5","5937","21478","1302.429375","0.016931581874999997","3454286.4281249973","44.905723565625095"
"2106","5937","5932","6","5938","21484","1302.64875","0.01693443375","3455589.0768749975","44.9226579993751"
"2107","5938","5936","8","5944","21492","1303.965","0.016951545","3456893.0418749973","44.939609544375095"
"2108","5944","5939","1","5940","21493","1303.0875","0.0169401375","3458196.129374997","44.956549681875096"
"2109","5940","5932","6","5938","21499","1302.64875","0.01693443375","3459498.7781249974","44.9734841156251"
"2110","5938","5929","5","5934","21504","1301.77125","0.01692302625","3460800.5493749976","44.990407141875096"
"2111","5934","5928","5","5933","21509","1301.551875","0.016920174375","3462102.1012499975","45.0073273162501"
"2112","5933","5924","2","5926","21511","1300.0162500000001","0.01690021125","3463402.1174999974","45.024227527500095"
"2113","5926","5924","7","5931","21518","1301.113125","0.016914470625","3464703.2306249975","45.04114199812509"
"2114","5931","5922","9","5931","21527","1301.113125","0.016914470625","3466004.3437499977","45.05805646875009"
"2115","5931","5929","7","5936","21534","1302.21","0.01692873","3467306.5537499976","45.074985198750085"
"2116","5936","5934","7","5941","21541","1303.306875","0.016942989375","3468609.8606249974","45.09192818812509"
"2117","5941","5934","8","5942","21549","1303.52625","0.016945841249999996","3469913.3868749975","45.10887402937509"
"2118","5942","5935","3","5938","21552","1302.64875","0.01693443375","3471216.0356249977","45.12580846312509"
"2119","5938","5929","8","5937","21560","1302.429375","0.016931581874999997","3472518.4649999975","45.14274004500009"
"2120","5937","5934","2","5936","21562","1302.21","0.01692873","3473820.6749999975","45.159668775000085"
"2121","5936","5927","1","5928","21563","1300.4550000000002","0.016905915","3475121.1299999976","45.17657469000009"
"2122","5928","5922","8","5930","21571","1300.89375","0.01691161875","3476422.0237499974","45.19348630875009"
"2123","5930","5928","8","5936","21579","1302.21","0.01692873","3477724.2337499973","45.210415038750085"
"2124","5936","5930","2","5932","21581","1301.3324999999998","0.016917322499999995","3479025.5662499974","45.227332361250085"
"2125","5932","5925","7","5932","21588","1301.3324999999998","0.016917322499999995","3480326.8987499974","45.244249683750084"
"2126","5932","5923","6","5929","21594","1300.6743749999998","0.016908766874999998","3481627.5731249973","45.26115845062508"
"2127","5929","5928","4","5932","21598","1301.3324999999998","0.016917322499999995","3482928.9056249973","45.27807577312508"
"2128","5932","5924","4","5928","21602","1300.4550000000002","0.016905915","3484229.3606249974","45.294981688125084"
"2129","5928","5924","4","5928","21606","1300.4550000000002","0.016905915","3485529.8156249975","45.311887603125086"
"2130","5928","5923","8","5931","21614","1301.113125","0.016914470625","3486830.9287499976","45.32880207375008"
"2131","5931","5929","2","5931","21616","1301.113125","0.016914470625","3488132.041874998","45.34571654437508"
"2132","5931","5928","6","5934","21622","1301.77125","0.01692302625","3489433.813124998","45.36263957062508"
"2133","5934","5926","1","5927","21623","1300.2356249999998","0.016903063124999996","3490734.048749998","45.37954263375008"
"2134","5927","5924","1","5925","21624","1299.796875","0.016897359375","3492033.845624998","45.39643999312508"
"2135","5925","5919","5","5924","21629","1299.5774999999999","0.016894507499999996","3493333.4231249983","45.413334500625076"
"2136","5924","5915","8","5923","21637","1299.3581250000002","0.016891655625","3494632.781249998","45.43022615625008"
"2137","5923","5922","9","5931","21646","1301.113125","0.016914470625","3495933.8943749983","45.447140626875075"
"2138","5931","5922","5","5927","21651","1300.2356249999998","0.016903063124999996","3497234.1299999985","45.464043690000075"
"2139","5927","5926","9","5935","21660","1301.990625","0.016925878125","3498536.1206249986","45.480969568125076"
"2140","5935","5927","1","5928","21661","1300.4550000000002","0.016905915","3499836.5756249987","45.49787548312508"
"2141","5928","5925","6","5931","21667","1301.113125","0.016914470625","3501137.688749999","45.514789953750075"
"2142","5931","5925","8","5933","21675","1301.551875","0.016920174375","3502439.2406249987","45.53171012812508"
"2143","5933","5925","9","5934","21684","1301.77125","0.01692302625","3503741.011874999","45.548633154375075"
"2144","5934","5927","7","5934","21691","1301.77125","0.01692302625","3505042.783124999","45.56555618062507"
"2145","5934","5931","9","5940","21700","1303.0875","0.0169401375","3506345.870624999","45.582496318125074"
"2146","5940","5933","8","5941","21708","1303.306875","0.016942989375","3507649.177499999","45.59943930750008"
"2147","5941","5936","6","5942","21714","1303.52625","0.016945841249999996","3508952.703749999","45.616385148750076"
"2148","5942","5939","4","5943","21718","1303.7456250000002","0.016948693125","3510256.449374999","45.63333384187508"
"2149","5943","5934","9","5943","21727","1303.7456250000002","0.016948693125","3511560.194999999","45.65028253500008"
"2150","5943","5941","8","5949","21735","1305.0618749999999","0.016965804374999997","3512865.256874999","45.66724833937508"
"2151","5949","5946","1","5947","21736","1304.6231249999998","0.016960100625","3514169.879999999","45.68420844000008"
"2152","5947","5942","7","5949","21743","1305.0618749999999","0.016965804374999997","3515474.941874999","45.701174244375075"
"2153","5949","5943","8","5951","21751","1305.5006250000001","0.016971508125","3516780.442499999","45.71814575250008"
"2154","5951","5950","5","5955","21756","1306.378125","0.016982915624999997","3518086.820624999","45.73512866812508"
"2155","5955","5948","2","5950","21758","1305.28125","0.01696865625","3519392.101874999","45.75209732437508"
"2156","5950","5945","6","5951","21764","1305.5006250000001","0.016971508125","3520697.6024999986","45.76906883250008"
"2157","5951","5942","1","5943","21765","1303.7456250000002","0.016948693125","3522001.3481249986","45.786017525625084"
"2158","5943","5938","5","5943","21770","1303.7456250000002","0.016948693125","3523305.0937499986","45.802966218750086"
"2159","5943","5940","6","5946","21776","1304.4037500000002","0.01695724875","3524609.4974999987","45.81992346750009"
"2160","5946","5937","8","5945","21784","1304.184375","0.016954396875","3525913.681874999","45.83687786437509"
"2161","5945","5939","5","5944","21789","1303.965","0.016951545","3527217.6468749987","45.85382940937509"
"2162","5944","5943","4","5947","21793","1304.6231249999998","0.016960100625","3528522.2699999986","45.87078951000009"
"2163","5947","5941","6","5947","21799","1304.6231249999998","0.016960100625","3529826.8931249985","45.887749610625086"
"2164","5947","5945","7","5952","21806","1305.7199999999998","0.016974359999999997","3531132.6131249988","45.904723970625085"
"2165","5952","5949","9","5958","21815","1307.03625","0.01699147125","3532439.6493749986","45.92171544187509"
"2166","5958","5957","1","5958","21816","1307.03625","0.01699147125","3533746.6856249985","45.93870691312509"
"2167","5958","5953","4","5957","21820","1306.8168749999998","0.016988619374999996","3535053.5024999985","45.95569553250009"
"2168","5957","5953","6","5959","21826","1307.255625","0.016994323125","3536360.758124999","45.972689855625084"
"2169","5959","5953","7","5960","21833","1307.475","0.016997174999999996","3537668.233124999","45.989687030625085"
"2170","5960","5954","6","5960","21839","1307.475","0.016997174999999996","3538975.708124999","46.006684205625085"
"2171","5960","5954","4","5958","21843","1307.03625","0.01699147125","3540282.744374999","46.02367567687509"
"2172","5958","5953","6","5959","21849","1307.255625","0.016994323125","3541589.999999999","46.040670000000084"
"2173","5959","5958","8","5966","21857","1308.79125","0.01701428625","3542898.791249999","46.05768428625009"
"2174","5966","5961","5","5966","21862","1308.79125","0.01701428625","3544207.5824999986","46.07469857250009"
"2175","5966","5964","6","5970","21868","1309.66875","0.01702569375","3545517.251249999","46.09172426625009"
"2176","5970","5966","8","5974","21876","1310.5462499999999","0.01703710125","3546827.797499999","46.10876136750009"
"2177","5974","5973","2","5975","21878","1310.765625","0.017039953125","3548138.563124999","46.12580132062509"
"2178","5975","5969","7","5976","21885","1310.9850000000001","0.017042805","3549449.548124999","46.14284412562509"
"2179","5976","5971","9","5980","21894","1311.8625","0.0170542125","3550761.4106249986","46.15989833812509"
"2180","5980","5974","1","5975","21895","1310.765625","0.017039953125","3552072.1762499986","46.17693829125009"
"2181","5975","5971","2","5973","21897","1310.3268750000002","0.017034249375","3553382.5031249984","46.19397254062509"
"2182","5973","5964","4","5968","21901","1309.2300000000002","0.017019990000000002","3554691.7331249984","46.21099253062509"
"2183","5968","5960","7","5967","21908","1309.010625","0.017017138124999998","3556000.7437499985","46.22800966875009"
"2184","5967","5961","2","5963","21910","1308.133125","0.017005730625","3557308.8768749987","46.24501539937509"
"2185","5963","5956","8","5964","21918","1308.3525","0.017008582499999998","3558617.2293749987","46.26202398187509"
"2186","5964","5962","4","5966","21922","1308.79125","0.01701428625","3559926.0206249985","46.27903826812509"
"2187","5966","5962","3","5965","21925","1308.571875","0.017011434375","3561234.5924999984","46.29604970250009"
"2188","5965","5958","3","5961","21928","1307.694375","0.017000026875","3562542.2868749984","46.313049729375095"
"2189","5961","5955","9","5964","21937","1308.3525","0.017008582499999998","3563850.6393749984","46.33005831187509"
"2190","5964","5956","9","5965","21946","1308.571875","0.017011434375","3565159.2112499983","46.34706974625009"
"2191","5965","5964","9","5973","21955","1310.3268750000002","0.017034249375","3566469.538124998","46.36410399562509"
"2192","5973","5966","7","5973","21962","1310.3268750000002","0.017034249375","3567779.864999998","46.381138245000095"
"2193","5973","5965","3","5968","21965","1309.2300000000002","0.017019990000000002","3569089.094999998","46.398158235000096"
"2194","5968","5960","9","5969","21974","1309.449375","0.017022841874999996","3570398.5443749977","46.41518107687509"
"2195","5969","5968","3","5971","21977","1309.8881250000002","0.017028545625000002","3571708.432499998","46.432209622500096"
"2196","5971","5970","2","5972","21979","1310.1074999999998","0.017031397499999996","3573018.5399999977","46.449241020000095"
"2197","5972","5971","1","5972","21980","1310.1074999999998","0.017031397499999996","3574328.6474999976","46.46627241750009"
"2198","5972","5971","6","5977","21986","1311.2043749999998","0.017045656874999995","3575639.851874998","46.48331807437509"
"2199","5977","5972","5","5977","21991","1311.2043749999998","0.017045656874999995","3576951.056249998","46.50036373125009"
"2200","5977","5974","7","5981","21998","1312.081875","0.017057064375","3578263.138124998","46.51742079562509"
"2201","5981","5976","5","5981","22003","1312.081875","0.017057064375","3579575.2199999983","46.534477860000095"
"2202","5981","5978","9","5987","22012","1313.398125","0.017074175624999997","3580888.618124998","46.55155203562509"
"2203","5987","5986","5","5991","22017","1314.275625","0.017085583124999998","3582202.893749998","46.568637618750095"
"2204","5991","5987","6","5993","22023","1314.7143750000002","0.017091286875000004","3583517.608124998","46.585728905625096"
"2205","5993","5986","4","5990","22027","1314.05625","0.01708273125","3584831.664374998","46.602811636875096"
"2206","5990","5986","2","5988","22029","1313.6175","0.0170770275","3586145.281874998","46.6198886643751"
"2207","5988","5986","3","5989","22032","1313.836875","0.017079879375","3587459.118749998","46.63696854375009"
"2208","5989","5980","8","5988","22040","1313.6175","0.0170770275","3588772.736249998","46.654045571250094"
"2209","5988","5982","8","5990","22048","1314.05625","0.01708273125","3590086.792499998","46.671128302500094"
"2210","5990","5989","7","5996","22055","1315.3725000000002","0.0170998425","3591402.164999998","46.688228145000096"
"2211","5996","5994","9","6003","22064","1316.9081250000002","0.017119805625","3592719.0731249982","46.7053479506251"
"2212","6003","5999","4","6003","22068","1316.9081250000002","0.017119805625","3594035.9812499983","46.7224677562501"
"2213","6003","5995","1","5996","22069","1315.3725000000002","0.0170998425","3595351.3537499984","46.7395675987501"
"2214","5996","5994","3","5997","22072","1315.5918749999998","0.017102694374999998","3596666.9456249983","46.7566702931251"
"2215","5997","5988","6","5994","22078","1314.93375","0.017094138749999998","3597981.879374998","46.773764431875094"
"2216","5994","5991","6","5997","22084","1315.5918749999998","0.017102694374999998","3599297.471249998","46.79086712625009"
"2217","5997","5991","2","5993","22086","1314.7143750000002","0.017091286875000004","3600612.185624998","46.80795841312509"
"2218","5993","5985","6","5991","22092","1314.275625","0.017085583124999998","3601926.461249998","46.825043996250095"
"2219","5991","5986","8","5994","22100","1314.93375","0.017094138749999998","3603241.3949999977","46.84213813500009"
"2220","5994","5985","6","5991","22106","1314.275625","0.017085583124999998","3604555.6706249975","46.859223718125094"
"2221","5991","5990","8","5998","22114","1315.8112500000002","0.017105546250000003","3605871.4818749973","46.876329264375094"
"2222","5998","5994","8","6002","22122","1316.6887499999998","0.017116953749999997","3607188.1706249975","46.89344621812509"
"2223","6002","5997","5","6002","22127","1316.6887499999998","0.017116953749999997","3608504.8593749977","46.91056317187509"
"2224","6002","5997","3","6000","22130","1316.25","0.017111249999999998","3609821.1093749977","46.92767442187509"
"2225","6000","5999","2","6001","22132","1316.4693750000001","0.017114101875","3611137.5787499975","46.94478852375009"
"2226","6001","5996","9","6005","22141","1317.346875","0.017125509374999997","3612454.9256249974","46.96191403312509"
"2227","6005","6004","1","6005","22142","1317.346875","0.017125509374999997","3613772.272499997","46.97903954250009"
"2228","6005","6004","2","6006","22144","1317.56625","0.01712836125","3615089.8387499973","46.99616790375009"
"2229","6006","5998","3","6001","22147","1316.4693750000001","0.017114101875","3616406.308124997","47.01328200562509"
"2230","6001","5995","7","6002","22154","1316.6887499999998","0.017116953749999997","3617722.9968749974","47.03039895937509"
"2231","6002","6001","7","6008","22161","1318.005","0.017134065","3619041.0018749973","47.04753302437509"
"2232","6008","6006","2","6008","22163","1318.005","0.017134065","3620359.006874997","47.06466708937509"
"2233","6008","5999","8","6007","22171","1317.7856249999998","0.017131213124999996","3621676.792499997","47.08179830250009"
"2234","6007","6000","9","6009","22180","1318.224375","0.017136916874999998","3622995.0168749974","47.09893521937509"
"2235","6009","6007","1","6008","22181","1318.005","0.017134065","3624313.0218749973","47.116069284375094"
"2236","6008","6007","6","6013","22187","1319.101875","0.017148324375","3625632.1237499975","47.133217608750094"
"2237","6013","6006","7","6013","22194","1319.101875","0.017148324375","3626951.2256249976","47.150365933125094"
"2238","6013","6011","6","6017","22200","1319.979375","0.017159731874999997","3628271.2049999977","47.16752566500009"
"2239","6017","6016","6","6022","22206","1321.0762499999998","0.017173991249999996","3629592.2812499977","47.18469965625009"
"2240","6022","6013","3","6016","22209","1319.76","0.01715688","3630912.0412499974","47.20185653625009"
"2241","6016","6013","3","6016","22212","1319.76","0.01715688","3632231.801249997","47.21901341625009"
"2242","6016","6009","6","6015","22218","1319.540625","0.017154028125","3633551.341874997","47.23616744437509"
"2243","6015","6007","9","6016","22227","1319.76","0.01715688","3634871.101874997","47.25332432437509"
"2244","6016","6014","8","6022","22235","1321.0762499999998","0.017173991249999996","3636192.178124997","47.27049831562509"
"2245","6022","6015","2","6017","22237","1319.979375","0.017159731874999997","3637512.157499997","47.28765804750009"
"2246","6017","6009","4","6013","22241","1319.101875","0.017148324375","3638831.259374997","47.30480637187509"
"2247","6013","6005","7","6012","22248","1318.8825","0.017145472499999998","3640150.141874997","47.321951844375086"
"2248","6012","6006","7","6013","22255","1319.101875","0.017148324375","3641469.243749997","47.339100168750086"
"2249","6013","6004","7","6011","22262","1318.663125","0.017142620625","3642787.906874997","47.35624278937509"
"2250","6011","6009","8","6017","22270","1319.979375","0.017159731874999997","3644107.886249997","47.373402521250085"
"2251","6017","6010","3","6013","22273","1319.101875","0.017148324375","3645426.9881249974","47.390550845625086"
"2252","6013","6004","5","6009","22278","1318.224375","0.017136916874999998","3646745.2124999976","47.40768776250009"
"2253","6009","6005","9","6014","22287","1319.32125","0.017151176249999997","3648064.5337499976","47.42483893875009"
"2254","6014","6012","3","6015","22290","1319.540625","0.017154028125","3649384.0743749975","47.44199296687509"
"2255","6015","6014","6","6020","22296","1320.6375","0.0171682875","3650704.7118749977","47.45916125437509"
"2256","6020","6015","8","6023","22304","1321.2956250000002","0.017176843125","3652026.0074999975","47.47633809750009"
"2257","6023","6020","5","6025","22309","1321.734375","0.017182546875","3653347.7418749975","47.49352064437509"
"2258","6025","6018","3","6021","22312","1320.8568750000002","0.017171139375","3654668.5987499976","47.51069178375009"
"2259","6021","6018","8","6026","22320","1321.9537500000001","0.01718539875","3655990.5524999974","47.52787718250009"
"2260","6026","6022","1","6023","22321","1321.2956250000002","0.017176843125","3657311.848124997","47.54505402562509"
"2261","6023","6018","3","6021","22324","1320.8568750000002","0.017171139375","3658632.7049999973","47.56222516500009"
"2262","6021","6012","1","6013","22325","1319.101875","0.017148324375","3659951.8068749974","47.579373489375094"
"2263","6013","6006","8","6014","22333","1319.32125","0.017151176249999997","3661271.1281249975","47.5965246656251"
"2264","6014","6008","5","6013","22338","1319.101875","0.017148324375","3662590.2299999977","47.6136729900001"
"2265","6013","6004","3","6007","22341","1317.7856249999998","0.017131213124999996","3663908.0156249977","47.630804203125095"
"2266","6007","5999","8","6007","22349","1317.7856249999998","0.017131213124999996","3665225.8012499977","47.64793541625009"
"2267","6007","6000","8","6008","22357","1318.005","0.017134065","3666543.8062499976","47.66506948125009"
"2268","6008","6001","3","6004","22360","1317.1274999999998","0.017122657499999996","3667860.9337499975","47.682192138750096"
"2269","6004","6000","2","6002","22362","1316.6887499999998","0.017116953749999997","3669177.6224999977","47.699309092500094"
"2270","6002","6001","6","6007","22368","1317.7856249999998","0.017131213124999996","3670495.4081249977","47.71644030562509"
"2271","6007","5998","1","5999","22369","1316.0306249999999","0.017108398124999997","3671811.438749998","47.733548703750095"
"2272","5999","5990","8","5998","22377","1315.8112500000002","0.017105546250000003","3673127.2499999977","47.750654250000096"
"2273","5998","5993","4","5997","22381","1315.5918749999998","0.017102694374999998","3674442.8418749976","47.767756944375094"
"2274","5997","5991","3","5994","22384","1314.93375","0.017094138749999998","3675757.7756249974","47.78485108312509"
"2275","5994","5988","6","5994","22390","1314.93375","0.017094138749999998","3677072.7093749973","47.80194522187509"
"2276","5994","5986","3","5989","22393","1313.836875","0.017079879375","3678386.5462499973","47.819025101250084"
"2277","5989","5986","6","5992","22399","1314.495","0.017088435","3679701.0412499974","47.83611353625008"
"2278","5992","5991","7","5998","22406","1315.8112500000002","0.017105546250000003","3681016.8524999972","47.85321908250008"
"2279","5998","5995","3","5998","22409","1315.8112500000002","0.017105546250000003","3682332.663749997","47.87032462875008"
"2280","5998","5993","2","5995","22411","1315.153125","0.017096990625","3683647.816874997","47.88742161937508"
"2281","5995","5992","7","5999","22418","1316.0306249999999","0.017108398124999997","3684963.8474999974","47.904530017500086"
"2282","5999","5997","5","6002","22423","1316.6887499999998","0.017116953749999997","3686280.5362499976","47.921646971250084"
"2283","6002","5994","4","5998","22427","1315.8112500000002","0.017105546250000003","3687596.3474999974","47.938752517500085"
"2284","5998","5994","6","6000","22433","1316.25","0.017111249999999998","3688912.5974999974","47.955863767500084"
"2285","6000","5996","5","6001","22438","1316.4693750000001","0.017114101875","3690229.066874997","47.972977869375086"
"2286","6001","5992","2","5994","22440","1314.93375","0.017094138749999998","3691544.000624997","47.99007200812508"
"2287","5994","5991","7","5998","22447","1315.8112500000002","0.017105546250000003","3692859.811874997","48.00717755437508"
"2288","5998","5990","2","5992","22449","1314.495","0.017088435","3694174.306874997","48.02426598937508"
"2289","5992","5984","9","5993","22458","1314.7143750000002","0.017091286875000004","3695489.021249997","48.04135727625008"
"2290","5993","5991","6","5997","22464","1315.5918749999998","0.017102694374999998","3696804.613124997","48.05845997062508"
"2291","5997","5988","8","5996","22472","1315.3725000000002","0.0170998425","3698119.985624997","48.07555981312508"
"2292","5996","5995","6","6001","22478","1316.4693750000001","0.017114101875","3699436.454999997","48.092673915000084"
"2293","6001","5992","3","5995","22481","1315.153125","0.017096990625","3700751.608124997","48.10977090562508"
"2294","5995","5987","7","5994","22488","1314.93375","0.017094138749999998","3702066.541874997","48.12686504437508"
"2295","5994","5993","2","5995","22490","1315.153125","0.017096990625","3703381.694999997","48.14396203500008"
"2296","5995","5990","5","5995","22495","1315.153125","0.017096990625","3704696.848124997","48.16105902562508"
"2297","5995","5991","5","5996","22500","1315.3725000000002","0.0170998425","3706012.2206249973","48.17815886812508"
"2298","5996","5992","8","6000","22508","1316.25","0.017111249999999998","3707328.4706249973","48.19527011812508"
"2299","6000","5998","9","6007","22517","1317.7856249999998","0.017131213124999996","3708646.2562499973","48.21240133125008"
"2300","6007","5999","8","6007","22525","1317.7856249999998","0.017131213124999996","3709964.0418749973","48.229532544375076"
"2301","6007","6005","1","6006","22526","1317.56625","0.01712836125","3711281.6081249975","48.24666090562508"
"2302","6006","6002","9","6011","22535","1318.663125","0.017142620625","3712600.2712499974","48.26380352625008"
"2303","6011","6010","7","6017","22542","1319.979375","0.017159731874999997","3713920.2506249975","48.28096325812508"
"2304","6017","6015","1","6016","22543","1319.76","0.01715688","3715240.0106249973","48.29812013812508"
"2305","6016","6015","6","6021","22549","1320.8568750000002","0.017171139375","3716560.8674999974","48.31529127750008"
"2306","6021","6018","9","6027","22558","1322.1731249999998","0.017188250624999995","3717883.0406249976","48.33247952812508"
"2307","6027","6019","4","6023","22562","1321.2956250000002","0.017176843125","3719204.3362499974","48.34965637125008"
"2308","6023","6017","8","6025","22570","1321.734375","0.017182546875","3720526.0706249974","48.366838918125076"
"2309","6025","6017","9","6026","22579","1321.9537500000001","0.01718539875","3721848.0243749972","48.38402431687508"
"2310","6026","6022","5","6027","22584","1322.1731249999998","0.017188250624999995","3723170.1974999974","48.401212567500075"
"2311","6027","6018","7","6025","22591","1321.734375","0.017182546875","3724491.9318749974","48.41839511437507"
"2312","6025","6021","6","6027","22597","1322.1731249999998","0.017188250624999995","3725814.1049999977","48.43558336500007"
"2313","6027","6020","5","6025","22602","1321.734375","0.017182546875","3727135.8393749977","48.45276591187507"
"2314","6025","6022","6","6028","22608","1322.3925000000002","0.0171911025","3728458.2318749977","48.46995701437507"
"2315","6028","6022","7","6029","22615","1322.6118749999998","0.017193954374999997","3729780.8437499977","48.48715096875007"
"2316","6029","6027","8","6035","22623","1323.928125","0.017211065624999997","3731104.7718749978","48.50436203437507"
"2317","6035","6029","3","6032","22626","1323.2699999999998","0.017202509999999997","3732428.041874998","48.52156454437507"
"2318","6032","6031","5","6036","22631","1324.1475","0.0172139175","3733752.1893749977","48.53877846187507"
"2319","6036","6033","4","6037","22635","1324.366875","0.017216769375","3735076.5562499976","48.555995231250066"
"2320","6037","6033","1","6034","22636","1323.70875","0.01720821375","3736400.264999998","48.57320344500007"
"2321","6034","6027","9","6036","22645","1324.1475","0.0172139175","3737724.4124999978","48.59041736250007"
"2322","6036","6027","7","6034","22652","1323.70875","0.01720821375","3739048.121249998","48.60762557625007"
"2323","6034","6031","8","6039","22660","1324.805625","0.017222473125","3740372.926874998","48.624848049375075"
"2324","6039","6030","2","6032","22662","1323.2699999999998","0.017202509999999997","3741696.196874998","48.64205055937507"
"2325","6032","6030","9","6039","22671","1324.805625","0.017222473125","3743021.002499998","48.659273032500074"
"2326","6039","6030","2","6032","22673","1323.2699999999998","0.017202509999999997","3744344.272499998","48.67647554250007"
"2327","6032","6026","4","6030","22677","1322.83125","0.01719680625","3745667.103749998","48.69367234875007"
"2328","6030","6024","2","6026","22679","1321.9537500000001","0.01718539875","3746989.057499998","48.71085774750007"
"2329","6026","6021","3","6024","22682","1321.5149999999999","0.017179695","3748310.572499998","48.728037442500074"
"2330","6024","6017","4","6021","22686","1320.8568750000002","0.017171139375","3749631.429374998","48.745208581875076"
"2331","6021","6017","1","6018","22687","1320.1987500000002","0.01716258375","3750951.628124998","48.762371165625076"
"2332","6018","6009","5","6014","22692","1319.32125","0.017151176249999997","3752270.949374998","48.77952234187508"
"2333","6014","6011","9","6020","22701","1320.6375","0.0171682875","3753591.586874998","48.79669062937508"
"2334","6020","6014","7","6021","22708","1320.8568750000002","0.017171139375","3754912.443749998","48.81386176875008"
"2335","6021","6016","1","6017","22709","1319.979375","0.017159731874999997","3756232.4231249983","48.83102150062508"
"2336","6017","6014","4","6018","22713","1320.1987500000002","0.01716258375","3757552.6218749983","48.84818408437508"
"2337","6018","6015","7","6022","22720","1321.0762499999998","0.017173991249999996","3758873.6981249982","48.865358075625075"
"2338","6022","6015","5","6020","22725","1320.6375","0.0171682875","3760194.3356249984","48.88252636312507"
"2339","6020","6012","6","6018","22731","1320.1987500000002","0.01716258375","3761514.5343749984","48.899688946875074"
"2340","6018","6016","7","6023","22738","1321.2956250000002","0.017176843125","3762835.829999998","48.916865790000074"
"2341","6023","6021","9","6030","22747","1322.83125","0.01719680625","3764158.661249998","48.93406259625007"
"2342","6030","6024","9","6033","22756","1323.489375","0.017205361875000002","3765482.150624998","48.95126795812507"
"2343","6033","6032","3","6035","22759","1323.928125","0.017211065624999997","3766806.078749998","48.96847902375007"
"2344","6035","6031","7","6038","22766","1324.58625","0.01721962125","3768130.664999998","48.98569864500007"
"2345","6038","6037","4","6041","22770","1325.244375","0.017228176874999997","3769455.909374998","49.00292682187507"
"2346","6041","6034","8","6042","22778","1325.46375","0.01723102875","3770781.373124998","49.02015785062507"
"2347","6042","6039","6","6045","22784","1326.121875","0.017239584375","3772107.4949999982","49.03739743500007"
"2348","6045","6041","6","6047","22790","1326.5606249999998","0.017245288124999997","3773434.055624998","49.05464272312506"
"2349","6047","6042","6","6048","22796","1326.7800000000002","0.017248140000000002","3774760.835624998","49.07189086312506"
"2350","6048","6040","5","6045","22801","1326.121875","0.017239584375","3776086.957499998","49.08913044750006"
"2351","6045","6038","8","6046","22809","1326.3412500000002","0.01724243625","3777413.298749998","49.10637288375006"
"2352","6046","6044","9","6053","22818","1327.8768750000002","0.017262399375","3778741.1756249983","49.12363528312506"
"2353","6053","6050","8","6058","22826","1328.97375","0.01727665875","3780070.149374998","49.14091194187506"
"2354","6058","6049","3","6052","22829","1327.6574999999998","0.017259547499999996","3781397.8068749984","49.15817148937506"
"2355","6052","6043","5","6048","22834","1326.7800000000002","0.017248140000000002","3782724.586874998","49.17541962937506"
"2356","6048","6041","3","6044","22837","1325.9025","0.017236732499999997","3784050.489374998","49.19265636187506"
"2357","6044","6040","2","6042","22839","1325.46375","0.01723102875","3785375.953124998","49.209887390625056"
"2358","6042","6037","7","6044","22846","1325.9025","0.017236732499999997","3786701.855624998","49.22712412312506"
"2359","6044","6037","7","6044","22853","1325.9025","0.017236732499999997","3788027.758124998","49.24436085562506"
"2360","6044","6042","3","6045","22856","1326.121875","0.017239584375","3789353.879999998","49.26160044000006"
"2361","6045","6037","1","6038","22857","1324.58625","0.01721962125","3790678.466249998","49.27882006125006"
"2362","6038","6031","6","6037","22863","1324.366875","0.017216769375","3792002.833124998","49.296036830625056"
"2363","6037","6032","5","6037","22868","1324.366875","0.017216769375","3793327.199999998","49.31325360000005"
"2364","6037","6036","3","6039","22871","1324.805625","0.017222473125","3794652.005624998","49.330476073125055"
"2365","6039","6035","9","6044","22880","1325.9025","0.017236732499999997","3795977.9081249977","49.34771280562506"
"2366","6044","6037","7","6044","22887","1325.9025","0.017236732499999997","3797303.8106249976","49.36494953812506"
"2367","6044","6042","4","6046","22891","1326.3412500000002","0.01724243625","3798630.1518749977","49.38219197437506"
"2368","6046","6045","2","6047","22893","1326.5606249999998","0.017245288124999997","3799956.7124999976","49.39943726250006"
"2369","6047","6042","3","6045","22896","1326.121875","0.017239584375","3801282.8343749978","49.416676846875056"
"2370","6045","6042","6","6048","22902","1326.7800000000002","0.017248140000000002","3802609.6143749976","49.433924986875056"
"2371","6048","6040","9","6049","22911","1326.9993749999999","0.017250991874999996","3803936.6137499977","49.45117597875006"
"2372","6049","6041","1","6042","22912","1325.46375","0.01723102875","3805262.077499998","49.468407007500055"
"2373","6042","6036","6","6042","22918","1325.46375","0.01723102875","3806587.541249998","49.48563803625005"
"2374","6042","6037","6","6043","22924","1325.6831250000002","0.017233880625000003","3807913.224374998","49.50287191687505"
"2375","6043","6036","6","6042","22930","1325.46375","0.01723102875","3809238.688124998","49.52010294562505"
"2376","6042","6039","3","6042","22933","1325.46375","0.01723102875","3810564.151874998","49.537333974375045"
"2377","6042","6034","5","6039","22938","1324.805625","0.017222473125","3811888.957499998","49.55455644750005"
"2378","6039","6037","4","6041","22942","1325.244375","0.017228176874999997","3813214.201874998","49.57178462437505"
"2379","6041","6038","5","6043","22947","1325.6831250000002","0.017233880625000003","3814539.884999998","49.58901850500005"
"2380","6043","6039","6","6045","22953","1326.121875","0.017239584375","3815866.006874998","49.606258089375046"
"2381","6045","6036","9","6045","22962","1326.121875","0.017239584375","3817192.1287499983","49.623497673750045"
"2382","6045","6043","8","6051","22970","1327.4381250000001","0.017256695625000002","3818519.566874998","49.640754369375045"
"2383","6051","6049","9","6058","22979","1328.97375","0.01727665875","3819848.540624998","49.658031028125045"
"2384","6058","6049","1","6050","22980","1327.21875","0.017253843749999997","3821175.759374998","49.67528487187504"
"2385","6050","6042","7","6049","22987","1326.9993749999999","0.017250991874999996","3822502.758749998","49.692535863750045"
"2386","6049","6045","7","6052","22994","1327.6574999999998","0.017259547499999996","3823830.4162499984","49.70979541125004"
"2387","6052","6050","6","6056","23000","1328.535","0.017270955","3825158.9512499985","49.72706636625004"
"2388","6056","6054","5","6059","23005","1329.193125","0.017279510624999998","3826488.1443749988","49.744345876875045"
"2389","6059","6050","3","6053","23008","1327.8768750000002","0.017262399375","3827816.021249999","49.761608276250044"
"2390","6053","6045","7","6052","23015","1327.6574999999998","0.017259547499999996","3829143.678749999","49.77886782375004"
"2391","6052","6049","9","6058","23024","1328.97375","0.01727665875","3830472.652499999","49.79614448250004"
"2392","6058","6054","2","6056","23026","1328.535","0.017270955","3831801.187499999","49.81341543750004"
"2393","6056","6051","3","6054","23029","1328.0962499999998","0.017265251249999995","3833129.283749999","49.83068068875004"
"2394","6054","6053","3","6056","23032","1328.535","0.017270955","3834457.818749999","49.847951643750044"
"2395","6056","6051","5","6056","23037","1328.535","0.017270955","3835786.3537499993","49.865222598750044"
"2396","6056","6055","5","6060","23042","1329.4125","0.0172823625","3837115.7662499994","49.88250496125004"
"2397","6060","6054","9","6063","23051","1330.070625","0.017290918125","3838445.8368749996","49.89979587937504"
"2398","6063","6054","3","6057","23054","1328.7543749999998","0.017273806874999995","3839774.5912499996","49.91706968625004"
"2399","6057","6054","6","6060","23060","1329.4125","0.0172823625","3841104.0037499997","49.934352048750036"
"2400","6060","6058","7","6065","23067","1330.509375","0.017296621875","3842434.5131249996","49.95164867062503"
"2401","6065","6065","0","6065","23067","1330.509375","0.017296621875","3843765.0224999995","49.96894529250003"
"2402","6065","6065","0","6065","23067","1330.509375","0.017296621875","3845095.5318749994","49.98624191437503"
"2403","6065","6065","0","6065","23067","1330.509375","0.017296621875","3846426.0412499993","50.003538536250026"
"2404","6065","6065","0","6065","23067","1330.509375","0.017296621875","3847756.550624999","50.020835158125024"
"2405","6065","6065","0","6065","23067","1330.509375","0.017296621875","3849087.059999999","50.03813178000002"
"2406","6065","6065","0","6065","23067","1330.509375","0.017296621875","3850417.569374999","50.05542840187502"
"2407","6065","6065","0","6065","23067","1330.509375","0.017296621875","3851748.078749999","50.07272502375002"
"2408","6065","6065","0","6065","23067","1330.509375","0.017296621875","3853078.588124999","50.090021645625015"
"2409","6065","6065","0","6065","23067","1330.509375","0.017296621875","3854409.0974999988","50.10731826750001"
"2410","6065","6065","0","6065","23067","1330.509375","0.017296621875","3855739.6068749987","50.12461488937501"
"2411","6065","6065","0","6065","23067","1330.509375","0.017296621875","3857070.1162499986","50.14191151125001"
"2412","6065","6065","0","6065","23067","1330.509375","0.017296621875","3858400.6256249985","50.159208133125006"
"2413","6065","6065","0","6065","23067","1330.509375","0.017296621875","3859731.1349999984","50.176504755"
"2414","6065","6065","0","6065","23067","1330.509375","0.017296621875","3861061.6443749983","50.193801376875"
"2415","6065","6065","0","6065","23067","1330.509375","0.017296621875","3862392.153749998","50.21109799875"
"2416","6065","6065","0","6065","23067","1330.509375","0.017296621875","3863722.663124998","50.228394620625"
"2417","6065","6065","0","6065","23067","1330.509375","0.017296621875","3865053.172499998","50.245691242499994"
"2418","6065","6065","0","6065","23067","1330.509375","0.017296621875","3866383.681874998","50.26298786437499"
"2419","6065","6065","0","6065","23067","1330.509375","0.017296621875","3867714.191249998","50.28028448624999"
"2420","6065","6065","0","6065","23067","1330.509375","0.017296621875","3869044.7006249977","50.29758110812499"
"2421","6065","6065","0","6065","23067","1330.509375","0.017296621875","3870375.2099999976","50.314877729999985"
"2422","6065","6065","0","6065","23067","1330.509375","0.017296621875","3871705.7193749975","50.33217435187498"
"2423","6065","6065","0","6065","23067","1330.509375","0.017296621875","3873036.2287499974","50.34947097374998"
"2424","6065","6065","0","6065","23067","1330.509375","0.017296621875","3874366.7381249974","50.36676759562498"
"2425","6065","6065","0","6065","23067","1330.509375","0.017296621875","3875697.2474999973","50.384064217499976"
"2426","6065","6065","0","6065","23067","1330.509375","0.017296621875","3877027.756874997","50.40136083937497"
"2427","6065","6065","0","6065","23067","1330.509375","0.017296621875","3878358.266249997","50.41865746124997"
"2428","6065","6065","0","6065","23067","1330.509375","0.017296621875","3879688.775624997","50.43595408312497"
"2429","6065","6065","0","6065","23067","1330.509375","0.017296621875","3881019.284999997","50.45325070499997"
"2430","6065","6065","0","6065","23067","1330.509375","0.017296621875","3882349.794374997","50.470547326874964"
"2431","6065","6065","0","6065","23067","1330.509375","0.017296621875","3883680.3037499967","50.48784394874996"
"2432","6065","6065","0","6065","23067","1330.509375","0.017296621875","3885010.8131249966","50.50514057062496"
"2433","6065","6065","0","6065","23067","1330.509375","0.017296621875","3886341.3224999965","50.52243719249996"
"2434","6065","6065","0","6065","23067","1330.509375","0.017296621875","3887671.8318749964","50.539733814374955"
"2435","6065","6065","0","6065","23067","1330.509375","0.017296621875","3889002.3412499963","50.55703043624995"
"2436","6065","6065","0","6065","23067","1330.509375","0.017296621875","3890332.8506249962","50.57432705812495"
"2437","6065","6065","0","6065","23067","1330.509375","0.017296621875","3891663.359999996","50.59162367999995"
"2438","6065","6065","0","6065","23067","1330.509375","0.017296621875","3892993.869374996","50.608920301874946"
"2439","6065","6065","0","6065","23067","1330.509375","0.017296621875","3894324.378749996","50.62621692374994"
"2440","6065","6065","0","6065","23067","1330.509375","0.017296621875","3895654.888124996","50.64351354562494"
"2441","6065","6065","0","6065","23067","1330.509375","0.017296621875","3896985.397499996","50.66081016749994"
"2442","6065","6065","0","6065","23067","1330.509375","0.017296621875","3898315.9068749957","50.67810678937494"
"2443","6065","6065","0","6065","23067","1330.509375","0.017296621875","3899646.4162499956","50.695403411249934"
"2444","6065","6065","0","6065","23067","1330.509375","0.017296621875","3900976.9256249955","50.71270003312493"
"2445","6065","6065","0","6065","23067","1330.509375","0.017296621875","3902307.4349999954","50.72999665499993"
"2446","6065","6065","0","6065","23067","1330.509375","0.017296621875","3903637.9443749953","50.74729327687493"
"2447","6065","6065","0","6065","23067","1330.509375","0.017296621875","3904968.453749995","50.764589898749925"
"2448","6065","6065","0","6065","23067","1330.509375","0.017296621875","3906298.963124995","50.78188652062492"
"2449","6065","6065","0","6065","23067","1330.509375","0.017296621875","3907629.472499995","50.79918314249992"
"2450","6065","6065","0","6065","23067","1330.509375","0.017296621875","3908959.981874995","50.81647976437492"
"2451","6065","6065","0","6065","23067","1330.509375","0.017296621875","3910290.491249995","50.833776386249916"
"2452","6065","6065","0","6065","23067","1330.509375","0.017296621875","3911621.0006249947","50.851073008124914"
"2453","6065","6065","0","6065","23067","1330.509375","0.017296621875","3912951.5099999947","50.86836962999991"
"2454","6065","6065","0","6065","23067","1330.509375","0.017296621875","3914282.0193749946","50.88566625187491"
"2455","6065","6065","0","6065","23067","1330.509375","0.017296621875","3915612.5287499945","50.90296287374991"
"2456","6065","6065","0","6065","23067","1330.509375","0.017296621875","3916943.0381249944","50.920259495624904"
"2457","6065","6065","0","6065","23067","1330.509375","0.017296621875","3918273.5474999943","50.9375561174999"
"2458","6065","6065","0","6065","23067","1330.509375","0.017296621875","3919604.056874994","50.9548527393749"
"2459","6065","6065","0","6065","23067","1330.509375","0.017296621875","3920934.566249994","50.9721493612499"
"2460","6065","6065","0","6065","23067","1330.509375","0.017296621875","3922265.075624994","50.989445983124895"
"2461","6065","6065","0","6065","23067","1330.509375","0.017296621875","3923595.584999994","51.00674260499989"
"2462","6065","6065","0","6065","23067","1330.509375","0.017296621875","3924926.094374994","51.02403922687489"
"2463","6065","6065","0","6065","23067","1330.509375","0.017296621875","3926256.6037499937","51.04133584874989"
"2464","6065","6065","0","6065","23067","1330.509375","0.017296621875","3927587.1131249936","51.058632470624886"
"2465","6065","6065","0","6065","23067","1330.509375","0.017296621875","3928917.6224999935","51.075929092499884"
"2466","6065","6065","0","6065","23067","1330.509375","0.017296621875","3930248.1318749934","51.09322571437488"
"2467","6065","6065","0","6065","23067","1330.509375","0.017296621875","3931578.6412499934","51.11052233624988"
"2468","6065","6065","0","6065","23067","1330.509375","0.017296621875","3932909.1506249933","51.12781895812488"
"2469","6065","6065","0","6065","23067","1330.509375","0.017296621875","3934239.659999993","51.145115579999874"
"2470","6065","6065","0","6065","23067","1330.509375","0.017296621875","3935570.169374993","51.16241220187487"
"2471","6065","6065","0","6065","23067","1330.509375","0.017296621875","3936900.678749993","51.17970882374987"
"2472","6065","6065","0","6065","23067","1330.509375","0.017296621875","3938231.188124993","51.19700544562487"
"2473","6065","6065","0","6065","23067","1330.509375","0.017296621875","3939561.697499993","51.214302067499865"
"2474","6065","6065","0","6065","23067","1330.509375","0.017296621875","3940892.2068749927","51.23159868937486"
"2475","6065","6065","0","6065","23067","1330.509375","0.017296621875","3942222.7162499926","51.24889531124986"
"2476","6065","6065","0","6065","23067","1330.509375","0.017296621875","3943553.2256249925","51.26619193312486"
"2477","6065","6065","0","6065","23067","1330.509375","0.017296621875","3944883.7349999924","51.283488554999856"
"2478","6065","6065","0","6065","23067","1330.509375","0.017296621875","3946214.2443749923","51.300785176874854"
"2479","6065","6065","0","6065","23067","1330.509375","0.017296621875","3947544.753749992","51.31808179874985"
"2480","6065","6065","0","6065","23067","1330.509375","0.017296621875","3948875.263124992","51.33537842062485"
"2481","6065","6065","0","6065","23067","1330.509375","0.017296621875","3950205.772499992","51.35267504249985"
"2482","6065","6065","0","6065","23067","1330.509375","0.017296621875","3951536.281874992","51.369971664374845"
"2483","6065","6065","0","6065","23067","1330.509375","0.017296621875","3952866.791249992","51.38726828624984"
"2484","6065","6065","0","6065","23067","1330.509375","0.017296621875","3954197.3006249918","51.40456490812484"
"2485","6065","6065","0","6065","23067","1330.509375","0.017296621875","3955527.8099999917","51.42186152999984"
"2486","6065","6065","0","6065","23067","1330.509375","0.017296621875","3956858.3193749916","51.439158151874835"
"2487","6065","6065","0","6065","23067","1330.509375","0.017296621875","3958188.8287499915","51.45645477374983"
"2488","6065","6065","0","6065","23067","1330.509375","0.017296621875","3959519.3381249914","51.47375139562483"
"2489","6065","6065","0","6065","23067","1330.509375","0.017296621875","3960849.8474999913","51.49104801749983"
"2490","6065","6065","0","6065","23067","1330.509375","0.017296621875","3962180.356874991","51.508344639374826"
"2491","6065","6065","0","6065","23067","1330.509375","0.017296621875","3963510.866249991","51.525641261249824"
"2492","6065","6065","0","6065","23067","1330.509375","0.017296621875","3964841.375624991","51.54293788312482"
"2493","6065","6065","0","6065","23067","1330.509375","0.017296621875","3966171.884999991","51.56023450499982"
"2494","6065","6065","0","6065","23067","1330.509375","0.017296621875","3967502.394374991","51.57753112687482"
"2495","6065","6065","0","6065","23067","1330.509375","0.017296621875","3968832.9037499907","51.594827748749815"
"2496","6065","6065","0","6065","23067","1330.509375","0.017296621875","3970163.4131249906","51.61212437062481"
"2497","6065","6065","0","6065","23067","1330.509375","0.017296621875","3971493.9224999906","51.62942099249981"
"2498","6065","6065","0","6065","23067","1330.509375","0.017296621875","3972824.4318749905","51.64671761437481"
"2499","6065","6065","0","6065","23067","1330.509375","0.017296621875","3974154.9412499904","51.664014236249805"
"2500","6065","6065","0","6065","23067","1330.509375","0.017296621875","3975485.4506249903","51.6813108581248"
"2501","6065","6065","0","6065","23067","1330.509375","0.017296621875","3976815.95999999","51.6986074799998"
"2502","6065","6065","0","6065","23067","1330.509375","0.017296621875","3978146.46937499","51.7159041018748"
"2503","6065","6065","0","6065","23067","1330.509375","0.017296621875","3979476.97874999","51.733200723749796"
"2504","6065","6065","0","6065","23067","1330.509375","0.017296621875","3980807.48812499","51.750497345624794"
"2505","6065","6065","0","6065","23067","1330.509375","0.017296621875","3982137.99749999","51.76779396749979"
"2506","6065","6065","0","6065","23067","1330.509375","0.017296621875","3983468.5068749897","51.78509058937479"
"2507","6065","6065","0","6065","23067","1330.509375","0.017296621875","3984799.0162499896","51.80238721124979"
"2508","6065","6065","0","6065","23067","1330.509375","0.017296621875","3986129.5256249895","51.819683833124785"
"2509","6065","6065","0","6065","23067","1330.509375","0.017296621875","3987460.0349999894","51.83698045499978"
"2510","6065","6065","0","6065","23067","1330.509375","0.017296621875","3988790.5443749893","51.85427707687478"
"2511","6065","6065","0","6065","23067","1330.509375","0.017296621875","3990121.0537499893","51.87157369874978"
"2512","6065","6065","0","6065","23067","1330.509375","0.017296621875","3991451.563124989","51.888870320624775"
"2513","6065","6065","0","6065","23067","1330.509375","0.017296621875","3992782.072499989","51.90616694249977"
"2514","6065","6065","0","6065","23067","1330.509375","0.017296621875","3994112.581874989","51.92346356437477"
"2515","6065","6065","0","6065","23067","1330.509375","0.017296621875","3995443.091249989","51.94076018624977"
"2516","6065","6065","0","6065","23067","1330.509375","0.017296621875","3996773.600624989","51.958056808124766"
"2517","6065","6065","0","6065","23067","1330.509375","0.017296621875","3998104.1099999887","51.975353429999764"
"2518","6065","6065","0","6065","23067","1330.509375","0.017296621875","3999434.6193749886","51.99265005187476"
"2519","6065","6065","0","6065","23067","1330.509375","0.017296621875","4000765.1287499885","52.00994667374976"
"2520","6065","6065","0","6065","23067","1330.509375","0.017296621875","4002095.6381249884","52.02724329562476"
"2521","6065","6065","0","6065","23067","1330.509375","0.017296621875","4003426.1474999883","52.044539917499755"
"2522","6065","6065","0","6065","23067","1330.509375","0.017296621875","4004756.656874988","52.06183653937475"
"2523","6065","6065","0","6065","23067","1330.509375","0.017296621875","4006087.166249988","52.07913316124975"
"2524","6065","6065","0","6065","23067","1330.509375","0.017296621875","4007417.675624988","52.09642978312475"
"2525","6065","6065","0","6065","23067","1330.509375","0.017296621875","4008748.184999988","52.113726404999746"
"2526","6065","6065","0","6065","23067","1330.509375","0.017296621875","4010078.694374988","52.13102302687474"
"2527","6065","6065","0","6065","23067","1330.509375","0.017296621875","4011409.2037499878","52.14831964874974"
"2528","6065","6065","0","6065","23067","1330.509375","0.017296621875","4012739.7131249877","52.16561627062474"
"2529","6065","6065","0","6065","23067","1330.509375","0.017296621875","4014070.2224999876","52.182912892499736"
"2530","6065","6065","0","6065","23067","1330.509375","0.017296621875","4015400.7318749875","52.200209514374734"
"2531","6065","6065","0","6065","23067","1330.509375","0.017296621875","4016731.2412499874","52.21750613624973"
"2532","6065","6065","0","6065","23067","1330.509375","0.017296621875","4018061.7506249873","52.23480275812473"
"2533","6065","6065","0","6065","23067","1330.509375","0.017296621875","4019392.259999987","52.25209937999973"
"2534","6065","6065","0","6065","23067","1330.509375","0.017296621875","4020722.769374987","52.269396001874725"
"2535","6065","6065","0","6065","23067","1330.509375","0.017296621875","4022053.278749987","52.28669262374972"
"2536","6065","6065","0","6065","23067","1330.509375","0.017296621875","4023383.788124987","52.30398924562472"
"2537","6065","6065","0","6065","23067","1330.509375","0.017296621875","4024714.297499987","52.32128586749972"
"2538","6065","6065","0","6065","23067","1330.509375","0.017296621875","4026044.8068749867","52.338582489374716"
"2539","6065","6065","0","6065","23067","1330.509375","0.017296621875","4027375.3162499866","52.35587911124971"
"2540","6065","6065","0","6065","23067","1330.509375","0.017296621875","4028705.8256249866","52.37317573312471"
"2541","6065","6065","0","6065","23067","1330.509375","0.017296621875","4030036.3349999865","52.39047235499971"
"2542","6065","6065","0","6065","23067","1330.509375","0.017296621875","4031366.8443749864","52.407768976874706"
"2543","6065","6065","0","6065","23067","1330.509375","0.017296621875","4032697.3537499863","52.425065598749704"
"2544","6065","6065","0","6065","23067","1330.509375","0.017296621875","4034027.863124986","52.4423622206247"
"2545","6065","6065","0","6065","23067","1330.509375","0.017296621875","4035358.372499986","52.4596588424997"
"2546","6065","6065","0","6065","23067","1330.509375","0.017296621875","4036688.881874986","52.4769554643747"
"2547","6065","6065","0","6065","23067","1330.509375","0.017296621875","4038019.391249986","52.494252086249695"
"2548","6065","6065","0","6065","23067","1330.509375","0.017296621875","4039349.900624986","52.51154870812469"
"2549","6065","6065","0","6065","23067","1330.509375","0.017296621875","4040680.4099999857","52.52884532999969"
"2550","6065","6065","0","6065","23067","1330.509375","0.017296621875","4042010.9193749856","52.54614195187469"
"2551","6065","6065","0","6065","23067","1330.509375","0.017296621875","4043341.4287499855","52.563438573749686"
"2552","6065","6065","0","6065","23067","1330.509375","0.017296621875","4044671.9381249854","52.58073519562468"
"2553","6065","6065","0","6065","23067","1330.509375","0.017296621875","4046002.4474999853","52.59803181749968"
"2554","6065","6065","0","6065","23067","1330.509375","0.017296621875","4047332.9568749852","52.61532843937468"
"2555","6065","6065","0","6065","23067","1330.509375","0.017296621875","4048663.466249985","52.632625061249676"
"2556","6065","6065","0","6065","23067","1330.509375","0.017296621875","4049993.975624985","52.649921683124674"
"2557","6065","6065","0","6065","23067","1330.509375","0.017296621875","4051324.484999985","52.66721830499967"
"2558","6065","6065","0","6065","23067","1330.509375","0.017296621875","4052654.994374985","52.68451492687467"
"2559","6065","6065","0","6065","23067","1330.509375","0.017296621875","4053985.503749985","52.70181154874967"
"2560","6065","6065","0","6065","23067","1330.509375","0.017296621875","4055316.0131249847","52.719108170624665"
"2561","6065","6065","0","6065","23067","1330.509375","0.017296621875","4056646.5224999846","52.73640479249966"
"2562","6065","6065","0","6065","23067","1330.509375","0.017296621875","4057977.0318749845","52.75370141437466"
"2563","6065","6065","0","6065","23067","1330.509375","0.017296621875","4059307.5412499844","52.77099803624966"
"2564","6065","6065","0","6065","23067","1330.509375","0.017296621875","4060638.0506249843","52.788294658124656"
"2565","6065","6065","0","6065","23067","1330.509375","0.017296621875","4061968.559999984","52.80559127999965"
"2566","6065","6065","0","6065","23067","1330.509375","0.017296621875","4063299.069374984","52.82288790187465"
"2567","6065","6065","0","6065","23067","1330.509375","0.017296621875","4064629.578749984","52.84018452374965"
"2568","6065","6065","0","6065","23067","1330.509375","0.017296621875","4065960.088124984","52.85748114562465"
"2569","6065","6065","0","6065","23067","1330.509375","0.017296621875","4067290.597499984","52.874777767499644"
"2570","6065","6065","0","6065","23067","1330.509375","0.017296621875","4068621.1068749838","52.89207438937464"
"2571","6065","6065","0","6065","23067","1330.509375","0.017296621875","4069951.6162499837","52.90937101124964"
"2572","6065","6065","0","6065","23067","1330.509375","0.017296621875","4071282.1256249836","52.92666763312464"
"2573","6065","6065","0","6065","23067","1330.509375","0.017296621875","4072612.6349999835","52.943964254999635"
"2574","6065","6065","0","6065","23067","1330.509375","0.017296621875","4073943.1443749834","52.96126087687463"
"2575","6065","6065","0","6065","23067","1330.509375","0.017296621875","4075273.6537499833","52.97855749874963"
"2576","6065","6065","0","6065","23067","1330.509375","0.017296621875","4076604.163124983","52.99585412062463"
"2577","6065","6065","0","6065","23067","1330.509375","0.017296621875","4077934.672499983","53.013150742499626"
"2578","6065","6065","0","6065","23067","1330.509375","0.017296621875","4079265.181874983","53.03044736437462"
"2579","6065","6065","0","6065","23067","1330.509375","0.017296621875","4080595.691249983","53.04774398624962"
"2580","6065","6065","0","6065","23067","1330.509375","0.017296621875","4081926.200624983","53.06504060812462"
"2581","6065","6065","0","6065","23067","1330.509375","0.017296621875","4083256.7099999827","53.08233722999962"
"2582","6065","6065","0","6065","23067","1330.509375","0.017296621875","4084587.2193749826","53.099633851874614"
"2583","6065","6065","0","6065","23067","1330.509375","0.017296621875","4085917.7287499825","53.11693047374961"
"2584","6065","6065","0","6065","23067","1330.509375","0.017296621875","4087248.2381249825","53.13422709562461"
"2585","6065","6065","0","6065","23067","1330.509375","0.017296621875","4088578.7474999824","53.15152371749961"
"2586","6065","6065","0","6065","23067","1330.509375","0.017296621875","4089909.2568749823","53.168820339374605"
"2587","6065","6065","0","6065","23067","1330.509375","0.017296621875","4091239.766249982","53.1861169612496"
"2588","6065","6065","0","6065","23067","1330.509375","0.017296621875","4092570.275624982","53.2034135831246"
"2589","6065","6065","0","6065","23067","1330.509375","0.017296621875","4093900.784999982","53.2207102049996"
"2590","6065","6065","0","6065","23067","1330.509375","0.017296621875","4095231.294374982","53.238006826874596"
"2591","6065","6065","0","6065","23067","1330.509375","0.017296621875","4096561.803749982","53.25530344874959"
"2592","6065","6065","0","6065","23067","1330.509375","0.017296621875","4097892.3131249817","53.27260007062459"
"2593","6065","6065","0","6065","23067","1330.509375","0.017296621875","4099222.8224999816","53.28989669249959"
"2594","6065","6065","0","6065","23067","1330.509375","0.017296621875","4100553.3318749815","53.30719331437459"
"2595","6065","6065","0","6065","23067","1330.509375","0.017296621875","4101883.8412499814","53.324489936249584"
"2596","6065","6065","0","6065","23067","1330.509375","0.017296621875","4103214.3506249813","53.34178655812458"
"2597","6065","6065","0","6065","23067","1330.509375","0.017296621875","4104544.8599999812","53.35908317999958"
"2598","6065","6065","0","6065","23067","1330.509375","0.017296621875","4105875.369374981","53.37637980187458"
"2599","6065","6065","0","6065","23067","1330.509375","0.017296621875","4107205.878749981","53.393676423749575"
"2600","6065","6065","0","6065","23067","1330.509375","0.017296621875","4108536.388124981","53.41097304562457"
"2601","6065","6065","0","6065","23067","1330.509375","0.017296621875","4109866.897499981","53.42826966749957"
"2602","6065","6065","0","6065","23067","1330.509375","0.017296621875","4111197.406874981","53.44556628937457"
"2603","6065","6065","0","6065","23067","1330.509375","0.017296621875","4112527.9162499807","53.462862911249566"
"2604","6065","6065","0","6065","23067","1330.509375","0.017296621875","4113858.4256249806","53.480159533124564"
"2605","6065","6065","0","6065","23067","1330.509375","0.017296621875","4115188.9349999805","53.49745615499956"
"2606","6065","6065","0","6065","23067","1330.509375","0.017296621875","4116519.4443749804","53.51475277687456"
"2607","6065","6065","0","6065","23067","1330.509375","0.017296621875","4117849.9537499803","53.53204939874956"
"2608","6065","6065","0","6065","23067","1330.509375","0.017296621875","4119180.46312498","53.549346020624554"
"2609","6065","6065","0","6065","23067","1330.509375","0.017296621875","4120510.97249998","53.56664264249955"
"2610","6065","6065","0","6065","23067","1330.509375","0.017296621875","4121841.48187498","53.58393926437455"
"2611","6065","6065","0","6065","23067","1330.509375","0.017296621875","4123171.99124998","53.60123588624955"
"2612","6065","6065","0","6065","23067","1330.509375","0.017296621875","4124502.50062498","53.618532508124545"
"2613","6065","6065","0","6065","23067","1330.509375","0.017296621875","4125833.0099999798","53.63582912999954"
"2614","6065","6065","0","6065","23067","1330.509375","0.017296621875","4127163.5193749797","53.65312575187454"
"2615","6065","6065","0","6065","23067","1330.509375","0.017296621875","4128494.0287499796","53.67042237374954"
"2616","6065","6065","0","6065","23067","1330.509375","0.017296621875","4129824.5381249795","53.687718995624536"
"2617","6065","6065","0","6065","23067","1330.509375","0.017296621875","4131155.0474999794","53.705015617499534"
"2618","6065","6065","0","6065","23067","1330.509375","0.017296621875","4132485.5568749793","53.72231223937453"
"2619","6065","6065","0","6065","23067","1330.509375","0.017296621875","4133816.066249979","53.73960886124953"
"2620","6065","6065","0","6065","23067","1330.509375","0.017296621875","4135146.575624979","53.75690548312453"
"2621","6065","6065","0","6065","23067","1330.509375","0.017296621875","4136477.084999979","53.774202104999524"
"2622","6065","6065","0","6065","23067","1330.509375","0.017296621875","4137807.594374979","53.79149872687452"
"2623","6065","6065","0","6065","23067","1330.509375","0.017296621875","4139138.103749979","53.80879534874952"
"2624","6065","6065","0","6065","23067","1330.509375","0.017296621875","4140468.6131249787","53.82609197062452"
"2625","6065","6065","0","6065","23067","1330.509375","0.017296621875","4141799.1224999786","53.843388592499515"
"2626","6065","6065","0","6065","23067","1330.509375","0.017296621875","4143129.6318749785","53.86068521437451"
"2627","6065","6065","0","6065","23067","1330.509375","0.017296621875","4144460.1412499784","53.87798183624951"
"2628","6065","6065","0","6065","23067","1330.509375","0.017296621875","4145790.6506249784","53.89527845812451"
"2629","6065","6065","0","6065","23067","1330.509375","0.017296621875","4147121.1599999783","53.912575079999506"
"2630","6065","6065","0","6065","23067","1330.509375","0.017296621875","4148451.669374978","53.929871701874504"
"2631","6065","6065","0","6065","23067","1330.509375","0.017296621875","4149782.178749978","53.9471683237495"
"2632","6065","6065","0","6065","23067","1330.509375","0.017296621875","4151112.688124978","53.9644649456245"
"2633","6065","6065","0","6065","23067","1330.509375","0.017296621875","4152443.197499978","53.9817615674995"
"2634","6065","6065","0","6065","23067","1330.509375","0.017296621875","4153773.706874978","53.999058189374495"
"2635","6065","6065","0","6065","23067","1330.509375","0.017296621875","4155104.2162499777","54.01635481124949"
"2636","6065","6065","0","6065","23067","1330.509375","0.017296621875","4156434.7256249776","54.03365143312449"
"2637","6065","6065","0","6065","23067","1330.509375","0.017296621875","4157765.2349999775","54.05094805499949"
"2638","6065","6065","0","6065","23067","1330.509375","0.017296621875","4159095.7443749774","54.068244676874485"
"2639","6065","6065","0","6065","23067","1330.509375","0.017296621875","4160426.2537499773","54.08554129874948"
"2640","6065","6065","0","6065","23067","1330.509375","0.017296621875","4161756.7631249772","54.10283792062448"
"2641","6065","6065","0","6065","23067","1330.509375","0.017296621875","4163087.272499977","54.12013454249948"
"2642","6065","6065","0","6065","23067","1330.509375","0.017296621875","4164417.781874977","54.137431164374476"
"2643","6065","6065","0","6065","23067","1330.509375","0.017296621875","4165748.291249977","54.154727786249474"
"2644","6065","6065","0","6065","23067","1330.509375","0.017296621875","4167078.800624977","54.17202440812447"
"2645","6065","6065","0","6065","23067","1330.509375","0.017296621875","4168409.309999977","54.18932102999947"
"2646","6065","6065","0","6065","23067","1330.509375","0.017296621875","4169739.8193749767","54.20661765187447"
"2647","6065","6065","0","6065","23067","1330.509375","0.017296621875","4171070.3287499766","54.223914273749465"
"2648","6065","6065","0","6065","23067","1330.509375","0.017296621875","4172400.8381249765","54.24121089562446"
"2649","6065","6065","0","6065","23067","1330.509375","0.017296621875","4173731.3474999764","54.25850751749946"
"2650","6065","6065","0","6065","23067","1330.509375","0.017296621875","4175061.8568749763","54.27580413937446"
"2651","6065","6065","0","6065","23067","1330.509375","0.017296621875","4176392.366249976","54.293100761249455"
"2652","6065","6065","0","6065","23067","1330.509375","0.017296621875","4177722.875624976","54.31039738312445"
"2653","6065","6065","0","6065","23067","1330.509375","0.017296621875","4179053.384999976","54.32769400499945"
"2654","6065","6065","0","6065","23067","1330.509375","0.017296621875","4180383.894374976","54.34499062687445"
"2655","6065","6065","0","6065","23067","1330.509375","0.017296621875","4181714.403749976","54.362287248749446"
"2656","6065","6065","0","6065","23067","1330.509375","0.017296621875","4183044.9131249757","54.379583870624444"
"2657","6065","6065","0","6065","23067","1330.509375","0.017296621875","4184375.4224999757","54.39688049249944"
"2658","6065","6065","0","6065","23067","1330.509375","0.017296621875","4185705.9318749756","54.41417711437444"
"2659","6065","6065","0","6065","23067","1330.509375","0.017296621875","4187036.4412499755","54.43147373624944"
"2660","6065","6065","0","6065","23067","1330.509375","0.017296621875","4188366.9506249754","54.448770358124435"
"2661","6065","6065","0","6065","23067","1330.509375","0.017296621875","4189697.4599999753","54.46606697999943"
"2662","6065","6065","0","6065","23067","1330.509375","0.017296621875","4191027.969374975","54.48336360187443"
"2663","6065","6065","0","6065","23067","1330.509375","0.017296621875","4192358.478749975","54.50066022374943"
"2664","6065","6065","0","6065","23067","1330.509375","0.017296621875","4193688.988124975","54.517956845624425"
"2665","6065","6065","0","6065","23067","1330.509375","0.017296621875","4195019.497499975","54.53525346749942"
"2666","6065","6065","0","6065","23067","1330.509375","0.017296621875","4196350.006874976","54.55255008937442"
"2667","6065","6065","0","6065","23067","1330.509375","0.017296621875","4197680.516249976","54.56984671124942"
"2668","6065","6065","0","6065","23067","1330.509375","0.017296621875","4199011.0256249765","54.587143333124416"
"2669","6065","6065","0","6065","23067","1330.509375","0.017296621875","4200341.534999977","54.604439954999414"
"2670","6065","6065","0","6065","23067","1330.509375","0.017296621875","4201672.044374977","54.62173657687441"
"2671","6065","6065","0","6065","23067","1330.509375","0.017296621875","4203002.553749978","54.63903319874941"
"2672","6065","6065","0","6065","23067","1330.509375","0.017296621875","4204333.063124978","54.65632982062441"
"2673","6065","6065","0","6065","23067","1330.509375","0.017296621875","4205663.572499978","54.673626442499405"
"2674","6065","6065","0","6065","23067","1330.509375","0.017296621875","4206994.081874979","54.6909230643744"
"2675","6065","6065","0","6065","23067","1330.509375","0.017296621875","4208324.591249979","54.7082196862494"
"2676","6065","6065","0","6065","23067","1330.509375","0.017296621875","4209655.1006249795","54.7255163081244"
"2677","6065","6065","0","6065","23067","1330.509375","0.017296621875","4210985.60999998","54.742812929999396"
"2678","6065","6065","0","6065","23067","1330.509375","0.017296621875","4212316.11937498","54.76010955187439"
"2679","6065","6065","0","6065","23067","1330.509375","0.017296621875","4213646.628749981","54.77740617374939"
"2680","6065","6065","0","6065","23067","1330.509375","0.017296621875","4214977.138124981","54.79470279562439"
"2681","6065","6065","0","6065","23067","1330.509375","0.017296621875","4216307.647499981","54.811999417499386"
"2682","6065","6065","0","6065","23067","1330.509375","0.017296621875","4217638.156874982","54.829296039374384"
"2683","6065","6065","0","6065","23067","1330.509375","0.017296621875","4218968.666249982","54.84659266124938"
"2684","6065","6065","0","6065","23067","1330.509375","0.017296621875","4220299.175624982","54.86388928312438"
"2685","6065","6065","0","6065","23067","1330.509375","0.017296621875","4221629.684999983","54.88118590499938"
"2686","6065","6065","0","6065","23067","1330.509375","0.017296621875","4222960.194374983","54.898482526874375"
"2687","6065","6065","0","6065","23067","1330.509375","0.017296621875","4224290.703749984","54.91577914874937"
"2688","6065","6065","0","6065","23067","1330.509375","0.017296621875","4225621.213124984","54.93307577062437"
"2689","6065","6065","0","6065","23067","1330.509375","0.017296621875","4226951.722499984","54.95037239249937"
"2690","6065","6065","0","6065","23067","1330.509375","0.017296621875","4228282.231874985","54.967669014374366"
"2691","6065","6065","0","6065","23067","1330.509375","0.017296621875","4229612.741249985","54.98496563624936"
"2692","6065","6065","0","6065","23067","1330.509375","0.017296621875","4230943.250624985","55.00226225812436"
"2693","6065","6065","0","6065","23067","1330.509375","0.017296621875","4232273.759999986","55.01955887999936"
"2694","6065","6065","0","6065","23067","1330.509375","0.017296621875","4233604.269374986","55.036855501874356"
"2695","6065","6065","0","6065","23067","1330.509375","0.017296621875","4234934.778749987","55.054152123749354"
"2696","6065","6065","0","6065","23067","1330.509375","0.017296621875","4236265.288124987","55.07144874562435"
"2697","6065","6065","0","6065","23067","1330.509375","0.017296621875","4237595.797499987","55.08874536749935"
"2698","6065","6065","0","6065","23067","1330.509375","0.017296621875","4238926.306874988","55.10604198937435"
"2699","6065","6065","0","6065","23067","1330.509375","0.017296621875","4240256.816249988","55.123338611249345"
"2700","6065","6065","0","6065","23067","1330.509375","0.017296621875","4241587.325624988","55.14063523312434"
"2701","6065","6065","0","6065","23067","1330.509375","0.017296621875","4242917.834999989","55.15793185499934"
"2702","6065","6065","0","6065","23067","1330.509375","0.017296621875","4244248.344374989","55.17522847687434"
"2703","6065","6065","0","6065","23067","1330.509375","0.017296621875","4245578.8537499895","55.192525098749336"
"2704","6065","6065","0","6065","23067","1330.509375","0.017296621875","4246909.36312499","55.20982172062433"
"2705","6065","6065","0","6065","23067","1330.509375","0.017296621875","4248239.87249999","55.22711834249933"
"2706","6065","6065","0","6065","23067","1330.509375","0.017296621875","4249570.381874991","55.24441496437433"
"2707","6065","6065","0","6065","23067","1330.509375","0.017296621875","4250900.891249991","55.261711586249326"
"2708","6065","6065","0","6065","23067","1330.509375","0.017296621875","4252231.400624991","55.279008208124324"
"2709","6065","6065","0","6065","23067","1330.509375","0.017296621875","4253561.909999992","55.29630482999932"
"2710","6065","6065","0","6065","23067","1330.509375","0.017296621875","4254892.419374992","55.31360145187432"
"2711","6065","6065","0","6065","23067","1330.509375","0.017296621875","4256222.9287499925","55.33089807374932"
"2712","6065","6065","0","6065","23067","1330.509375","0.017296621875","4257553.438124993","55.348194695624315"
"2713","6065","6065","0","6065","23067","1330.509375","0.017296621875","4258883.947499993","55.36549131749931"
"2714","6065","6065","0","6065","23067","1330.509375","0.017296621875","4260214.456874994","55.38278793937431"
"2715","6065","6065","0","6065","23067","1330.509375","0.017296621875","4261544.966249994","55.40008456124931"
"2716","6065","6065","0","6065","23067","1330.509375","0.017296621875","4262875.475624994","55.417381183124306"
"2717","6065","6065","0","6065","23067","1330.509375","0.017296621875","4264205.984999995","55.4346778049993"
"2718","6065","6065","0","6065","23067","1330.509375","0.017296621875","4265536.494374995","55.4519744268743"
"2719","6065","6065","0","6065","23067","1330.509375","0.017296621875","4266867.0037499955","55.4692710487493"
"2720","6065","6065","0","6065","23067","1330.509375","0.017296621875","4268197.513124996","55.4865676706243"
"2721","6065","6065","0","6065","23067","1330.509375","0.017296621875","4269528.022499996","55.503864292499294"
"2722","6065","6065","0","6065","23067","1330.509375","0.017296621875","4270858.531874997","55.52116091437429"
"2723","6065","6065","0","6065","23067","1330.509375","0.017296621875","4272189.041249997","55.53845753624929"
"2724","6065","6065","0","6065","23067","1330.509375","0.017296621875","4273519.550624997","55.55575415812429"
"2725","6065","6065","0","6065","23067","1330.509375","0.017296621875","4274850.059999998","55.573050779999285"
"2726","6065","6065","0","6065","23067","1330.509375","0.017296621875","4276180.569374998","55.59034740187428"
"2727","6065","6065","0","6065","23067","1330.509375","0.017296621875","4277511.0787499985","55.60764402374928"
"2728","6065","6065","0","6065","23067","1330.509375","0.017296621875","4278841.588124999","55.62494064562428"
"2729","6065","6065","0","6065","23067","1330.509375","0.017296621875","4280172.097499999","55.642237267499276"
"2730","6065","6065","0","6065","23067","1330.509375","0.017296621875","4281502.606875","55.65953388937427"
"2731","6065","6065","0","6065","23067","1330.509375","0.017296621875","4282833.11625","55.67683051124927"
"2732","6065","6065","0","6065","23067","1330.509375","0.017296621875","4284163.625625","55.69412713312427"
"2733","6065","6065","0","6065","23067","1330.509375","0.017296621875","4285494.135000001","55.71142375499927"
"2734","6065","6065","0","6065","23067","1330.509375","0.017296621875","4286824.644375001","55.728720376874264"
"2735","6065","6065","0","6065","23067","1330.509375","0.017296621875","4288155.153750001","55.74601699874926"
"2736","6065","6065","0","6065","23067","1330.509375","0.017296621875","4289485.663125002","55.76331362062426"
"2737","6065","6065","0","6065","23067","1330.509375","0.017296621875","4290816.172500002","55.78061024249926"
"2738","6065","6065","0","6065","23067","1330.509375","0.017296621875","4292146.681875003","55.797906864374255"
"2739","6065","6065","0","6065","23067","1330.509375","0.017296621875","4293477.191250003","55.81520348624925"
"2740","6065","6065","0","6065","23067","1330.509375","0.017296621875","4294807.700625003","55.83250010812425"
"2741","6065","6065","0","6065","23067","1330.509375","0.017296621875","4296138.210000004","55.84979672999925"
"2742","6065","6065","0","6065","23067","1330.509375","0.017296621875","4297468.719375004","55.867093351874246"
"2743","6065","6065","0","6065","23067","1330.509375","0.017296621875","4298799.228750004","55.88438997374924"
"2744","6065","6065","0","6065","23067","1330.509375","0.017296621875","4300129.738125005","55.90168659562424"
"2745","6065","6065","0","6065","23067","1330.509375","0.017296621875","4301460.247500005","55.91898321749924"
"2746","6065","6065","0","6065","23067","1330.509375","0.017296621875","4302790.756875006","55.93627983937424"
"2747","6065","6065","0","6065","23067","1330.509375","0.017296621875","4304121.266250006","55.953576461249234"
"2748","6065","6065","0","6065","23067","1330.509375","0.017296621875","4305451.775625006","55.97087308312423"
"2749","6065","6065","0","6065","23067","1330.509375","0.017296621875","4306782.285000007","55.98816970499923"
"2750","6065","6065","0","6065","23067","1330.509375","0.017296621875","4308112.794375007","56.00546632687423"
"2751","6065","6065","0","6065","23067","1330.509375","0.017296621875","4309443.303750007","56.022762948749225"
"2752","6065","6065","0","6065","23067","1330.509375","0.017296621875","4310773.813125008","56.04005957062422"
"2753","6065","6065","0","6065","23067","1330.509375","0.017296621875","4312104.322500008","56.05735619249922"
"2754","6065","6065","0","6065","23067","1330.509375","0.017296621875","4313434.8318750085","56.07465281437422"
"2755","6065","6065","0","6065","23067","1330.509375","0.017296621875","4314765.341250009","56.091949436249216"
"2756","6065","6065","0","6065","23067","1330.509375","0.017296621875","4316095.850625009","56.109246058124214"
"2757","6065","6065","0","6065","23067","1330.509375","0.017296621875","4317426.36000001","56.12654267999921"
"2758","6065","6065","0","6065","23067","1330.509375","0.017296621875","4318756.86937501","56.14383930187421"
"2759","6065","6065","0","6065","23067","1330.509375","0.017296621875","4320087.37875001","56.16113592374921"
"2760","6065","6065","0","6065","23067","1330.509375","0.017296621875","4321417.888125011","56.178432545624204"
"2761","6065","6065","0","6065","23067","1330.509375","0.017296621875","4322748.397500011","56.1957291674992"
"2762","6065","6065","0","6065","23067","1330.509375","0.017296621875","4324078.9068750115","56.2130257893742"
"2763","6065","6065","0","6065","23067","1330.509375","0.017296621875","4325409.416250012","56.2303224112492"
"2764","6065","6065","0","6065","23067","1330.509375","0.017296621875","4326739.925625012","56.247619033124195"
"2765","6065","6065","0","6065","23067","1330.509375","0.017296621875","4328070.435000013","56.26491565499919"
"2766","6065","6065","0","6065","23067","1330.509375","0.017296621875","4329400.944375013","56.28221227687419"
"2767","6065","6065","0","6065","23067","1330.509375","0.017296621875","4330731.453750013","56.29950889874919"
"2768","6065","6065","0","6065","23067","1330.509375","0.017296621875","4332061.963125014","56.316805520624186"
"2769","6065","6065","0","6065","23067","1330.509375","0.017296621875","4333392.472500014","56.334102142499184"
"2770","6065","6065","0","6065","23067","1330.509375","0.017296621875","4334722.9818750145","56.35139876437418"
"2771","6065","6065","0","6065","23067","1330.509375","0.017296621875","4336053.491250015","56.36869538624918"
"2772","6065","6065","0","6065","23067","1330.509375","0.017296621875","4337384.000625015","56.38599200812418"
"2773","6065","6065","0","6065","23067","1330.509375","0.017296621875","4338714.510000016","56.403288629999174"
"2774","6065","6065","0","6065","23067","1330.509375","0.017296621875","4340045.019375016","56.42058525187417"
"2775","6065","6065","0","6065","23067","1330.509375","0.017296621875","4341375.528750016","56.43788187374917"
"2776","6065","6065","0","6065","23067","1330.509375","0.017296621875","4342706.038125017","56.45517849562417"
"2777","6065","6065","0","6065","23067","1330.509375","0.017296621875","4344036.547500017","56.472475117499165"
"2778","6065","6065","0","6065","23067","1330.509375","0.017296621875","4345367.0568750175","56.48977173937416"
"2779","6065","6065","0","6065","23067","1330.509375","0.017296621875","4346697.566250018","56.50706836124916"
"2780","6065","6065","0","6065","23067","1330.509375","0.017296621875","4348028.075625018","56.52436498312416"
"2781","6065","6065","0","6065","23067","1330.509375","0.017296621875","4349358.585000019","56.541661604999156"
"2782","6065","6065","0","6065","23067","1330.509375","0.017296621875","4350689.094375019","56.558958226874154"
"2783","6065","6065","0","6065","23067","1330.509375","0.017296621875","4352019.603750019","56.57625484874915"
"2784","6065","6065","0","6065","23067","1330.509375","0.017296621875","4353350.11312502","56.59355147062415"
"2785","6065","6065","0","6065","23067","1330.509375","0.017296621875","4354680.62250002","56.61084809249915"
"2786","6065","6065","0","6065","23067","1330.509375","0.017296621875","4356011.13187502","56.628144714374145"
"2787","6065","6065","0","6065","23067","1330.509375","0.017296621875","4357341.641250021","56.64544133624914"
"2788","6065","6065","0","6065","23067","1330.509375","0.017296621875","4358672.150625021","56.66273795812414"
"2789","6065","6065","0","6065","23067","1330.509375","0.017296621875","4360002.660000022","56.68003457999914"
"2790","6065","6065","0","6065","23067","1330.509375","0.017296621875","4361333.169375022","56.697331201874135"
"2791","6065","6065","0","6065","23067","1330.509375","0.017296621875","4362663.678750022","56.71462782374913"
"2792","6065","6065","0","6065","23067","1330.509375","0.017296621875","4363994.188125023","56.73192444562413"
"2793","6065","6065","0","6065","23067","1330.509375","0.017296621875","4365324.697500023","56.74922106749913"
"2794","6065","6065","0","6065","23067","1330.509375","0.017296621875","4366655.206875023","56.766517689374126"
"2795","6065","6065","0","6065","23067","1330.509375","0.017296621875","4367985.716250024","56.783814311249124"
"2796","6065","6065","0","6065","23067","1330.509375","0.017296621875","4369316.225625024","56.80111093312412"
"2797","6065","6065","0","6065","23067","1330.509375","0.017296621875","4370646.735000025","56.81840755499912"
"2798","6065","6065","0","6065","23067","1330.509375","0.017296621875","4371977.244375025","56.83570417687412"
"2799","6065","6065","0","6065","23067","1330.509375","0.017296621875","4373307.753750025","56.853000798749115"
"2800","6065","6065","0","6065","23067","1330.509375","0.017296621875","4374638.263125026","56.87029742062411"
"2801","6065","6065","0","6065","23067","1330.509375","0.017296621875","4375968.772500026","56.88759404249911"
"2802","6065","6065","0","6065","23067","1330.509375","0.017296621875","4377299.281875026","56.90489066437411"
"2803","6065","6065","0","6065","23067","1330.509375","0.017296621875","4378629.791250027","56.922187286249105"
"2804","6065","6065","0","6065","23067","1330.509375","0.017296621875","4379960.300625027","56.9394839081241"
"2805","6065","6065","0","6065","23067","1330.509375","0.017296621875","4381290.8100000275","56.9567805299991"
"2806","6065","6065","0","6065","23067","1330.509375","0.017296621875","4382621.319375028","56.9740771518741"
"2807","6065","6065","0","6065","23067","1330.509375","0.017296621875","4383951.828750028","56.991373773749096"
"2808","6065","6065","0","6065","23067","1330.509375","0.017296621875","4385282.338125029","57.008670395624094"
"2809","6065","6065","0","6065","23067","1330.509375","0.017296621875","4386612.847500029","57.02596701749909"
"2810","6065","6065","0","6065","23067","1330.509375","0.017296621875","4387943.356875029","57.04326363937409"
"2811","6065","6065","0","6065","23067","1330.509375","0.017296621875","4389273.86625003","57.06056026124909"
"2812","6065","6065","0","6065","23067","1330.509375","0.017296621875","4390604.37562503","57.077856883124085"
"2813","6065","6065","0","6065","23067","1330.509375","0.017296621875","4391934.8850000305","57.09515350499908"
"2814","6065","6065","0","6065","23067","1330.509375","0.017296621875","4393265.394375031","57.11245012687408"
"2815","6065","6065","0","6065","23067","1330.509375","0.017296621875","4394595.903750031","57.12974674874908"
"2816","6065","6065","0","6065","23067","1330.509375","0.017296621875","4395926.413125032","57.147043370624075"
"2817","6065","6065","0","6065","23067","1330.509375","0.017296621875","4397256.922500032","57.16433999249907"
"2818","6065","6065","0","6065","23067","1330.509375","0.017296621875","4398587.431875032","57.18163661437407"
"2819","6065","6065","0","6065","23067","1330.509375","0.017296621875","4399917.941250033","57.19893323624907"
"2820","6065","6065","0","6065","23067","1330.509375","0.017296621875","4401248.450625033","57.216229858124066"
"2821","6065","6065","0","6065","23067","1330.509375","0.017296621875","4402578.9600000335","57.233526479999064"
"2822","6065","6065","0","6065","23067","1330.509375","0.017296621875","4403909.469375034","57.25082310187406"
"2823","6065","6065","0","6065","23067","1330.509375","0.017296621875","4405239.978750034","57.26811972374906"
"2824","6065","6065","0","6065","23067","1330.509375","0.017296621875","4406570.488125035","57.28541634562406"
"2825","6065","6065","0","6065","23067","1330.509375","0.017296621875","4407900.997500035","57.302712967499055"
"2826","6065","6065","0","6065","23067","1330.509375","0.017296621875","4409231.506875035","57.32000958937405"
"2827","6065","6065","0","6065","23067","1330.509375","0.017296621875","4410562.016250036","57.33730621124905"
"2828","6065","6065","0","6065","23067","1330.509375","0.017296621875","4411892.525625036","57.35460283312405"
"2829","6065","6065","0","6065","23067","1330.509375","0.017296621875","4413223.0350000365","57.371899454999046"
"2830","6065","6065","0","6065","23067","1330.509375","0.017296621875","4414553.544375037","57.38919607687404"
"2831","6065","6065","0","6065","23067","1330.509375","0.017296621875","4415884.053750037","57.40649269874904"
"2832","6065","6065","0","6065","23067","1330.509375","0.017296621875","4417214.563125038","57.42378932062404"
"2833","6065","6065","0","6065","23067","1330.509375","0.017296621875","4418545.072500038","57.441085942499036"
"2834","6065","6065","0","6065","23067","1330.509375","0.017296621875","4419875.581875038","57.458382564374034"
"2835","6065","6065","0","6065","23067","1330.509375","0.017296621875","4421206.091250039","57.47567918624903"
"2836","6065","6065","0","6065","23067","1330.509375","0.017296621875","4422536.600625039","57.49297580812403"
"2837","6065","6065","0","6065","23067","1330.509375","0.017296621875","4423867.110000039","57.51027242999903"
"2838","6065","6065","0","6065","23067","1330.509375","0.017296621875","4425197.61937504","57.527569051874025"
"2839","6065","6065","0","6065","23067","1330.509375","0.017296621875","4426528.12875004","57.54486567374902"
"2840","6065","6065","0","6065","23067","1330.509375","0.017296621875","4427858.638125041","57.56216229562402"
"2841","6065","6065","0","6065","23067","1330.509375","0.017296621875","4429189.147500041","57.57945891749902"
"2842","6065","6065","0","6065","23067","1330.509375","0.017296621875","4430519.656875041","57.596755539374016"
"2843","6065","6065","0","6065","23067","1330.509375","0.017296621875","4431850.166250042","57.61405216124901"
"2844","6065","6065","0","6065","23067","1330.509375","0.017296621875","4433180.675625042","57.63134878312401"
"2845","6065","6065","0","6065","23067","1330.509375","0.017296621875","4434511.185000042","57.64864540499901"
"2846","6065","6065","0","6065","23067","1330.509375","0.017296621875","4435841.694375043","57.665942026874006"
"2847","6065","6065","0","6065","23067","1330.509375","0.017296621875","4437172.203750043","57.683238648749004"
"2848","6065","6065","0","6065","23067","1330.509375","0.017296621875","4438502.713125044","57.700535270624"
"2849","6065","6065","0","6065","23067","1330.509375","0.017296621875","4439833.222500044","57.717831892499"
"2850","6065","6065","0","6065","23067","1330.509375","0.017296621875","4441163.731875044","57.735128514374"
"2851","6065","6065","0","6065","23067","1330.509375","0.017296621875","4442494.241250045","57.752425136248995"
"2852","6065","6065","0","6065","23067","1330.509375","0.017296621875","4443824.750625045","57.76972175812399"
"2853","6065","6065","0","6065","23067","1330.509375","0.017296621875","4445155.260000045","57.78701837999899"
"2854","6065","6065","0","6065","23067","1330.509375","0.017296621875","4446485.769375046","57.80431500187399"
"2855","6065","6065","0","6065","23067","1330.509375","0.017296621875","4447816.278750046","57.821611623748986"
"2856","6065","6065","0","6065","23067","1330.509375","0.017296621875","4449146.7881250465","57.83890824562398"
"2857","6065","6065","0","6065","23067","1330.509375","0.017296621875","4450477.297500047","57.85620486749898"
"2858","6065","6065","0","6065","23067","1330.509375","0.017296621875","4451807.806875047","57.87350148937398"
"2859","6065","6065","0","6065","23067","1330.509375","0.017296621875","4453138.316250048","57.89079811124898"
"2860","6065","6065","0","6065","23067","1330.509375","0.017296621875","4454468.825625048","57.908094733123974"
"2861","6065","6065","0","6065","23067","1330.509375","0.017296621875","4455799.335000048","57.92539135499897"
"2862","6065","6065","0","6065","23067","1330.509375","0.017296621875","4457129.844375049","57.94268797687397"
"2863","6065","6065","0","6065","23067","1330.509375","0.017296621875","4458460.353750049","57.95998459874897"
"2864","6065","6065","0","6065","23067","1330.509375","0.017296621875","4459790.8631250495","57.977281220623965"
"2865","6065","6065","0","6065","23067","1330.509375","0.017296621875","4461121.37250005","57.99457784249896"
"2866","6065","6065","0","6065","23067","1330.509375","0.017296621875","4462451.88187505","58.01187446437396"
"2867","6065","6065","0","6065","23067","1330.509375","0.017296621875","4463782.391250051","58.02917108624896"
"2868","6065","6065","0","6065","23067","1330.509375","0.017296621875","4465112.900625051","58.046467708123956"
"2869","6065","6065","0","6065","23067","1330.509375","0.017296621875","4466443.410000051","58.06376432999895"
"2870","6065","6065","0","6065","23067","1330.509375","0.017296621875","4467773.919375052","58.08106095187395"
"2871","6065","6065","0","6065","23067","1330.509375","0.017296621875","4469104.428750052","58.09835757374895"
"2872","6065","6065","0","6065","23067","1330.509375","0.017296621875","4470434.9381250525","58.11565419562395"
"2873","6065","6065","0","6065","23067","1330.509375","0.017296621875","4471765.447500053","58.132950817498944"
"2874","6065","6065","0","6065","23067","1330.509375","0.017296621875","4473095.956875053","58.15024743937394"
"2875","6065","6065","0","6065","23067","1330.509375","0.017296621875","4474426.466250054","58.16754406124894"
"2876","6065","6065","0","6065","23067","1330.509375","0.017296621875","4475756.975625054","58.18484068312394"
"2877","6065","6065","0","6065","23067","1330.509375","0.017296621875","4477087.485000054","58.202137304998935"
"2878","6065","6065","0","6065","23067","1330.509375","0.017296621875","4478417.994375055","58.21943392687393"
"2879","6065","6065","0","6065","23067","1330.509375","0.017296621875","4479748.503750055","58.23673054874893"
"2880","6065","6065","0","6065","23067","1330.509375","0.017296621875","4481079.0131250555","58.25402717062393"
"2881","6065","6065","0","6065","23067","1330.509375","0.017296621875","4482409.522500056","58.271323792498926"
"2882","6065","6065","0","6065","23067","1330.509375","0.017296621875","4483740.031875056","58.28862041437392"
"2883","6065","6065","0","6065","23067","1330.509375","0.017296621875","4485070.541250057","58.30591703624892"
"2884","6065","6065","0","6065","23067","1330.509375","0.017296621875","4486401.050625057","58.32321365812392"
"2885","6065","6065","0","6065","23067","1330.509375","0.017296621875","4487731.560000057","58.34051027999892"
"2886","6065","6065","0","6065","23067","1330.509375","0.017296621875","4489062.069375058","58.357806901873914"
"2887","6065","6065","0","6065","23067","1330.509375","0.017296621875","4490392.578750058","58.37510352374891"
"2888","6065","6065","0","6065","23067","1330.509375","0.017296621875","4491723.088125058","58.39240014562391"
"2889","6065","6065","0","6065","23067","1330.509375","0.017296621875","4493053.597500059","58.40969676749891"
"2890","6065","6065","0","6065","23067","1330.509375","0.017296621875","4494384.106875059","58.426993389373905"
"2891","6065","6065","0","6065","23067","1330.509375","0.017296621875","4495714.61625006","58.4442900112489"
"2892","6065","6065","0","6065","23067","1330.509375","0.017296621875","4497045.12562506","58.4615866331239"
"2893","6065","6065","0","6065","23067","1330.509375","0.017296621875","4498375.63500006","58.4788832549989"
"2894","6065","6065","0","6065","23067","1330.509375","0.017296621875","4499706.144375061","58.496179876873896"
"2895","6065","6065","0","6065","23067","1330.509375","0.017296621875","4501036.653750061","58.513476498748894"
"2896","6065","6065","0","6065","23067","1330.509375","0.017296621875","4502367.163125061","58.53077312062389"
"2897","6065","6065","0","6065","23067","1330.509375","0.017296621875","4503697.672500062","58.54806974249889"
"2898","6065","6065","0","6065","23067","1330.509375","0.017296621875","4505028.181875062","58.56536636437389"
"2899","6065","6065","0","6065","23067","1330.509375","0.017296621875","4506358.691250063","58.582662986248884"
"2900","6065","6065","0","6065","23067","1330.509375","0.017296621875","4507689.200625063","58.59995960812388"
"2901","6065","6065","0","6065","23067","1330.509375","0.017296621875","4509019.710000063","58.61725622999888"
"2902","6065","6065","0","6065","23067","1330.509375","0.017296621875","4510350.219375064","58.63455285187388"
"2903","6065","6065","0","6065","23067","1330.509375","0.017296621875","4511680.728750064","58.651849473748875"
"2904","6065","6065","0","6065","23067","1330.509375","0.017296621875","4513011.238125064","58.66914609562387"
"2905","6065","6065","0","6065","23067","1330.509375","0.017296621875","4514341.747500065","58.68644271749887"
"2906","6065","6065","0","6065","23067","1330.509375","0.017296621875","4515672.256875065","58.70373933937387"
"2907","6065","6065","0","6065","23067","1330.509375","0.017296621875","4517002.7662500655","58.721035961248866"
"2908","6065","6065","0","6065","23067","1330.509375","0.017296621875","4518333.275625066","58.738332583123864"
"2909","6065","6065","0","6065","23067","1330.509375","0.017296621875","4519663.785000066","58.75562920499886"
"2910","6065","6065","0","6065","23067","1330.509375","0.017296621875","4520994.294375067","58.77292582687386"
"2911","6065","6065","0","6065","23067","1330.509375","0.017296621875","4522324.803750067","58.79022244874886"
"2912","6065","6065","0","6065","23067","1330.509375","0.017296621875","4523655.313125067","58.807519070623854"
"2913","6065","6065","0","6065","23067","1330.509375","0.017296621875","4524985.822500068","58.82481569249885"
"2914","6065","6065","0","6065","23067","1330.509375","0.017296621875","4526316.331875068","58.84211231437385"
"2915","6065","6065","0","6065","23067","1330.509375","0.017296621875","4527646.8412500685","58.85940893624885"
"2916","6065","6065","0","6065","23067","1330.509375","0.017296621875","4528977.350625069","58.876705558123845"
"2917","6065","6065","0","6065","23067","1330.509375","0.017296621875","4530307.860000069","58.89400217999884"
"2918","6065","6065","0","6065","23067","1330.509375","0.017296621875","4531638.36937507","58.91129880187384"
"2919","6065","6065","0","6065","23067","1330.509375","0.017296621875","4532968.87875007","58.92859542374884"
"2920","6065","6065","0","6065","23067","1330.509375","0.017296621875","4534299.38812507","58.945892045623836"
"2921","6065","6065","0","6065","23067","1330.509375","0.017296621875","4535629.897500071","58.963188667498834"
"2922","6065","6065","0","6065","23067","1330.509375","0.017296621875","4536960.406875071","58.98048528937383"
"2923","6065","6065","0","6065","23067","1330.509375","0.017296621875","4538290.9162500715","58.99778191124883"
"2924","6065","6065","0","6065","23067","1330.509375","0.017296621875","4539621.425625072","59.01507853312383"
"2925","6065","6065","0","6065","23067","1330.509375","0.017296621875","4540951.935000072","59.032375154998824"
"2926","6065","6065","0","6065","23067","1330.509375","0.017296621875","4542282.444375073","59.04967177687382"
"2927","6065","6065","0","6065","23067","1330.509375","0.017296621875","4543612.953750073","59.06696839874882"
"2928","6065","6065","0","6065","23067","1330.509375","0.017296621875","4544943.463125073","59.08426502062382"
"2929","6065","6065","0","6065","23067","1330.509375","0.017296621875","4546273.972500074","59.101561642498815"
"2930","6065","6065","0","6065","23067","1330.509375","0.017296621875","4547604.481875074","59.11885826437381"
"2931","6065","6065","0","6065","23067","1330.509375","0.017296621875","4548934.9912500745","59.13615488624881"
"2932","6065","6065","0","6065","23067","1330.509375","0.017296621875","4550265.500625075","59.15345150812381"
"2933","6065","6065","0","6065","23067","1330.509375","0.017296621875","4551596.010000075","59.170748129998806"
"2934","6065","6065","0","6065","23067","1330.509375","0.017296621875","4552926.519375076","59.188044751873804"
"2935","6065","6065","0","6065","23067","1330.509375","0.017296621875","4554257.028750076","59.2053413737488"
"2936","6065","6065","0","6065","23067","1330.509375","0.017296621875","4555587.538125076","59.2226379956238"
"2937","6065","6065","0","6065","23067","1330.509375","0.017296621875","4556918.047500077","59.2399346174988"
"2938","6065","6065","0","6065","23067","1330.509375","0.017296621875","4558248.556875077","59.257231239373795"
"2939","6065","6065","0","6065","23067","1330.509375","0.017296621875","4559579.066250077","59.27452786124879"
"2940","6065","6065","0","6065","23067","1330.509375","0.017296621875","4560909.575625078","59.29182448312379"
"2941","6065","6065","0","6065","23067","1330.509375","0.017296621875","4562240.085000078","59.30912110499879"
"2942","6065","6065","0","6065","23067","1330.509375","0.017296621875","4563570.594375079","59.326417726873785"
"2943","6065","6065","0","6065","23067","1330.509375","0.017296621875","4564901.103750079","59.34371434874878"
"2944","6065","6065","0","6065","23067","1330.509375","0.017296621875","4566231.613125079","59.36101097062378"
"2945","6065","6065","0","6065","23067","1330.509375","0.017296621875","4567562.12250008","59.37830759249878"
"2946","6065","6065","0","6065","23067","1330.509375","0.017296621875","4568892.63187508","59.395604214373776"
"2947","6065","6065","0","6065","23067","1330.509375","0.017296621875","4570223.14125008","59.412900836248774"
"2948","6065","6065","0","6065","23067","1330.509375","0.017296621875","4571553.650625081","59.43019745812377"
"2949","6065","6065","0","6065","23067","1330.509375","0.017296621875","4572884.160000081","59.44749407999877"
"2950","6065","6065","0","6065","23067","1330.509375","0.017296621875","4574214.669375082","59.46479070187377"
"2951","6065","6065","0","6065","23067","1330.509375","0.017296621875","4575545.178750082","59.482087323748765"
"2952","6065","6065","0","6065","23067","1330.509375","0.017296621875","4576875.688125082","59.49938394562376"
"2953","6065","6065","0","6065","23067","1330.509375","0.017296621875","4578206.197500083","59.51668056749876"
"2954","6065","6065","0","6065","23067","1330.509375","0.017296621875","4579536.706875083","59.53397718937376"
"2955","6065","6065","0","6065","23067","1330.509375","0.017296621875","4580867.216250083","59.551273811248755"
"2956","6065","6065","0","6065","23067","1330.509375","0.017296621875","4582197.725625084","59.56857043312375"
"2957","6065","6065","0","6065","23067","1330.509375","0.017296621875","4583528.235000084","59.58586705499875"
"2958","6065","6065","0","6065","23067","1330.509375","0.017296621875","4584858.7443750845","59.60316367687375"
"2959","6065","6065","0","6065","23067","1330.509375","0.017296621875","4586189.253750085","59.620460298748746"
"2960","6065","6065","0","6065","23067","1330.509375","0.017296621875","4587519.763125085","59.637756920623744"
"2961","6065","6065","0","6065","23067","1330.509375","0.017296621875","4588850.272500086","59.65505354249874"
"2962","6065","6065","0","6065","23067","1330.509375","0.017296621875","4590180.781875086","59.67235016437374"
"2963","6065","6065","0","6065","23067","1330.509375","0.017296621875","4591511.291250086","59.68964678624874"
"2964","6065","6065","0","6065","23067","1330.509375","0.017296621875","4592841.800625087","59.706943408123735"
"2965","6065","6065","0","6065","23067","1330.509375","0.017296621875","4594172.310000087","59.72424002999873"
"2966","6065","6065","0","6065","23067","1330.509375","0.017296621875","4595502.8193750875","59.74153665187373"
"2967","6065","6065","0","6065","23067","1330.509375","0.017296621875","4596833.328750088","59.75883327374873"
"2968","6065","6065","0","6065","23067","1330.509375","0.017296621875","4598163.838125088","59.776129895623725"
"2969","6065","6065","0","6065","23067","1330.509375","0.017296621875","4599494.347500089","59.79342651749872"
"2970","6065","6065","0","6065","23067","1330.509375","0.017296621875","4600824.856875089","59.81072313937372"
"2971","6065","6065","0","6065","23067","1330.509375","0.017296621875","4602155.366250089","59.82801976124872"
"2972","6065","6065","0","6065","23067","1330.509375","0.017296621875","4603485.87562509","59.845316383123716"
"2973","6065","6065","0","6065","23067","1330.509375","0.017296621875","4604816.38500009","59.862613004998714"
"2974","6065","6065","0","6065","23067","1330.509375","0.017296621875","4606146.8943750905","59.87990962687371"
"2975","6065","6065","0","6065","23067","1330.509375","0.017296621875","4607477.403750091","59.89720624874871"
"2976","6065","6065","0","6065","23067","1330.509375","0.017296621875","4608807.913125091","59.91450287062371"
"2977","6065","6065","0","6065","23067","1330.509375","0.017296621875","4610138.422500092","59.931799492498705"
"2978","6065","6065","0","6065","23067","1330.509375","0.017296621875","4611468.931875092","59.9490961143737"
"2979","6065","6065","0","6065","23067","1330.509375","0.017296621875","4612799.441250092","59.9663927362487"
"2980","6065","6065","0","6065","23067","1330.509375","0.017296621875","4614129.950625093","59.9836893581237"
"2981","6065","6065","0","6065","23067","1330.509375","0.017296621875","4615460.460000093","60.000985979998696"
"2982","6065","6065","0","6065","23067","1330.509375","0.017296621875","4616790.9693750935","60.01828260187369"
"2983","6065","6065","0","6065","23067","1330.509375","0.017296621875","4618121.478750094","60.03557922374869"
"2984","6065","6065","0","6065","23067","1330.509375","0.017296621875","4619451.988125094","60.05287584562369"
"2985","6065","6065","0","6065","23067","1330.509375","0.017296621875","4620782.497500095","60.070172467498686"
"2986","6065","6065","0","6065","23067","1330.509375","0.017296621875","4622113.006875095","60.087469089373684"
"2987","6065","6065","0","6065","23067","1330.509375","0.017296621875","4623443.516250095","60.10476571124868"
"2988","6065","6065","0","6065","23067","1330.509375","0.017296621875","4624774.025625096","60.12206233312368"
"2989","6065","6065","0","6065","23067","1330.509375","0.017296621875","4626104.535000096","60.13935895499868"
"2990","6065","6065","0","6065","23067","1330.509375","0.017296621875","4627435.044375096","60.156655576873675"
"2991","6065","6065","0","6065","23067","1330.509375","0.017296621875","4628765.553750097","60.17395219874867"
"2992","6065","6065","0","6065","23067","1330.509375","0.017296621875","4630096.063125097","60.19124882062367"
"2993","6065","6065","0","6065","23067","1330.509375","0.017296621875","4631426.572500098","60.20854544249867"
"2994","6065","6065","0","6065","23067","1330.509375","0.017296621875","4632757.081875098","60.225842064373666"
"2995","6065","6065","0","6065","23067","1330.509375","0.017296621875","4634087.591250098","60.24313868624866"
"2996","6065","6065","0","6065","23067","1330.509375","0.017296621875","4635418.100625099","60.26043530812366"
"2997","6065","6065","0","6065","23067","1330.509375","0.017296621875","4636748.610000099","60.27773192999866"
"2998","6065","6065","0","6065","23067","1330.509375","0.017296621875","4638079.119375099","60.295028551873656"
"2999","6065","6065","0","6065","23067","1330.509375","0.017296621875","4639409.6287501","60.312325173748654"
"3000","6065","6065","0","6065","23067","1330.509375","0.017296621875","4640740.1381251","60.32962179562365"
"3001","6065","6065","0","6065","23067","1330.509375","0.017296621875","4642070.647500101","60.34691841749865"
"3002","6065","6058","2","6060","23069","1329.4125","0.0172823625","4643400.0600001","60.36420077999865"
"3003","6060","6059","2","6061","23071","1329.631875","0.017285214375","4644729.6918751","60.38148599437365"
"3004","6061","6053","3","6056","23074","1328.535","0.017270955","4646058.2268751","60.39875694937365"
"3005","6056","6054","8","6062","23082","1329.85125","0.017288066249999998","4647388.078125101","60.41604501562365"
"3006","6062","6055","4","6059","23086","1329.193125","0.017279510624999998","4648717.271250101","60.433324526248654"
"3007","6059","6053","9","6062","23095","1329.85125","0.017288066249999998","4650047.122500101","60.45061259249866"
"3008","6062","6053","8","6061","23103","1329.631875","0.017285214375","4651376.754375101","60.46789780687366"
"3009","6061","6054","7","6061","23110","1329.631875","0.017285214375","4652706.386250101","60.48518302124866"
"3010","6061","6055","3","6058","23113","1328.97375","0.01727665875","4654035.360000101","60.50245967999866"
"3011","6058","6056","7","6063","23120","1330.070625","0.017290918125","4655365.430625101","60.51975059812366"
"3012","6063","6054","7","6061","23127","1329.631875","0.017285214375","4656695.062500101","60.53703581249866"
"3013","6061","6054","9","6063","23136","1330.070625","0.017290918125","4658025.1331251","60.55432673062366"
"3014","6063","6062","6","6068","23142","1331.1675000000002","0.0173051775","4659356.300625101","60.571631908123656"
"3015","6068","6066","3","6069","23145","1331.386875","0.017308029375","4660687.687500101","60.58893993749866"
"3016","6069","6065","8","6073","23153","1332.2643750000002","0.017319436875","4662019.951875101","60.60625937437366"
"3017","6073","6067","2","6069","23155","1331.386875","0.017308029375","4663351.338750101","60.62356740374866"
"3018","6069","6060","9","6069","23164","1331.386875","0.017308029375","4664682.725625101","60.64087543312366"
"3019","6069","6062","2","6064","23166","1330.29","0.01729377","4666013.015625101","60.65816920312366"
"3020","6064","6062","2","6064","23168","1330.29","0.01729377","4667343.305625101","60.675462973123665"
"3021","6064","6063","2","6065","23170","1330.509375","0.017296621875","4668673.815000101","60.69275959499866"
"3022","6065","6060","8","6068","23178","1331.1675000000002","0.0173051775","4670004.982500101","60.71006477249866"
"3023","6068","6061","8","6069","23186","1331.386875","0.017308029375","4671336.369375101","60.72737280187366"
"3024","6069","6063","9","6072","23195","1332.0449999999998","0.017316584999999995","4672668.414375101","60.74468938687367"
"3025","6072","6064","1","6065","23196","1330.509375","0.017296621875","4673998.923750102","60.761986008748664"
"3026","6065","6061","5","6066","23201","1330.72875","0.01729947375","4675329.652500101","60.779285482498665"
"3027","6066","6065","6","6071","23207","1331.8256250000002","0.017313733125","4676661.478125101","60.796599215623665"
"3028","6071","6065","3","6068","23210","1331.1675000000002","0.0173051775","4677992.645625101","60.813904393123664"
"3029","6068","6065","3","6068","23213","1331.1675000000002","0.0173051775","4679323.813125102","60.83120957062366"
"3030","6068","6060","2","6062","23215","1329.85125","0.017288066249999998","4680653.664375102","60.84849763687367"
"3031","6062","6056","3","6059","23218","1329.193125","0.017279510624999998","4681982.857500102","60.86577714749867"
"3032","6059","6055","5","6060","23223","1329.4125","0.0172823625","4683312.270000102","60.88305950999867"
"3033","6060","6056","8","6064","23231","1330.29","0.01729377","4684642.560000102","60.90035327999867"
"3034","6064","6062","3","6065","23234","1330.509375","0.017296621875","4685973.069375102","60.917649901873666"
"3035","6065","6059","4","6063","23238","1330.070625","0.017290918125","4687303.140000102","60.934940819998666"
"3036","6063","6061","8","6069","23246","1331.386875","0.017308029375","4688634.526875102","60.95224884937367"
"3037","6069","6066","1","6067","23247","1330.948125","0.017302325624999997","4689965.475000102","60.96955117499867"
"3038","6067","6061","6","6067","23253","1330.948125","0.017302325624999997","4691296.423125102","60.986853500623674"
"3039","6067","6061","3","6064","23256","1330.29","0.01729377","4692626.713125102","61.004147270623676"
"3040","6064","6058","4","6062","23260","1329.85125","0.017288066249999998","4693956.5643751025","61.02143533687368"
"3041","6062","6053","5","6058","23265","1328.97375","0.01727665875","4695285.538125102","61.03871199562368"
"3042","6058","6054","7","6061","23272","1329.631875","0.017285214375","4696615.170000102","61.05599720999868"
"3043","6061","6052","2","6054","23274","1328.0962499999998","0.017265251249999995","4697943.266250103","61.07326246124868"
"3044","6054","6049","7","6056","23281","1328.535","0.017270955","4699271.801250103","61.09053341624868"
"3045","6056","6055","7","6062","23288","1329.85125","0.017288066249999998","4700601.652500103","61.107821482498686"
"3046","6062","6055","9","6064","23297","1330.29","0.01729377","4701931.942500103","61.12511525249869"
"3047","6064","6061","6","6067","23303","1330.948125","0.017302325624999997","4703262.890625103","61.14241757812369"
"3048","6067","6058","7","6065","23310","1330.509375","0.017296621875","4704593.400000104","61.15971419999869"
"3049","6065","6057","6","6063","23316","1330.070625","0.017290918125","4705923.470625103","61.17700511812369"
"3050","6063","6060","7","6067","23323","1330.948125","0.017302325624999997","4707254.418750104","61.19430744374869"
"3051","6067","6061","1","6062","23324","1329.85125","0.017288066249999998","4708584.270000104","61.211595509998695"
"3052","6062","6061","3","6064","23327","1330.29","0.01729377","4709914.560000104","61.2288892799987"
"3053","6064","6062","2","6064","23329","1330.29","0.01729377","4711244.850000104","61.2461830499987"
"3054","6064","6057","5","6062","23334","1329.85125","0.017288066249999998","4712574.701250104","61.2634711162487"
"3055","6062","6059","4","6063","23338","1330.070625","0.017290918125","4713904.771875104","61.2807620343737"
"3056","6063","6054","8","6062","23346","1329.85125","0.017288066249999998","4715234.623125104","61.298050100623705"
"3057","6062","6059","9","6068","23355","1331.1675000000002","0.0173051775","4716565.790625105","61.315355278123704"
"3058","6068","6063","5","6068","23360","1331.1675000000002","0.0173051775","4717896.958125105","61.3326604556237"
"3059","6068","6059","8","6067","23368","1330.948125","0.017302325624999997","4719227.906250105","61.349962781248706"
"3060","6067","6058","9","6067","23377","1330.948125","0.017302325624999997","4720558.854375105","61.36726510687371"
"3061","6067","6064","5","6069","23382","1331.386875","0.017308029375","4721890.241250105","61.38457313624871"
"3062","6069","6063","1","6064","23383","1330.29","0.01729377","4723220.531250105","61.40186690624871"
"3063","6064","6056","7","6063","23390","1330.070625","0.017290918125","4724550.601875105","61.41915782437371"
"3064","6063","6062","1","6063","23391","1330.070625","0.017290918125","4725880.672500105","61.43644874249871"
"3065","6063","6059","5","6064","23396","1330.29","0.01729377","4727210.962500105","61.453742512498714"
"3066","6064","6057","3","6060","23399","1329.4125","0.0172823625","4728540.375000104","61.47102487499871"
"3067","6060","6051","4","6055","23403","1328.315625","0.017268103125","4729868.690625104","61.48829297812371"
"3068","6055","6054","5","6059","23408","1329.193125","0.017279510624999998","4731197.883750104","61.50557248874871"
"3069","6059","6052","4","6056","23412","1328.535","0.017270955","4732526.4187501045","61.52284344374871"
"3070","6056","6055","7","6062","23419","1329.85125","0.017288066249999998","4733856.270000105","61.540131509998716"
"3071","6062","6058","3","6061","23422","1329.631875","0.017285214375","4735185.901875105","61.55741672437372"
"3072","6061","6057","3","6060","23425","1329.4125","0.0172823625","4736515.314375104","61.574699086873714"
"3073","6060","6059","7","6066","23432","1330.72875","0.01729947375","4737846.043125104","61.591998560623715"
"3074","6066","6064","6","6070","23438","1331.60625","0.01731088125","4739177.649375104","61.60930944187371"
"3075","6070","6065","2","6067","23440","1330.948125","0.017302325624999997","4740508.597500104","61.626611767498716"
"3076","6067","6065","6","6071","23446","1331.8256250000002","0.017313733125","4741840.423125104","61.643925500623716"
"3077","6071","6065","8","6073","23454","1332.2643750000002","0.017319436875","4743172.687500104","61.661244937498715"
"3078","6073","6068","7","6075","23461","1332.703125","0.017325140625","4744505.390625104","61.67857007812371"
"3079","6075","6071","8","6079","23469","1333.5806249999998","0.017336548124999997","4745838.971250105","61.695906626248714"
"3080","6079","6074","6","6080","23475","1333.8","0.017339399999999998","4747172.7712501045","61.71324602624871"
"3081","6080","6073","4","6077","23479","1333.1418749999998","0.017330844374999998","4748505.913125104","61.730576870623715"
"3082","6077","6069","9","6078","23488","1333.3612500000002","0.017333696250000002","4749839.274375104","61.74791056687371"
"3083","6078","6076","8","6084","23496","1334.6775","0.0173508075","4751173.951875105","61.765261374373715"
"3084","6084","6082","7","6089","23503","1335.774375","0.017365066874999998","4752509.726250105","61.782626441248716"
"3085","6089","6086","8","6094","23511","1336.87125","0.017379326249999997","4753846.597500104","61.80000576749872"
"3086","6094","6093","4","6097","23515","1337.5293749999998","0.017387881874999997","4755184.126875104","61.81739364937372"
"3087","6097","6096","5","6101","23520","1338.4068750000001","0.017399289375","4756522.533750105","61.83479293874872"
"3088","6101","6092","4","6096","23524","1337.3100000000002","0.017385030000000003","4757859.843750104","61.85217796874872"
"3089","6096","6087","2","6089","23526","1335.774375","0.017365066874999998","4759195.618125104","61.86954303562372"
"3090","6089","6080","9","6089","23535","1335.774375","0.017365066874999998","4760531.392500104","61.88690810249872"
"3091","6089","6084","2","6086","23537","1335.11625","0.017356511249999998","4761866.508750104","61.90426461374872"
"3092","6086","6079","9","6088","23546","1335.555","0.017362215","4763202.063750104","61.92162682874872"
"3093","6088","6079","3","6082","23549","1334.2387499999998","0.017345103749999997","4764536.302500104","61.938971932498724"
"3094","6082","6073","9","6082","23558","1334.2387499999998","0.017345103749999997","4765870.541250103","61.95631703624873"
"3095","6082","6074","7","6081","23565","1334.019375","0.017342251875","4767204.560625103","61.97365928812373"
"3096","6081","6079","1","6080","23566","1333.8","0.017339399999999998","4768538.360625103","61.990998688123724"
"3097","6080","6079","7","6086","23573","1335.11625","0.017356511249999998","4769873.476875103","62.008355199373725"
"3098","6086","6082","7","6089","23580","1335.774375","0.017365066874999998","4771209.251250103","62.025720266248726"
"3099","6089","6080","2","6082","23582","1334.2387499999998","0.017345103749999997","4772543.490000103","62.04306536999873"
"3100","6082","6078","7","6085","23589","1334.896875","0.017353659374999997","4773878.386875102","62.060419029373726"
"3101","6085","6077","9","6086","23598","1335.11625","0.017356511249999998","4775213.503125102","62.077775540623726"
"3102","6086","6083","5","6088","23603","1335.555","0.017362215","4776549.058125102","62.095137755623725"
"3103","6088","6082","8","6090","23611","1335.99375","0.01736791875","4777885.051875102","62.11250567437372"
"3104","6090","6082","6","6088","23617","1335.555","0.017362215","4779220.606875102","62.12986788937372"
"3105","6088","6079","5","6084","23622","1334.6775","0.0173508075","4780555.284375102","62.14721869687372"
"3106","6084","6077","1","6078","23623","1333.3612500000002","0.017333696250000002","4781888.645625102","62.16455239312372"
"3107","6078","6071","3","6074","23626","1332.4837499999999","0.017322288749999998","4783221.129375102","62.18187468187372"
"3108","6074","6069","3","6072","23629","1332.0449999999998","0.017316584999999995","4784553.174375102","62.199191266873726"
"3109","6072","6064","5","6069","23634","1331.386875","0.017308029375","4785884.561250102","62.21649929624873"
"3110","6069","6066","9","6075","23643","1332.703125","0.017325140625","4787217.264375102","62.233824436873725"
"3111","6075","6069","1","6070","23644","1331.60625","0.01731088125","4788548.870625102","62.25113531812372"
"3112","6070","6063","4","6067","23648","1330.948125","0.017302325624999997","4789879.818750102","62.268437643748726"
"3113","6067","6065","7","6072","23655","1332.0449999999998","0.017316584999999995","4791211.863750102","62.28575422874873"
"3114","6072","6064","5","6069","23660","1331.386875","0.017308029375","4792543.250625102","62.30306225812373"
"3115","6069","6065","8","6073","23668","1332.2643750000002","0.017319436875","4793875.515000102","62.32038169499873"
"3116","6073","6069","6","6075","23674","1332.703125","0.017325140625","4795208.218125102","62.33770683562373"
"3117","6075","6071","5","6076","23679","1332.9225000000001","0.0173279925","4796541.140625102","62.35503482812373"
"3118","6076","6069","4","6073","23683","1332.2643750000002","0.017319436875","4797873.405000103","62.37235426499873"
"3119","6073","6072","6","6078","23689","1333.3612500000002","0.017333696250000002","4799206.766250103","62.389687961248725"
"3120","6078","6077","1","6078","23690","1333.3612500000002","0.017333696250000002","4800540.127500103","62.407021657498724"
"3121","6078","6075","5","6080","23695","1333.8","0.017339399999999998","4801873.927500103","62.42436105749872"
"3122","6080","6071","6","6077","23701","1333.1418749999998","0.017330844374999998","4803207.069375102","62.441691901873725"
"3123","6077","6073","7","6080","23708","1333.8","0.017339399999999998","4804540.869375102","62.45903130187372"
"3124","6080","6077","1","6078","23709","1333.3612500000002","0.017333696250000002","4805874.230625102","62.47636499812372"
"3125","6078","6074","1","6075","23710","1332.703125","0.017325140625","4807206.933750102","62.49369013874872"
"3126","6075","6068","8","6076","23718","1332.9225000000001","0.0173279925","4808539.856250103","62.51101813124872"
"3127","6076","6072","9","6081","23727","1334.019375","0.017342251875","4809873.875625103","62.52836038312372"
"3128","6081","6078","7","6085","23734","1334.896875","0.017353659374999997","4811208.772500102","62.545714042498716"
"3129","6085","6083","5","6088","23739","1335.555","0.017362215","4812544.327500102","62.563076257498714"
"3130","6088","6086","6","6092","23745","1336.4325","0.017373622499999998","4813880.760000102","62.58044987999872"
"3131","6092","6091","2","6093","23747","1336.6518750000002","0.017376474375000003","4815217.411875103","62.597826354373716"
"3132","6093","6092","4","6096","23751","1337.3100000000002","0.017385030000000003","4816554.721875102","62.615211384373715"
"3133","6096","6091","2","6093","23753","1336.6518750000002","0.017376474375000003","4817891.373750103","62.632587858748714"
"3134","6093","6092","5","6097","23758","1337.5293749999998","0.017387881874999997","4819228.903125103","62.64997574062372"
"3135","6097","6095","2","6097","23760","1337.5293749999998","0.017387881874999997","4820566.432500103","62.66736362249872"
"3136","6097","6091","7","6098","23767","1337.7487500000002","0.01739073375","4821904.181250103","62.68475435624872"
"3137","6098","6093","2","6095","23769","1337.090625","0.017382178124999998","4823241.271875103","62.702136534373714"
"3138","6095","6086","2","6088","23771","1335.555","0.017362215","4824576.826875103","62.71949874937371"
"3139","6088","6079","8","6087","23779","1335.335625","0.017359363125","4825912.162500103","62.736858112498716"
"3140","6087","6082","6","6088","23785","1335.555","0.017362215","4827247.717500103","62.754220327498714"
"3141","6088","6085","6","6091","23791","1336.213125","0.017370770625","4828583.9306251025","62.771591098123714"
"3142","6091","6087","8","6095","23799","1337.090625","0.017382178124999998","4829921.021250103","62.78897327624871"
"3143","6095","6086","2","6088","23801","1335.555","0.017362215","4831256.576250102","62.80633549124871"
"3144","6088","6084","3","6087","23804","1335.335625","0.017359363125","4832591.911875103","62.82369485437371"
"3145","6087","6084","5","6089","23809","1335.774375","0.017365066874999998","4833927.686250103","62.841059921248714"
"3146","6089","6083","1","6084","23810","1334.6775","0.0173508075","4835262.363750103","62.858410728748716"
"3147","6084","6075","3","6078","23813","1333.3612500000002","0.017333696250000002","4836595.725000103","62.875744424998715"
"3148","6078","6077","4","6081","23817","1334.019375","0.017342251875","4837929.744375103","62.893086676873715"
"3149","6081","6076","5","6081","23822","1334.019375","0.017342251875","4839263.763750103","62.910428928748715"
"3150","6081","6076","5","6081","23827","1334.019375","0.017342251875","4840597.783125103","62.927771180623715"
"3151","6081","6075","6","6081","23833","1334.019375","0.017342251875","4841931.802500104","62.945113432498715"
"3152","6081","6077","8","6085","23841","1334.896875","0.017353659374999997","4843266.699375103","62.96246709187371"
"3153","6085","6083","8","6091","23849","1336.213125","0.017370770625","4844602.912500103","62.97983786249871"
"3154","6091","6083","4","6087","23853","1335.335625","0.017359363125","4845938.248125103","62.997197225623715"
"3155","6087","6084","6","6090","23859","1335.99375","0.01736791875","4847274.241875104","63.01456514437371"
"3156","6090","6087","1","6088","23860","1335.555","0.017362215","4848609.796875103","63.03192735937371"
"3157","6088","6084","3","6087","23863","1335.335625","0.017359363125","4849945.132500104","63.049286722498714"
"3158","6087","6083","4","6087","23867","1335.335625","0.017359363125","4851280.468125104","63.06664608562372"
"3159","6087","6080","7","6087","23874","1335.335625","0.017359363125","4852615.803750104","63.08400544874872"
"3160","6087","6079","7","6086","23881","1335.11625","0.017356511249999998","4853950.920000104","63.10136195999872"
"3161","6086","6077","6","6083","23887","1334.458125","0.017347955625","4855285.378125104","63.11870991562372"
"3162","6083","6080","8","6088","23895","1335.555","0.017362215","4856620.933125104","63.13607213062372"
"3163","6088","6087","2","6089","23897","1335.774375","0.017365066874999998","4857956.707500104","63.15343719749872"
"3164","6089","6085","6","6091","23903","1336.213125","0.017370770625","4859292.920625104","63.17080796812372"
"3165","6091","6089","7","6096","23910","1337.3100000000002","0.017385030000000003","4860630.230625103","63.18819299812372"
"3166","6096","6090","2","6092","23912","1336.4325","0.017373622499999998","4861966.663125103","63.20556662062372"
"3167","6092","6088","2","6090","23914","1335.99375","0.01736791875","4863302.656875104","63.22293453937372"
"3168","6090","6086","3","6089","23917","1335.774375","0.017365066874999998","4864638.431250104","63.24029960624872"
"3169","6089","6085","1","6086","23918","1335.11625","0.017356511249999998","4865973.547500104","63.25765611749872"
"3170","6086","6082","1","6083","23919","1334.458125","0.017347955625","4867308.005625104","63.27500407312372"
"3171","6083","6074","1","6075","23920","1332.703125","0.017325140625","4868640.708750104","63.292329213748715"
"3172","6075","6067","1","6068","23921","1331.1675000000002","0.0173051775","4869971.876250104","63.309634391248714"
"3173","6068","6065","1","6066","23922","1330.72875","0.01729947375","4871302.605000104","63.326933864998715"
"3174","6066","6059","5","6064","23927","1330.29","0.01729377","4872632.895000104","63.34422763499872"
"3175","6064","6060","1","6061","23928","1329.631875","0.017285214375","4873962.526875104","63.36151284937372"
"3176","6061","6057","6","6063","23934","1330.070625","0.017290918125","4875292.5975001035","63.37880376749872"
"3177","6063","6060","9","6069","23943","1331.386875","0.017308029375","4876623.984375103","63.39611179687372"
"3178","6069","6060","7","6067","23950","1330.948125","0.017302325624999997","4877954.9325001035","63.41341412249872"
"3179","6067","6060","6","6066","23956","1330.72875","0.01729947375","4879285.661250103","63.43071359624872"
"3180","6066","6065","9","6074","23965","1332.4837499999999","0.017322288749999998","4880618.145000103","63.448035884998724"
"3181","6074","6068","8","6076","23973","1332.9225000000001","0.0173279925","4881951.067500103","63.465363877498724"
"3182","6076","6070","2","6072","23975","1332.0449999999998","0.017316584999999995","4883283.112500103","63.48268046249873"
"3183","6072","6066","1","6067","23976","1330.948125","0.017302325624999997","4884614.060625103","63.49998278812373"
"3184","6067","6059","6","6065","23982","1330.509375","0.017296621875","4885944.570000104","63.51727940999873"
"3185","6065","6057","7","6064","23989","1330.29","0.01729377","4887274.860000104","63.53457317999873"
"3186","6064","6060","7","6067","23996","1330.948125","0.017302325624999997","4888605.808125104","63.551875505623734"
"3187","6067","6062","9","6071","24005","1331.8256250000002","0.017313733125","4889937.633750103","63.569189238748734"
"3188","6071","6066","1","6067","24006","1330.948125","0.017302325624999997","4891268.5818751035","63.58649156437374"
"3189","6067","6060","2","6062","24008","1329.85125","0.017288066249999998","4892598.433125104","63.60377963062374"
"3190","6062","6057","3","6060","24011","1329.4125","0.0172823625","4893927.845625103","63.62106199312374"
"3191","6060","6055","6","6061","24017","1329.631875","0.017285214375","4895257.477500103","63.63834720749874"
"3192","6061","6059","6","6065","24023","1330.509375","0.017296621875","4896587.986875104","63.65564382937374"
"3193","6065","6061","9","6070","24032","1331.60625","0.01731088125","4897919.593125104","63.672954710623735"
"3194","6070","6065","7","6072","24039","1332.0449999999998","0.017316584999999995","4899251.638125104","63.69027129562374"
"3195","6072","6071","1","6072","24040","1332.0449999999998","0.017316584999999995","4900583.683125104","63.70758788062374"
"3196","6072","6066","5","6071","24045","1331.8256250000002","0.017313733125","4901915.508750103","63.72490161374874"
"3197","6071","6063","7","6070","24052","1331.60625","0.01731088125","4903247.115000104","63.74221249499874"
"3198","6070","6066","9","6075","24061","1332.703125","0.017325140625","4904579.818125104","63.75953763562374"
"3199","6075","6072","4","6076","24065","1332.9225000000001","0.0173279925","4905912.740625104","63.77686562812374"
"3200","6076","6070","2","6072","24067","1332.0449999999998","0.017316584999999995","4907244.785625104","63.79418221312374"
"3201","6072","6071","2","6073","24069","1332.2643750000002","0.017319436875","4908577.050000104","63.81150164999874"
"3202","6073","6066","7","6073","24076","1332.2643750000002","0.017319436875","4909909.314375104","63.82882108687374"
"3203","6073","6064","3","6067","24079","1330.948125","0.017302325624999997","4911240.2625001045","63.84612341249874"
"3204","6067","6065","6","6071","24085","1331.8256250000002","0.017313733125","4912572.088125104","63.86343714562374"
"3205","6071","6067","6","6073","24091","1332.2643750000002","0.017319436875","4913904.352500104","63.88075658249874"
"3206","6073","6067","8","6075","24099","1332.703125","0.017325140625","4915237.055625104","63.89808172312374"
"3207","6075","6068","6","6074","24105","1332.4837499999999","0.017322288749999998","4916569.539375104","63.91540401187374"
"3208","6074","6065","8","6073","24113","1332.2643750000002","0.017319436875","4917901.803750104","63.93272344874874"
"3209","6073","6067","4","6071","24117","1331.8256250000002","0.017313733125","4919233.629375104","63.95003718187374"
"3210","6071","6070","4","6074","24121","1332.4837499999999","0.017322288749999998","4920566.1131251035","63.96735947062374"
"3211","6074","6072","7","6079","24128","1333.5806249999998","0.017336548124999997","4921899.693750104","63.98469601874874"
"3212","6079","6077","5","6082","24133","1334.2387499999998","0.017345103749999997","4923233.9325001035","64.00204112249874"
"3213","6082","6078","2","6080","24135","1333.8","0.017339399999999998","4924567.732500103","64.01938052249874"
"3214","6080","6073","1","6074","24136","1332.4837499999999","0.017322288749999998","4925900.216250103","64.03670281124873"
"3215","6074","6068","6","6074","24142","1332.4837499999999","0.017322288749999998","4927232.700000103","64.05402509999873"
"3216","6074","6071","3","6074","24145","1332.4837499999999","0.017322288749999998","4928565.183750102","64.07134738874872"
"3217","6074","6066","5","6071","24150","1331.8256250000002","0.017313733125","4929897.009375102","64.08866112187371"
"3218","6071","6070","1","6071","24151","1331.8256250000002","0.017313733125","4931228.8350001015","64.1059748549987"
"3219","6071","6067","4","6071","24155","1331.8256250000002","0.017313733125","4932560.660625101","64.1232885881237"
"3220","6071","6063","7","6070","24162","1331.60625","0.01731088125","4933892.266875101","64.1405994693737"
"3221","6070","6069","3","6072","24165","1332.0449999999998","0.017316584999999995","4935224.311875101","64.1579160543737"
"3222","6072","6064","5","6069","24170","1331.386875","0.017308029375","4936555.698750101","64.1752240837487"
"3223","6069","6068","4","6072","24174","1332.0449999999998","0.017316584999999995","4937887.743750101","64.1925406687487"
"3224","6072","6069","1","6070","24175","1331.60625","0.01731088125","4939219.350000101","64.2098515499987"
"3225","6070","6069","9","6078","24184","1333.3612500000002","0.017333696250000002","4940552.711250101","64.22718524624871"
"3226","6078","6074","1","6075","24185","1332.703125","0.017325140625","4941885.414375101","64.24451038687371"
"3227","6075","6069","5","6074","24190","1332.4837499999999","0.017322288749999998","4943217.898125101","64.26183267562371"
"3228","6074","6072","7","6079","24197","1333.5806249999998","0.017336548124999997","4944551.478750101","64.27916922374871"
"3229","6079","6074","4","6078","24201","1333.3612500000002","0.017333696250000002","4945884.840000101","64.29650291999872"
"3230","6078","6071","3","6074","24204","1332.4837499999999","0.017322288749999998","4947217.323750101","64.31382520874871"
"3231","6074","6071","9","6080","24213","1333.8","0.017339399999999998","4948551.123750101","64.33116460874871"
"3232","6080","6079","8","6087","24221","1335.335625","0.017359363125","4949886.459375101","64.3485239718737"
"3233","6087","6086","5","6091","24226","1336.213125","0.017370770625","4951222.672500101","64.36589474249871"
"3234","6091","6085","2","6087","24228","1335.335625","0.017359363125","4952558.008125101","64.3832541056237"
"3235","6087","6084","3","6087","24231","1335.335625","0.017359363125","4953893.3437501015","64.4006134687487"
"3236","6087","6086","2","6088","24233","1335.555","0.017362215","4955228.898750101","64.41797568374871"
"3237","6088","6082","7","6089","24240","1335.774375","0.017365066874999998","4956564.673125101","64.43534075062371"
"3238","6089","6088","8","6096","24248","1337.3100000000002","0.017385030000000003","4957901.983125101","64.45272578062371"
"3239","6096","6092","3","6095","24251","1337.090625","0.017382178124999998","4959239.073750101","64.47010795874871"
"3240","6095","6093","3","6096","24254","1337.3100000000002","0.017385030000000003","4960576.383750101","64.48749298874871"
"3241","6096","6088","8","6096","24262","1337.3100000000002","0.017385030000000003","4961913.6937501","64.50487801874871"
"3242","6096","6092","8","6100","24270","1338.1875","0.0173964375","4963251.8812501","64.52227445624871"
"3243","6100","6099","3","6102","24273","1338.6262499999998","0.017402141249999996","4964590.5075001","64.53967659749871"
"3244","6102","6098","2","6100","24275","1338.1875","0.0173964375","4965928.6950001","64.55707303499871"
"3245","6100","6099","1","6100","24276","1338.1875","0.0173964375","4967266.8825001","64.5744694724987"
"3246","6100","6094","3","6097","24279","1337.5293749999998","0.017387881874999997","4968604.4118751","64.5918573543737"
"3247","6097","6092","3","6095","24282","1337.090625","0.017382178124999998","4969941.5025001","64.6092395324987"
"3248","6095","6087","7","6094","24289","1336.87125","0.017379326249999997","4971278.3737501","64.6266188587487"
"3249","6094","6089","9","6098","24298","1337.7487500000002","0.01739073375","4972616.1225001","64.6440095924987"
"3250","6098","6095","7","6102","24305","1338.6262499999998","0.017402141249999996","4973954.7487501","64.66141173374871"
"3251","6102","6100","5","6105","24310","1339.284375","0.017410696875","4975294.0331251","64.67882243062371"
"3252","6105","6101","4","6105","24314","1339.284375","0.017410696875","4976633.3175001","64.69623312749872"
"3253","6105","6104","8","6112","24322","1340.82","0.017430659999999997","4977974.1375001","64.71366378749872"
"3254","6112","6106","8","6114","24330","1341.25875","0.01743636375","4979315.3962501","64.73110015124871"
"3255","6114","6111","6","6117","24336","1341.916875","0.017444919374999996","4980657.3131251","64.7485450706237"
"3256","6117","6111","4","6115","24340","1341.478125","0.017439215625","4981998.7912501","64.76598428624871"
"3257","6115","6110","6","6116","24346","1341.6975","0.0174420675","4983340.4887501","64.78342635374871"
"3258","6116","6115","5","6120","24351","1342.575","0.017453475","4984683.0637501","64.8008798287487"
"3259","6120","6113","1","6114","24352","1341.25875","0.01743636375","4986024.3225001","64.8183161924987"
"3260","6114","6105","8","6113","24360","1341.039375","0.017433511875","4987365.3618751","64.8357497043737"
"3261","6113","6106","8","6114","24368","1341.25875","0.01743636375","4988706.6206251","64.85318606812369"
"3262","6114","6110","8","6118","24376","1342.1362500000002","0.01744777125","4990048.756875101","64.8706338393737"
"3263","6118","6114","8","6122","24384","1343.0137499999998","0.01745917875","4991391.7706251005","64.8880930181237"
"3264","6122","6119","7","6126","24391","1343.8912500000001","0.01747058625","4992735.661875101","64.9055636043737"
"3265","6126","6125","2","6127","24393","1344.1106249999998","0.017473438124999997","4994079.772500101","64.92303704249869"
"3266","6127","6121","3","6124","24396","1343.4524999999999","0.017464882499999997","4995423.2250001","64.94050192499869"
"3267","6124","6123","7","6130","24403","1344.76875","0.017481993749999997","4996767.9937501","64.95798391874868"
"3268","6130","6126","1","6127","24404","1344.1106249999998","0.017473438124999997","4998112.1043751","64.97545735687368"
"3269","6127","6121","3","6124","24407","1343.4524999999999","0.017464882499999997","4999455.556875099","64.99292223937367"
"3270","6124","6117","2","6119","24409","1342.355625","0.017450623125","5000797.912500099","65.01037286249867"
"3271","6119","6118","5","6123","24414","1343.2331250000002","0.017462030625000003","5002141.1456251","65.02783489312367"
"3272","6123","6118","6","6124","24420","1343.4524999999999","0.017464882499999997","5003484.598125099","65.04529977562366"
"3273","6124","6116","9","6125","24429","1343.671875","0.017467734375","5004828.270000099","65.06276750999866"
"3274","6125","6118","8","6126","24437","1343.8912500000001","0.01747058625","5006172.1612501","65.08023809624866"
"3275","6126","6121","1","6122","24438","1343.0137499999998","0.01745917875","5007515.175000099","65.09769727499867"
"3276","6122","6116","6","6122","24444","1343.0137499999998","0.01745917875","5008858.188750099","65.11515645374867"
"3277","6122","6115","4","6119","24448","1342.355625","0.017450623125","5010200.544375099","65.13260707687367"
"3278","6119","6118","7","6125","24455","1343.671875","0.017467734375","5011544.216250099","65.15007481124867"
"3279","6125","6117","4","6121","24459","1342.7943750000002","0.017456326875","5012887.010625099","65.16753113812368"
"3280","6121","6119","9","6128","24468","1344.3300000000002","0.017476290000000002","5014231.340625099","65.18500742812368"
"3281","6128","6124","8","6132","24476","1345.2074999999998","0.017487697499999996","5015576.548125098","65.20249512562368"
"3282","6132","6130","6","6136","24482","1346.085","0.017499105","5016922.633125098","65.21999423062368"
"3283","6136","6135","6","6141","24488","1347.181875","0.017513364375","5018269.815000098","65.23750759499869"
"3284","6141","6132","8","6140","24496","1346.9625","0.0175105125","5019616.777500099","65.25501810749869"
"3285","6140","6137","8","6145","24504","1348.059375","0.017524771875","5020964.836875099","65.27254287937369"
"3286","6145","6142","6","6148","24510","1348.7175000000002","0.0175333275","5022313.554375099","65.29007620687369"
"3287","6148","6144","5","6149","24515","1348.9368749999999","0.017536179375","5023662.491250099","65.30761238624869"
"3288","6149","6148","3","6151","24518","1349.3756250000001","0.017541883125","5025011.866875099","65.3251542693737"
"3289","6151","6145","3","6148","24521","1348.7175000000002","0.0175333275","5026360.584375099","65.3426875968737"
"3290","6148","6145","7","6152","24528","1349.5949999999998","0.017544734999999995","5027710.179375099","65.3602323318737"
"3291","6152","6144","5","6149","24533","1348.9368749999999","0.017536179375","5029059.116250099","65.3777685112487"
"3292","6149","6140","2","6142","24535","1347.40125","0.017516216249999998","5030406.517500099","65.3952847274987"
"3293","6142","6136","8","6144","24543","1347.84","0.017521919999999996","5031754.357500099","65.4128066474987"
"3294","6144","6142","1","6143","24544","1347.6206250000002","0.017519068125000002","5033101.978125099","65.4303257156237"
"3295","6143","6140","5","6145","24549","1348.059375","0.017524771875","5034450.037500099","65.4478504874987"
"3296","6145","6141","3","6144","24552","1347.84","0.017521919999999996","5035797.877500099","65.46537240749869"
"3297","6144","6139","3","6142","24555","1347.40125","0.017516216249999998","5037145.278750099","65.48288862374869"
"3298","6142","6137","4","6141","24559","1347.181875","0.017513364375","5038492.460625099","65.5004019881237"
"3299","6141","6135","1","6136","24560","1346.085","0.017499105","5039838.545625099","65.5179010931237"
"3300","6136","6130","7","6137","24567","1346.304375","0.017501956875","5041184.850000099","65.53540304999869"
"3301","6137","6135","6","6141","24573","1347.181875","0.017513364375","5042532.031875099","65.5529164143737"
"3302","6141","6137","3","6140","24576","1346.9625","0.0175105125","5043878.994375099","65.5704269268737"
"3303","6140","6137","4","6141","24580","1347.181875","0.017513364375","5045226.176250099","65.5879402912487"
"3304","6141","6134","1","6135","24581","1345.865625","0.017496253124999996","5046572.041875099","65.6054365443737"
"3305","6135","6127","9","6136","24590","1346.085","0.017499105","5047918.126875099","65.6229356493737"
"3306","6136","6131","9","6140","24599","1346.9625","0.0175105125","5049265.089375099","65.6404461618737"
"3307","6140","6138","2","6140","24601","1346.9625","0.0175105125","5050612.0518751","65.6579566743737"
"3308","6140","6136","3","6139","24604","1346.743125","0.017507660624999997","5051958.7950001","65.6754643349987"
"3309","6139","6136","7","6143","24611","1347.6206250000002","0.017519068125000002","5053306.4156251","65.69298340312369"
"3310","6143","6136","1","6137","24612","1346.304375","0.017501956875","5054652.7200001","65.71048535999869"
"3311","6137","6128","5","6133","24617","1345.426875","0.017490549375","5055998.1468751","65.72797590937368"
"3312","6133","6129","7","6136","24624","1346.085","0.017499105","5057344.2318751","65.74547501437368"
"3313","6136","6129","4","6133","24628","1345.426875","0.017490549375","5058689.6587501","65.76296556374868"
"3314","6133","6128","4","6132","24632","1345.2074999999998","0.017487697499999996","5060034.8662501","65.78045326124868"
"3315","6132","6128","4","6132","24636","1345.2074999999998","0.017487697499999996","5061380.073750099","65.79794095874868"
"3316","6132","6130","7","6137","24643","1346.304375","0.017501956875","5062726.378125099","65.81544291562368"
"3317","6137","6131","5","6136","24648","1346.085","0.017499105","5064072.463125099","65.83294202062368"
"3318","6136","6128","6","6134","24654","1345.64625","0.01749340125","5065418.1093751","65.85043542187367"
"3319","6134","6129","8","6137","24662","1346.304375","0.017501956875","5066764.4137501","65.86793737874866"
"3320","6137","6129","7","6136","24669","1346.085","0.017499105","5068110.4987501","65.88543648374866"
"3321","6136","6132","2","6134","24671","1345.64625","0.01749340125","5069456.1450001","65.90292988499866"
"3322","6134","6129","8","6137","24679","1346.304375","0.017501956875","5070802.4493751","65.92043184187365"
"3323","6137","6128","1","6129","24680","1344.5493749999998","0.017479141874999996","5072146.998750101","65.93791098374865"
"3324","6129","6128","6","6134","24686","1345.64625","0.01749340125","5073492.645000101","65.95540438499864"
"3325","6134","6129","7","6136","24693","1346.085","0.017499105","5074838.730000101","65.97290348999864"
"3326","6136","6132","9","6141","24702","1347.181875","0.017513364375","5076185.911875101","65.99041685437365"
"3327","6141","6138","6","6144","24708","1347.84","0.017521919999999996","5077533.751875101","66.00793877437364"
"3328","6144","6143","4","6147","24712","1348.4981249999998","0.017530475624999996","5078882.250000101","66.02546924999864"
"3329","6147","6138","5","6143","24717","1347.6206250000002","0.017519068125000002","5080229.870625101","66.04298831812363"
"3330","6143","6142","2","6144","24719","1347.84","0.017521919999999996","5081577.710625101","66.06051023812363"
"3331","6144","6143","2","6145","24721","1348.059375","0.017524771875","5082925.770000101","66.07803500999863"
"3332","6145","6136","7","6143","24728","1347.6206250000002","0.017519068125000002","5084273.3906251015","66.09555407812363"
"3333","6143","6142","9","6151","24737","1349.3756250000001","0.017541883125","5085622.766250102","66.11309596124863"
"3334","6151","6148","5","6153","24742","1349.8143750000002","0.017547586875","5086972.580625102","66.13064354812363"
"3335","6153","6151","7","6158","24749","1350.91125","0.01756184625","5088323.491875102","66.14820539437363"
"3336","6158","6151","7","6158","24756","1350.91125","0.01756184625","5089674.403125102","66.16576724062364"
"3337","6158","6157","3","6160","24759","1351.35","0.017567549999999998","5091025.753125101","66.18333479062363"
"3338","6160","6155","3","6158","24762","1350.91125","0.01756184625","5092376.664375101","66.20089663687364"
"3339","6158","6153","2","6155","24764","1350.253125","0.017553290625","5093726.917500101","66.21844992749864"
"3340","6155","6146","1","6147","24765","1348.4981249999998","0.017530475624999996","5095075.415625101","66.23598040312363"
"3341","6147","6145","3","6148","24768","1348.7175000000002","0.0175333275","5096424.133125101","66.25351373062364"
"3342","6148","6145","2","6147","24770","1348.4981249999998","0.017530475624999996","5097772.631250101","66.27104420624863"
"3343","6147","6142","1","6143","24771","1347.6206250000002","0.017519068125000002","5099120.251875102","66.28856327437363"
"3344","6143","6137","3","6140","24774","1346.9625","0.0175105125","5100467.214375102","66.30607378687363"
"3345","6140","6138","1","6139","24775","1346.743125","0.017507660624999997","5101813.957500102","66.32358144749863"
"3346","6139","6136","5","6141","24780","1347.181875","0.017513364375","5103161.139375102","66.34109481187363"
"3347","6141","6139","6","6145","24786","1348.059375","0.017524771875","5104509.198750102","66.35861958374863"
"3348","6145","6141","1","6142","24787","1347.40125","0.017516216249999998","5105856.600000102","66.37613579999864"
"3349","6142","6136","4","6140","24791","1346.9625","0.0175105125","5107203.562500102","66.39364631249863"
"3350","6140","6134","9","6143","24800","1347.6206250000002","0.017519068125000002","5108551.183125103","66.41116538062363"
"3351","6143","6139","4","6143","24804","1347.6206250000002","0.017519068125000002","5109898.803750103","66.42868444874863"
"3352","6143","6140","8","6148","24812","1348.7175000000002","0.0175333275","5111247.521250104","66.44621777624863"
"3353","6148","6143","5","6148","24817","1348.7175000000002","0.0175333275","5112596.238750104","66.46375110374863"
"3354","6148","6139","6","6145","24823","1348.059375","0.017524771875","5113944.298125104","66.48127587562364"
"3355","6145","6139","7","6146","24830","1348.2787500000002","0.017527623750000002","5115292.576875104","66.49880349937364"
"3356","6146","6142","8","6150","24838","1349.15625","0.01753903125","5116641.733125104","66.51634253062363"
"3357","6150","6148","9","6157","24847","1350.6918749999998","0.017558994374999994","5117992.425000103","66.53390152499863"
"3358","6157","6153","7","6160","24854","1351.35","0.017567549999999998","5119343.775000103","66.55146907499862"
"3359","6160","6158","8","6166","24862","1352.66625","0.017584661249999998","5120696.441250103","66.56905373624862"
"3360","6166","6159","9","6168","24871","1353.1050000000002","0.017590365000000004","5122049.546250103","66.58664410124862"
"3361","6168","6167","8","6175","24879","1354.640625","0.017610328124999998","5123404.186875103","66.60425442937363"
"3362","6175","6166","4","6170","24883","1353.54375","0.01759606875","5124757.730625103","66.62185049812362"
"3363","6170","6163","5","6168","24888","1353.1050000000002","0.017590365000000004","5126110.835625104","66.63944086312362"
"3364","6168","6159","6","6165","24894","1352.446875","0.017581809375","5127463.282500104","66.65702267249863"
"3365","6165","6160","2","6162","24896","1351.78875","0.017573253749999997","5128815.071250104","66.67459592624863"
"3366","6162","6157","5","6162","24901","1351.78875","0.017573253749999997","5130166.860000105","66.69216917999863"
"3367","6162","6156","7","6163","24908","1352.008125","0.017576105625","5131518.868125104","66.70974528562363"
"3368","6163","6155","1","6156","24909","1350.4725","0.0175561425","5132869.3406251045","66.72730142812362"
"3369","6156","6151","9","6160","24918","1351.35","0.017567549999999998","5134220.690625104","66.74486897812362"
"3370","6160","6152","3","6155","24921","1350.253125","0.017553290625","5135570.943750104","66.76242226874862"
"3371","6155","6154","8","6162","24929","1351.78875","0.017573253749999997","5136922.732500104","66.77999552249862"
"3372","6162","6160","3","6163","24932","1352.008125","0.017576105625","5138274.740625104","66.79757162812362"
"3373","6163","6162","7","6169","24939","1353.324375","0.017593216874999998","5139628.065000104","66.81516484499862"
"3374","6169","6161","6","6167","24945","1352.885625","0.017587513125","5140980.950625104","66.83275235812361"
"3375","6167","6165","2","6167","24947","1352.885625","0.017587513125","5142333.836250104","66.85033987124861"
"3376","6167","6158","4","6162","24951","1351.78875","0.017573253749999997","5143685.625000104","66.86791312499861"
"3377","6162","6161","1","6162","24952","1351.78875","0.017573253749999997","5145037.413750105","66.88548637874861"
"3378","6162","6154","7","6161","24959","1351.569375","0.017570401875","5146388.983125105","66.90305678062361"
"3379","6161","6152","4","6156","24963","1350.4725","0.0175561425","5147739.455625105","66.92061292312361"
"3380","6156","6155","1","6156","24964","1350.4725","0.0175561425","5149089.928125105","66.93816906562361"
"3381","6156","6154","8","6162","24972","1351.78875","0.017573253749999997","5150441.716875105","66.95574231937361"
"3382","6162","6160","4","6164","24976","1352.2275","0.0175789575","5151793.944375105","66.97332127687362"
"3383","6164","6159","3","6162","24979","1351.78875","0.017573253749999997","5153145.7331251055","66.99089453062362"
"3384","6162","6157","3","6160","24982","1351.35","0.017567549999999998","5154497.083125105","67.00846208062362"
"3385","6160","6154","2","6156","24984","1350.4725","0.0175561425","5155847.555625105","67.02601822312361"
"3386","6156","6150","7","6157","24991","1350.6918749999998","0.017558994374999994","5157198.247500105","67.04357721749861"
"3387","6157","6149","4","6153","24995","1349.8143750000002","0.017547586875","5158548.061875105","67.0611248043736"
"3388","6153","6146","8","6154","25003","1350.0337499999998","0.017550438749999998","5159898.095625105","67.07867524312361"
"3389","6154","6150","1","6151","25004","1349.3756250000001","0.017541883125","5161247.471250106","67.09621712624862"
"3390","6151","6150","2","6152","25006","1349.5949999999998","0.017544734999999995","5162597.066250105","67.11376186124862"
"3391","6152","6146","8","6154","25014","1350.0337499999998","0.017550438749999998","5163947.100000106","67.13131229999863"
"3392","6154","6149","3","6152","25017","1349.5949999999998","0.017544734999999995","5165296.695000106","67.14885703499863"
"3393","6152","6147","4","6151","25021","1349.3756250000001","0.017541883125","5166646.070625106","67.16639891812363"
"3394","6151","6146","9","6155","25030","1350.253125","0.017553290625","5167996.323750106","67.18395220874864"
"3395","6155","6154","4","6158","25034","1350.91125","0.01756184625","5169347.235000106","67.20151405499864"
"3396","6158","6149","2","6151","25036","1349.3756250000001","0.017541883125","5170696.610625106","67.21905593812365"
"3397","6151","6150","1","6151","25037","1349.3756250000001","0.017541883125","5172045.986250106","67.23659782124865"
"3398","6151","6146","7","6153","25044","1349.8143750000002","0.017547586875","5173395.800625106","67.25414540812365"
"3399","6153","6144","5","6149","25049","1348.9368749999999","0.017536179375","5174744.737500106","67.27168158749865"
"3400","6149","6142","7","6149","25056","1348.9368749999999","0.017536179375","5176093.674375106","67.28921776687365"
"3401","6149","6147","4","6151","25060","1349.3756250000001","0.017541883125","5177443.050000106","67.30675964999865"
"3402","6151","6146","4","6150","25064","1349.15625","0.01753903125","5178792.206250106","67.32429868124865"
"3403","6150","6146","7","6153","25071","1349.8143750000002","0.017547586875","5180142.020625106","67.34184626812365"
"3404","6153","6152","9","6161","25080","1351.569375","0.017570401875","5181493.590000106","67.35941666999865"
"3405","6161","6160","9","6169","25089","1353.324375","0.017593216874999998","5182846.914375106","67.37700988687365"
"3406","6169","6160","8","6168","25097","1353.1050000000002","0.017590365000000004","5184200.019375106","67.39460025187365"
"3407","6168","6166","4","6170","25101","1353.54375","0.01759606875","5185553.5631251065","67.41219632062365"
"3408","6170","6166","9","6175","25110","1354.640625","0.017610328124999998","5186908.2037501065","67.42980664874865"
"3409","6175","6172","1","6173","25111","1354.2018750000002","0.017604624375000003","5188262.405625107","67.44741127312365"
"3410","6173","6165","3","6168","25114","1353.1050000000002","0.017590365000000004","5189615.510625107","67.46500163812365"
"3411","6168","6159","9","6168","25123","1353.1050000000002","0.017590365000000004","5190968.615625108","67.48259200312366"
"3412","6168","6166","8","6174","25131","1354.4212499999999","0.017607476249999997","5192323.036875107","67.50019947937366"
"3413","6174","6171","3","6174","25134","1354.4212499999999","0.017607476249999997","5193677.458125107","67.51780695562367"
"3414","6174","6173","7","6180","25141","1355.7375","0.017624587499999997","5195033.195625107","67.53543154312366"
"3415","6180","6173","9","6182","25150","1356.1762499999998","0.017630291249999996","5196389.371875106","67.55306183437366"
"3416","6182","6173","5","6178","25155","1355.2987500000002","0.01761888375","5197744.670625106","67.57068071812367"
"3417","6178","6177","2","6179","25157","1355.5181249999998","0.017621735624999996","5199100.188750107","67.58830245374867"
"3418","6179","6176","2","6178","25159","1355.2987500000002","0.01761888375","5200455.487500107","67.60592133749867"
"3419","6178","6176","7","6183","25166","1356.395625","0.017633143125","5201811.883125107","67.62355448062367"
"3420","6183","6182","4","6186","25170","1357.05375","0.01764169875","5203168.936875107","67.64119617937367"
"3421","6186","6177","4","6181","25174","1355.956875","0.017627439375","5204524.893750107","67.65882361874867"
"3422","6181","6176","7","6183","25181","1356.395625","0.017633143125","5205881.289375107","67.67645676187367"
"3423","6183","6182","7","6189","25188","1357.711875","0.017650254374999997","5207239.001250107","67.69410701624867"
"3424","6189","6186","6","6192","25194","1358.37","0.017658809999999997","5208597.371250107","67.71176582624867"
"3425","6192","6189","5","6194","25199","1358.80875","0.01766451375","5209956.180000107","67.72943033999867"
"3426","6194","6187","9","6196","25208","1359.2475000000002","0.0176702175","5211315.427500106","67.74710055749867"
"3427","6196","6192","2","6194","25210","1358.80875","0.01766451375","5212674.236250106","67.76476507124868"
"3428","6194","6193","9","6202","25219","1360.5637499999998","0.017687328749999995","5214034.800000106","67.78245239999868"
"3429","6202","6199","6","6205","25225","1361.221875","0.017695884375","5215396.021875106","67.80014828437368"
"3430","6205","6204","5","6209","25230","1362.099375","0.017707291875","5216758.121250106","67.81785557624868"
"3431","6209","6204","4","6208","25234","1361.88","0.017704440000000002","5218120.001250106","67.83556001624868"
"3432","6208","6204","1","6205","25235","1361.221875","0.017695884375","5219481.223125106","67.85325590062368"
"3433","6205","6200","9","6209","25244","1362.099375","0.017707291875","5220843.322500106","67.87096319249868"
"3434","6209","6203","9","6212","25253","1362.7575","0.0177158475","5222206.080000106","67.88867903999868"
"3435","6212","6209","3","6212","25256","1362.7575","0.0177158475","5223568.837500107","67.90639488749868"
"3436","6212","6204","3","6207","25259","1361.6606249999998","0.017701588124999997","5224930.498125106","67.92409647562367"
"3437","6207","6200","4","6204","25263","1361.0024999999998","0.017693032499999997","5226291.5006251065","67.94178950812368"
"3438","6204","6195","2","6197","25265","1359.4668749999998","0.017673069374999996","5227650.967500106","67.95946257749867"
"3439","6197","6192","5","6197","25270","1359.4668749999998","0.017673069374999996","5229010.434375106","67.97713564687366"
"3440","6197","6196","4","6200","25274","1360.125","0.017681625","5230370.559375106","67.99481727187366"
"3441","6200","6195","6","6201","25280","1360.3443750000001","0.017684476875","5231730.903750107","68.01250174874866"
"3442","6201","6192","5","6197","25285","1359.4668749999998","0.017673069374999996","5233090.370625107","68.03017481812365"
"3443","6197","6190","7","6197","25292","1359.4668749999998","0.017673069374999996","5234449.837500107","68.04784788749865"
"3444","6197","6196","5","6201","25297","1360.3443750000001","0.017684476875","5235810.181875107","68.06553236437365"
"3445","6201","6200","1","6201","25298","1360.3443750000001","0.017684476875","5237170.526250107","68.08321684124866"
"3446","6201","6193","2","6195","25300","1359.028125","0.017667365625","5238529.554375107","68.10088420687366"
"3447","6195","6193","9","6202","25309","1360.5637499999998","0.017687328749999995","5239890.118125107","68.11857153562366"
"3448","6202","6201","3","6204","25312","1361.0024999999998","0.017693032499999997","5241251.120625108","68.13626456812366"
"3449","6204","6202","9","6211","25321","1362.538125","0.017712995625","5242613.6587501075","68.15397756374867"
"3450","6211","6205","3","6208","25324","1361.88","0.017704440000000002","5243975.538750107","68.17168200374867"
"3451","6208","6206","3","6209","25327","1362.099375","0.017707291875","5245337.638125108","68.18938929562367"
"3452","6209","6205","4","6209","25331","1362.099375","0.017707291875","5246699.737500108","68.20709658749867"
"3453","6209","6206","8","6214","25339","1363.19625","0.01772155125","5248062.933750108","68.22481813874867"
"3454","6214","6211","7","6218","25346","1364.0737500000002","0.017732958750000003","5249427.007500108","68.24255109749868"
"3455","6218","6212","9","6221","25355","1364.7318750000002","0.017741514375","5250791.739375108","68.26029261187368"
"3456","6221","6215","2","6217","25357","1363.854375","0.017730106875","5252155.593750108","68.27802271874869"
"3457","6217","6213","1","6214","25358","1363.19625","0.01772155125","5253518.790000108","68.29574426999869"
"3458","6214","6212","3","6215","25361","1363.415625","0.017724403125","5254882.205625108","68.3134686731237"
"3459","6215","6212","7","6219","25368","1364.293125","0.017735810624999997","5256246.498750108","68.33120448374869"
"3460","6219","6211","3","6214","25371","1363.19625","0.01772155125","5257609.695000108","68.3489260349987"
"3461","6214","6212","1","6213","25372","1362.976875","0.017718699375","5258972.671875108","68.3666447343737"
"3462","6213","6204","1","6205","25373","1361.221875","0.017695884375","5260333.893750108","68.3843406187487"
"3463","6205","6202","2","6204","25375","1361.0024999999998","0.017693032499999997","5261694.896250108","68.4020336512487"
"3464","6204","6203","7","6210","25382","1362.31875","0.017710143749999997","5263057.215000108","68.4197437949987"
"3465","6210","6204","6","6210","25388","1362.31875","0.017710143749999997","5264419.5337501075","68.43745393874869"
"3466","6210","6205","8","6213","25396","1362.976875","0.017718699375","5265782.510625107","68.45517263812368"
"3467","6213","6207","4","6211","25400","1362.538125","0.017712995625","5267145.048750107","68.47288563374869"
"3468","6211","6208","8","6216","25408","1363.635","0.017727254999999997","5268508.683750107","68.49061288874869"
"3469","6216","6208","7","6215","25415","1363.415625","0.017724403125","5269872.099375107","68.50833729187369"
"3470","6215","6206","4","6210","25419","1362.31875","0.017710143749999997","5271234.418125107","68.52604743562368"
"3471","6210","6202","5","6207","25424","1361.6606249999998","0.017701588124999997","5272596.0787501065","68.54374902374867"
"3472","6207","6198","6","6204","25430","1361.0024999999998","0.017693032499999997","5273957.081250107","68.56144205624868"
"3473","6204","6203","3","6206","25433","1361.44125","0.01769873625","5275318.522500107","68.57914079249868"
"3474","6206","6202","4","6206","25437","1361.44125","0.01769873625","5276679.963750107","68.59683952874867"
"3475","6206","6205","8","6213","25445","1362.976875","0.017718699375","5278042.940625107","68.61455822812367"
"3476","6213","6205","5","6210","25450","1362.31875","0.017710143749999997","5279405.259375107","68.63226837187366"
"3477","6210","6202","4","6206","25454","1361.44125","0.01769873625","5280766.700625107","68.64996710812366"
"3478","6206","6198","4","6202","25458","1360.5637499999998","0.017687328749999995","5282127.264375106","68.66765443687366"
"3479","6202","6199","7","6206","25465","1361.44125","0.01769873625","5283488.705625107","68.68535317312366"
"3480","6206","6201","4","6205","25469","1361.221875","0.017695884375","5284849.927500106","68.70304905749866"
"3481","6205","6201","8","6209","25477","1362.099375","0.017707291875","5286212.026875107","68.72075634937366"
"3482","6209","6201","4","6205","25481","1361.221875","0.017695884375","5287573.248750106","68.73845223374866"
"3483","6205","6199","2","6201","25483","1360.3443750000001","0.017684476875","5288933.593125107","68.75613671062366"
"3484","6201","6200","7","6207","25490","1361.6606249999998","0.017701588124999997","5290295.253750106","68.77383829874866"
"3485","6207","6198","6","6204","25496","1361.0024999999998","0.017693032499999997","5291656.256250107","68.79153133124866"
"3486","6204","6199","6","6205","25502","1361.221875","0.017695884375","5293017.478125107","68.80922721562366"
"3487","6205","6203","4","6207","25506","1361.6606249999998","0.017701588124999997","5294379.138750106","68.82692880374866"
"3488","6207","6198","6","6204","25512","1361.0024999999998","0.017693032499999997","5295740.1412501065","68.84462183624866"
"3489","6204","6203","6","6209","25518","1362.099375","0.017707291875","5297102.240625107","68.86232912812366"
"3490","6209","6206","1","6207","25519","1361.6606249999998","0.017701588124999997","5298463.901250106","68.88003071624865"
"3491","6207","6201","7","6208","25526","1361.88","0.017704440000000002","5299825.781250106","68.89773515624866"
"3492","6208","6207","8","6215","25534","1363.415625","0.017724403125","5301189.196875107","68.91545955937366"
"3493","6215","6209","4","6213","25538","1362.976875","0.017718699375","5302552.173750106","68.93317825874865"
"3494","6213","6207","4","6211","25542","1362.538125","0.017712995625","5303914.711875106","68.95089125437366"
"3495","6211","6210","4","6214","25546","1363.19625","0.01772155125","5305277.908125106","68.96861280562366"
"3496","6214","6206","5","6211","25551","1362.538125","0.017712995625","5306640.446250106","68.98632580124867"
"3497","6211","6204","4","6208","25555","1361.88","0.017704440000000002","5308002.326250106","69.00403024124867"
"3498","6208","6204","6","6210","25561","1362.31875","0.017710143749999997","5309364.645000106","69.02174038499867"
"3499","6210","6205","1","6206","25562","1361.44125","0.01769873625","5310726.086250106","69.03943912124866"
"3500","6206","6201","7","6208","25569","1361.88","0.017704440000000002","5312087.966250106","69.05714356124867"
"3501","6208","6199","8","6207","25577","1361.6606249999998","0.017701588124999997","5313449.626875105","69.07484514937366"
"3502","6207","6204","7","6211","25584","1362.538125","0.017712995625","5314812.165000105","69.09255814499866"
"3503","6211","6204","8","6212","25592","1362.7575","0.0177158475","5316174.922500106","69.11027399249866"
"3504","6212","6209","2","6211","25594","1362.538125","0.017712995625","5317537.460625106","69.12798698812367"
"3505","6211","6204","4","6208","25598","1361.88","0.017704440000000002","5318899.340625105","69.14569142812367"
"3506","6208","6200","6","6206","25604","1361.44125","0.01769873625","5320260.781875106","69.16339016437367"
"3507","6206","6200","1","6201","25605","1360.3443750000001","0.017684476875","5321621.126250106","69.18107464124867"
"3508","6201","6194","6","6200","25611","1360.125","0.017681625","5322981.251250106","69.19875626624867"
"3509","6200","6191","2","6193","25613","1358.5893750000002","0.017661661875","5324339.840625106","69.21641792812366"
"3510","6193","6185","8","6193","25621","1358.5893750000002","0.017661661875","5325698.430000107","69.23407958999866"
"3511","6193","6186","1","6187","25622","1357.273125","0.017644550624999998","5327055.703125107","69.25172414062365"
"3512","6187","6185","7","6192","25629","1358.37","0.017658809999999997","5328414.073125107","69.26938295062365"
"3513","6192","6184","8","6192","25637","1358.37","0.017658809999999997","5329772.443125107","69.28704176062365"
"3514","6192","6187","7","6194","25644","1358.80875","0.01766451375","5331131.251875107","69.30470627437366"
"3515","6194","6192","1","6193","25645","1358.5893750000002","0.017661661875","5332489.841250108","69.32236793624865"
"3516","6193","6190","9","6199","25654","1359.9056249999999","0.017678773124999998","5333849.746875107","69.34004670937365"
"3517","6199","6195","5","6200","25659","1360.125","0.017681625","5335209.871875107","69.35772833437365"
"3518","6200","6196","9","6205","25668","1361.221875","0.017695884375","5336571.093750107","69.37542421874865"
"3519","6205","6201","7","6208","25675","1361.88","0.017704440000000002","5337932.973750107","69.39312865874865"
"3520","6208","6202","1","6203","25676","1360.7831250000002","0.017690180625","5339293.756875107","69.41081883937365"
"3521","6203","6195","7","6202","25683","1360.5637499999998","0.017687328749999995","5340654.320625107","69.42850616812365"
"3522","6202","6200","3","6203","25686","1360.7831250000002","0.017690180625","5342015.103750107","69.44619634874864"
"3523","6203","6201","6","6207","25692","1361.6606249999998","0.017701588124999997","5343376.764375106","69.46389793687364"
"3524","6207","6202","6","6208","25698","1361.88","0.017704440000000002","5344738.644375106","69.48160237687364"
"3525","6208","6207","6","6213","25704","1362.976875","0.017718699375","5346101.621250106","69.49932107624863"
"3526","6213","6208","1","6209","25705","1362.099375","0.017707291875","5347463.720625106","69.51702836812363"
"3527","6209","6204","5","6209","25710","1362.099375","0.017707291875","5348825.8200001065","69.53473565999863"
"3528","6209","6202","6","6208","25716","1361.88","0.017704440000000002","5350187.700000106","69.55244009999863"
"3529","6208","6200","4","6204","25720","1361.0024999999998","0.017693032499999997","5351548.702500107","69.57013313249864"
"3530","6204","6196","8","6204","25728","1361.0024999999998","0.017693032499999997","5352909.705000107","69.58782616499865"
"3531","6204","6203","6","6209","25734","1362.099375","0.017707291875","5354271.804375107","69.60553345687364"
"3532","6209","6202","9","6211","25743","1362.538125","0.017712995625","5355634.342500107","69.62324645249865"
"3533","6211","6204","9","6213","25752","1362.976875","0.017718699375","5356997.319375107","69.64096515187364"
"3534","6213","6208","9","6217","25761","1363.854375","0.017730106875","5358361.173750107","69.65869525874865"
"3535","6217","6210","9","6219","25770","1364.293125","0.017735810624999997","5359725.466875107","69.67643106937365"
"3536","6219","6217","4","6221","25774","1364.7318750000002","0.017741514375","5361090.198750107","69.69417258374865"
"3537","6221","6217","4","6221","25778","1364.7318750000002","0.017741514375","5362454.930625106","69.71191409812366"
"3538","6221","6215","4","6219","25782","1364.293125","0.017735810624999997","5363819.223750106","69.72964990874866"
"3539","6219","6213","6","6219","25788","1364.293125","0.017735810624999997","5365183.516875106","69.74738571937365"
"3540","6219","6211","9","6220","25797","1364.5125","0.0177386625","5366548.029375106","69.76512438187365"
"3541","6220","6216","5","6221","25802","1364.7318750000002","0.017741514375","5367912.761250106","69.78286589624865"
"3542","6221","6217","3","6220","25805","1364.5125","0.0177386625","5369277.273750106","69.80060455874865"
"3543","6220","6215","5","6220","25810","1364.5125","0.0177386625","5370641.786250106","69.81834322124864"
"3544","6220","6218","9","6227","25819","1366.0481249999998","0.017758625624999996","5372007.834375106","69.83610184687365"
"3545","6227","6219","5","6224","25824","1365.3899999999999","0.017750069999999996","5373373.224375105","69.85385191687365"
"3546","6224","6216","1","6217","25825","1363.854375","0.017730106875","5374737.078750106","69.87158202374866"
"3547","6217","6213","8","6221","25833","1364.7318750000002","0.017741514375","5376101.810625105","69.88932353812366"
"3548","6221","6216","4","6220","25837","1364.5125","0.0177386625","5377466.323125105","69.90706220062366"
"3549","6220","6217","4","6221","25841","1364.7318750000002","0.017741514375","5378831.055000105","69.92480371499866"
"3550","6221","6212","3","6215","25844","1363.415625","0.017724403125","5380194.470625105","69.94252811812366"
"3551","6215","6206","2","6208","25846","1361.88","0.017704440000000002","5381556.350625105","69.96023255812366"
"3552","6208","6203","6","6209","25852","1362.099375","0.017707291875","5382918.450000105","69.97793984999866"
"3553","6209","6205","6","6211","25858","1362.538125","0.017712995625","5384280.988125105","69.99565284562367"
"3554","6211","6210","7","6217","25865","1363.854375","0.017730106875","5385644.8425001055","70.01338295249867"
"3555","6217","6213","3","6216","25868","1363.635","0.017727254999999997","5387008.477500105","70.03111020749867"
"3556","6216","6210","4","6214","25872","1363.19625","0.01772155125","5388371.673750105","70.04883175874868"
"3557","6214","6206","8","6214","25880","1363.19625","0.01772155125","5389734.870000105","70.06655330999868"
"3558","6214","6207","8","6215","25888","1363.415625","0.017724403125","5391098.285625106","70.08427771312368"
"3559","6215","6214","5","6219","25893","1364.293125","0.017735810624999997","5392462.578750106","70.10201352374868"
"3560","6219","6212","2","6214","25895","1363.19625","0.01772155125","5393825.775000106","70.11973507499869"
"3561","6214","6210","8","6218","25903","1364.0737500000002","0.017732958750000003","5395189.848750106","70.13746803374869"
"3562","6218","6214","2","6216","25905","1363.635","0.017727254999999997","5396553.483750106","70.15519528874869"
"3563","6216","6207","9","6216","25914","1363.635","0.017727254999999997","5397917.118750106","70.17292254374868"
"3564","6216","6215","9","6224","25923","1365.3899999999999","0.017750069999999996","5399282.508750105","70.19067261374869"
"3565","6224","6218","4","6222","25927","1364.9512499999998","0.017744366249999997","5400647.460000105","70.20841697999869"
"3566","6222","6215","3","6218","25930","1364.0737500000002","0.017732958750000003","5402011.533750106","70.22614993874869"
"3567","6218","6217","3","6220","25933","1364.5125","0.0177386625","5403376.046250106","70.24388860124868"
"3568","6220","6218","4","6222","25937","1364.9512499999998","0.017744366249999997","5404740.997500106","70.26163296749868"
"3569","6222","6217","4","6221","25941","1364.7318750000002","0.017741514375","5406105.729375105","70.27937448187369"
"3570","6221","6217","8","6225","25949","1365.609375","0.017752921874999997","5407471.338750105","70.29712740374869"
"3571","6225","6221","6","6227","25955","1366.0481249999998","0.017758625624999996","5408837.386875105","70.3148860293737"
"3572","6227","6221","2","6223","25957","1365.1706250000002","0.017747218125000002","5410202.557500105","70.33263324749869"
"3573","6223","6221","9","6230","25966","1366.70625","0.01776718125","5411569.263750105","70.35040042874869"
"3574","6230","6224","7","6231","25973","1366.925625","0.017770033125","5412936.189375105","70.36817046187369"
"3575","6231","6229","6","6235","25979","1367.803125","0.017781440625","5414303.992500105","70.38595190249869"
"3576","6235","6227","8","6235","25987","1367.803125","0.017781440625","5415671.795625105","70.40373334312369"
"3577","6235","6228","7","6235","25994","1367.803125","0.017781440625","5417039.598750104","70.42151478374869"
"3578","6235","6226","4","6230","25998","1366.70625","0.01776718125","5418406.305000104","70.43928196499868"
"3579","6230","6228","3","6231","26001","1366.925625","0.017770033125","5419773.230625104","70.45705199812369"
"3580","6231","6227","4","6231","26005","1366.925625","0.017770033125","5421140.156250104","70.47482203124869"
"3581","6231","6223","8","6231","26013","1366.925625","0.017770033125","5422507.081875104","70.4925920643737"
"3582","6231","6225","2","6227","26015","1366.0481249999998","0.017758625624999996","5423873.130000104","70.5103506899987"
"3583","6227","6225","7","6232","26022","1367.1449999999998","0.017772884999999995","5425240.275000104","70.5281235749987"
"3584","6232","6223","7","6230","26029","1366.70625","0.01776718125","5426606.981250104","70.5458907562487"
"3585","6230","6223","6","6229","26035","1366.4868749999998","0.017764329374999995","5427973.468125104","70.5636550856237"
"3586","6229","6225","1","6226","26036","1365.8287500000001","0.017755773750000002","5429339.296875104","70.58141085937369"
"3587","6226","6221","9","6230","26045","1366.70625","0.01776718125","5430706.003125104","70.59917804062368"
"3588","6230","6229","9","6238","26054","1368.46125","0.01778999625","5432074.464375104","70.61696803687369"
"3589","6238","6229","9","6238","26063","1368.46125","0.01778999625","5433442.9256251035","70.63475803312369"
"3590","6238","6233","5","6238","26068","1368.46125","0.01778999625","5434811.386875103","70.65254802937369"
"3591","6238","6237","7","6244","26075","1369.7775","0.0178071075","5436181.164375103","70.6703551368737"
"3592","6244","6243","6","6249","26081","1370.8743749999999","0.017821366874999998","5437552.038750103","70.68817650374869"
"3593","6249","6247","9","6256","26090","1372.41","0.01784133","5438924.448750103","70.70601783374869"
"3594","6256","6247","9","6256","26099","1372.41","0.01784133","5440296.858750103","70.72385916374868"
"3595","6256","6248","7","6255","26106","1372.190625","0.017838478124999998","5441669.049375103","70.74169764187369"
"3596","6255","6248","4","6252","26110","1371.5324999999998","0.017829922499999998","5443040.581875103","70.75952756437368"
"3597","6252","6246","4","6250","26114","1371.09375","0.01782421875","5444411.675625103","70.77735178312368"
"3598","6250","6243","9","6252","26123","1371.5324999999998","0.017829922499999998","5445783.208125102","70.79518170562368"
"3599","6252","6244","7","6251","26130","1371.3131250000001","0.017827070625","5447154.521250103","70.81300877624868"
"3600","6251","6245","5","6250","26135","1371.09375","0.01782421875","5448525.615000103","70.83083299499867"
"3601","6250","6245","2","6247","26137","1370.4356249999998","0.017815663124999995","5449896.050625103","70.84864865812368"
"3602","6247","6238","5","6243","26142","1369.5581250000002","0.017804255625","5451265.608750103","70.86645291374867"
"3603","6243","6239","5","6244","26147","1369.7775","0.0178071075","5452635.386250103","70.88426002124868"
"3604","6244","6243","9","6252","26156","1371.5324999999998","0.017829922499999998","5454006.918750103","70.90208994374868"
"3605","6252","6246","4","6250","26160","1371.09375","0.01782421875","5455378.012500103","70.91991416249867"
"3606","6250","6247","8","6255","26168","1372.190625","0.017838478124999998","5456750.203125102","70.93775264062367"
"3607","6255","6250","9","6259","26177","1373.068125","0.017849885625","5458123.271250103","70.95560252624867"
"3608","6259","6250","8","6258","26185","1372.84875","0.01784703375","5459496.120000103","70.97344955999867"
"3609","6258","6250","5","6255","26190","1372.190625","0.017838478124999998","5460868.310625102","70.99128803812367"
"3610","6255","6254","3","6257","26193","1372.6293749999998","0.017844181874999997","5462240.940000102","71.00913221999868"
"3611","6257","6251","8","6259","26201","1373.068125","0.017849885625","5463614.008125102","71.02698210562367"
"3612","6259","6251","7","6258","26208","1372.84875","0.01784703375","5464986.856875102","71.04482913937368"
"3613","6258","6249","1","6250","26209","1371.09375","0.01782421875","5466357.950625102","71.06265335812367"
"3614","6250","6246","6","6252","26215","1371.5324999999998","0.017829922499999998","5467729.483125102","71.08048328062367"
"3615","6252","6246","6","6252","26221","1371.5324999999998","0.017829922499999998","5469101.0156251015","71.09831320312367"
"3616","6252","6247","8","6255","26229","1372.190625","0.017838478124999998","5470473.206250101","71.11615168124867"
"3617","6255","6252","5","6257","26234","1372.6293749999998","0.017844181874999997","5471845.835625101","71.13399586312367"
"3618","6257","6255","9","6264","26243","1374.165","0.017864144999999998","5473220.000625101","71.15186000812368"
"3619","6264","6260","8","6268","26251","1375.0425000000002","0.017875552500000003","5474595.043125101","71.16973556062368"
"3620","6268","6262","6","6268","26257","1375.0425000000002","0.017875552500000003","5475970.085625102","71.18761111312368"
"3621","6268","6264","5","6269","26262","1375.261875","0.017878404374999997","5477345.347500102","71.20548951749868"
"3622","6269","6261","7","6268","26269","1375.0425000000002","0.017875552500000003","5478720.390000102","71.22336506999868"
"3623","6268","6259","5","6264","26274","1374.165","0.017864144999999998","5480094.555000102","71.24122921499868"
"3624","6264","6258","6","6264","26280","1374.165","0.017864144999999998","5481468.720000102","71.25909335999869"
"3625","6264","6256","8","6264","26288","1374.165","0.017864144999999998","5482842.885000102","71.27695750499869"
"3626","6264","6257","1","6258","26289","1372.84875","0.01784703375","5484215.733750102","71.29480453874869"
"3627","6258","6249","9","6258","26298","1372.84875","0.01784703375","5485588.582500102","71.3126515724987"
"3628","6258","6251","7","6258","26305","1372.84875","0.01784703375","5486961.431250102","71.3304986062487"
"3629","6258","6256","7","6263","26312","1373.945625","0.017861293125","5488335.376875102","71.34835989937369"
"3630","6263","6260","8","6268","26320","1375.0425000000002","0.017875552500000003","5489710.419375102","71.36623545187369"
"3631","6268","6267","8","6275","26328","1376.578125","0.017895515625","5491086.997500102","71.38413096749869"
"3632","6275","6271","1","6272","26329","1375.9199999999998","0.017886959999999997","5492462.917500102","71.40201792749869"
"3633","6272","6269","6","6275","26335","1376.578125","0.017895515625","5493839.495625102","71.41991344312369"
"3634","6275","6267","2","6269","26337","1375.261875","0.017878404374999997","5495214.757500102","71.43779184749869"
"3635","6269","6262","2","6264","26339","1374.165","0.017864144999999998","5496588.922500102","71.45565599249869"
"3636","6264","6263","2","6265","26341","1374.384375","0.017866996875","5497963.306875102","71.47352298937369"
"3637","6265","6261","1","6262","26342","1373.72625","0.01785844125","5499337.0331251025","71.49138143062369"
"3638","6262","6255","5","6260","26347","1373.2875","0.017852737499999997","5500710.320625102","71.50923416812368"
"3639","6260","6254","9","6263","26356","1373.945625","0.017861293125","5502084.266250102","71.52709546124868"
"3640","6263","6261","3","6264","26359","1374.165","0.017864144999999998","5503458.431250102","71.54495960624868"
"3641","6264","6258","6","6264","26365","1374.165","0.017864144999999998","5504832.596250102","71.56282375124869"
"3642","6264","6260","8","6268","26373","1375.0425000000002","0.017875552500000003","5506207.638750102","71.58069930374869"
"3643","6268","6264","7","6271","26380","1375.7006250000002","0.017884108125000003","5507583.339375102","71.59858341187369"
"3644","6271","6269","1","6270","26381","1375.48125","0.017881256249999998","5508958.820625102","71.6164646681237"
"3645","6270","6267","2","6269","26383","1375.261875","0.017878404374999997","5510334.082500102","71.6343430724987"
"3646","6269","6261","3","6264","26386","1374.165","0.017864144999999998","5511708.247500102","71.6522072174987"
"3647","6264","6259","2","6261","26388","1373.506875","0.017855589374999998","5513081.754375102","71.6700628068737"
"3648","6261","6257","8","6265","26396","1374.384375","0.017866996875","5514456.138750102","71.6879298037487"
"3649","6265","6257","8","6265","26404","1374.384375","0.017866996875","5515830.523125103","71.7057968006237"
"3650","6265","6258","2","6260","26406","1373.2875","0.017852737499999997","5517203.810625102","71.7236495381237"
"3651","6260","6259","4","6263","26410","1373.945625","0.017861293125","5518577.756250102","71.74151083124869"
"3652","6263","6254","8","6262","26418","1373.72625","0.01785844125","5519951.482500102","71.75936927249869"
"3653","6262","6254","9","6263","26427","1373.945625","0.017861293125","5521325.428125102","71.77723056562368"
"3654","6263","6256","7","6263","26434","1373.945625","0.017861293125","5522699.373750102","71.79509185874868"
"3655","6263","6255","2","6257","26436","1372.6293749999998","0.017844181874999997","5524072.003125101","71.81293604062368"
"3656","6257","6250","7","6257","26443","1372.6293749999998","0.017844181874999997","5525444.632500101","71.83078022249869"
"3657","6257","6251","9","6260","26452","1373.2875","0.017852737499999997","5526817.9200001005","71.84863295999868"
"3658","6260","6259","8","6267","26460","1374.823125","0.017872700624999998","5528192.743125101","71.86650566062369"
"3659","6267","6263","8","6271","26468","1375.7006250000002","0.017884108125000003","5529568.4437501","71.88438976874869"
"3660","6271","6269","5","6274","26473","1376.3587499999999","0.017892663749999996","5530944.8025001","71.9022824324987"
"3661","6274","6268","6","6274","26479","1376.3587499999999","0.017892663749999996","5532321.1612501","71.9201750962487"
"3662","6274","6265","7","6272","26486","1375.9199999999998","0.017886959999999997","5533697.081250099","71.9380620562487"
"3663","6272","6271","3","6274","26489","1376.3587499999999","0.017892663749999996","5535073.440000099","71.9559547199987"
"3664","6274","6271","4","6275","26493","1376.578125","0.017895515625","5536450.018125099","71.9738502356237"
"3665","6275","6273","7","6280","26500","1377.675","0.017909775","5537827.693125099","71.99176001062371"
"3666","6280","6277","4","6281","26504","1377.894375","0.017912626875","5539205.587500099","72.00967263749871"
"3667","6281","6277","1","6278","26505","1377.2362500000002","0.01790407125","5540582.823750099","72.02757670874871"
"3668","6278","6269","2","6271","26507","1375.7006250000002","0.017884108125000003","5541958.524375099","72.04546081687371"
"3669","6271","6265","2","6267","26509","1374.823125","0.017872700624999998","5543333.347500099","72.06333351749872"
"3670","6267","6264","5","6269","26514","1375.261875","0.017878404374999997","5544708.609375099","72.08121192187372"
"3671","6269","6263","3","6266","26517","1374.60375","0.01786984875","5546083.2131250985","72.09908177062371"
"3672","6266","6264","3","6267","26520","1374.823125","0.017872700624999998","5547458.036250099","72.11695447124872"
"3673","6267","6261","5","6266","26525","1374.60375","0.01786984875","5548832.640000098","72.13482431999871"
"3674","6266","6264","1","6265","26526","1374.384375","0.017866996875","5550207.024375099","72.15269131687371"
"3675","6265","6264","3","6267","26529","1374.823125","0.017872700624999998","5551581.847500099","72.17056401749872"
"3676","6267","6261","4","6265","26533","1374.384375","0.017866996875","5552956.231875099","72.18843101437372"
"3677","6265","6260","9","6269","26542","1375.261875","0.017878404374999997","5554331.493750099","72.20630941874872"
"3678","6269","6268","8","6276","26550","1376.7975000000001","0.0178983675","5555708.291250099","72.22420778624871"
"3679","6276","6273","4","6277","26554","1377.0168749999998","0.017901219374999996","5557085.308125099","72.24210900562372"
"3680","6277","6274","1","6275","26555","1376.578125","0.017895515625","5558461.886250099","72.26000452124872"
"3681","6275","6272","8","6280","26563","1377.675","0.017909775","5559839.561250099","72.27791429624872"
"3682","6280","6274","8","6282","26571","1378.1137499999998","0.017915478749999995","5561217.6750000985","72.29582977499872"
"3683","6282","6273","2","6275","26573","1376.578125","0.017895515625","5562594.2531250985","72.31372529062372"
"3684","6275","6270","6","6276","26579","1376.7975000000001","0.0178983675","5563971.050625099","72.33162365812372"
"3685","6276","6275","6","6281","26585","1377.894375","0.017912626875","5565348.945000099","72.34953628499872"
"3686","6281","6280","2","6282","26587","1378.1137499999998","0.017915478749999995","5566727.058750099","72.36745176374872"
"3687","6282","6281","6","6287","26593","1379.210625","0.017929738124999997","5568106.269375099","72.38538150187372"
"3688","6287","6280","1","6281","26594","1377.894375","0.017912626875","5569484.163750099","72.40329412874873"
"3689","6281","6279","1","6280","26595","1377.675","0.017909775","5570861.838750099","72.42120390374873"
"3690","6280","6273","7","6280","26602","1377.675","0.017909775","5572239.513750099","72.43911367874874"
"3691","6280","6277","6","6283","26608","1378.333125","0.017918330625","5573617.8468750985","72.45703200937373"
"3692","6283","6281","7","6288","26615","1379.43","0.017932589999999998","5574997.276875098","72.47496459937373"
"3693","6288","6283","5","6288","26620","1379.43","0.017932589999999998","5576376.706875098","72.49289718937374"
"3694","6288","6287","9","6296","26629","1381.1850000000002","0.017955405","5577757.8918750975","72.51085259437373"
"3695","6296","6289","7","6296","26636","1381.1850000000002","0.017955405","5579139.076875097","72.52880799937373"
"3696","6296","6291","5","6296","26641","1381.1850000000002","0.017955405","5580520.261875097","72.54676340437372"
"3697","6296","6287","4","6291","26645","1380.088125","0.017941145625","5581900.3500000965","72.56470454999872"
"3698","6291","6289","2","6291","26647","1380.088125","0.017941145625","5583280.438125096","72.58264569562373"
"3699","6291","6288","8","6296","26655","1381.1850000000002","0.017955405","5584661.623125096","72.60060110062372"
"3700","6296","6288","9","6297","26664","1381.4043749999998","0.017958256875","5586043.027500096","72.61855935749873"
"3701","6297","6289","7","6296","26671","1381.1850000000002","0.017955405","5587424.212500095","72.63651476249872"
"3702","6296","6289","5","6294","26676","1380.74625","0.01794970125","5588804.958750095","72.65446446374872"
"3703","6294","6290","3","6293","26679","1380.5268750000002","0.017946849375","5590185.485625096","72.67241131312372"
"3704","6293","6288","6","6294","26685","1380.74625","0.01794970125","5591566.2318750955","72.69036101437372"
"3705","6294","6287","3","6290","26688","1379.86875","0.01793829375","5592946.100625096","72.70829930812373"
"3706","6290","6283","5","6288","26693","1379.43","0.017932589999999998","5594325.530625096","72.72623189812373"
"3707","6288","6286","1","6287","26694","1379.210625","0.017929738124999997","5595704.741250096","72.74416163624873"
"3708","6287","6285","5","6290","26699","1379.86875","0.01793829375","5597084.610000096","72.76209992999874"
"3709","6290","6283","2","6285","26701","1378.771875","0.017924034374999998","5598463.381875096","72.78002396437374"
"3710","6285","6276","8","6284","26709","1378.5525","0.0179211825","5599841.934375096","72.79794514687374"
"3711","6284","6283","1","6284","26710","1378.5525","0.0179211825","5601220.486875096","72.81586632937375"
"3712","6284","6282","4","6286","26714","1378.99125","0.01792688625","5602599.478125096","72.83379321562374"
"3713","6286","6282","5","6287","26719","1379.210625","0.017929738124999997","5603978.688750097","72.85172295374875"
"3714","6287","6283","4","6287","26723","1379.210625","0.017929738124999997","5605357.899375097","72.86965269187375"
"3715","6287","6278","6","6284","26729","1378.5525","0.0179211825","5606736.451875097","72.88757387437376"
"3716","6284","6275","5","6280","26734","1377.675","0.017909775","5608114.126875097","72.90548364937376"
"3717","6280","6274","1","6275","26735","1376.578125","0.017895515625","5609490.705000097","72.92337916499876"
"3718","6275","6266","8","6274","26743","1376.3587499999999","0.017892663749999996","5610867.063750097","72.94127182874877"
"3719","6274","6266","5","6271","26748","1375.7006250000002","0.017884108125000003","5612242.764375096","72.95915593687377"
"3720","6271","6270","4","6274","26752","1376.3587499999999","0.017892663749999996","5613619.123125096","72.97704860062377"
"3721","6274","6265","9","6274","26761","1376.3587499999999","0.017892663749999996","5614995.4818750955","72.99494126437378"
"3722","6274","6267","1","6268","26762","1375.0425000000002","0.017875552500000003","5616370.524375096","73.01281681687378"
"3723","6268","6262","3","6265","26765","1374.384375","0.017866996875","5617744.908750096","73.03068381374878"
"3724","6265","6262","7","6269","26772","1375.261875","0.017878404374999997","5619120.170625096","73.04856221812378"
"3725","6269","6265","8","6273","26780","1376.1393750000002","0.017889811875","5620496.310000096","73.06645202999877"
"3726","6273","6271","3","6274","26783","1376.3587499999999","0.017892663749999996","5621872.668750096","73.08434469374878"
"3727","6274","6272","6","6278","26789","1377.2362500000002","0.01790407125","5623249.905000096","73.10224876499878"
"3728","6278","6271","7","6278","26796","1377.2362500000002","0.01790407125","5624627.141250096","73.12015283624878"
"3729","6278","6274","3","6277","26799","1377.0168749999998","0.017901219374999996","5626004.158125096","73.13805405562378"
"3730","6277","6276","3","6279","26802","1377.4556249999998","0.017906923124999998","5627381.613750096","73.15596097874878"
"3731","6279","6276","4","6280","26806","1377.675","0.017909775","5628759.288750096","73.17387075374879"
"3732","6280","6273","7","6280","26813","1377.675","0.017909775","5630136.963750096","73.1917805287488"
"3733","6280","6271","2","6273","26815","1376.1393750000002","0.017889811875","5631513.103125096","73.20967034062379"
"3734","6273","6264","8","6272","26823","1375.9199999999998","0.017886959999999997","5632889.023125096","73.22755730062379"
"3735","6272","6271","2","6273","26825","1376.1393750000002","0.017889811875","5634265.1625000965","73.24544711249878"
"3736","6273","6271","6","6277","26831","1377.0168749999998","0.017901219374999996","5635642.179375096","73.26334833187379"
"3737","6277","6270","7","6277","26838","1377.0168749999998","0.017901219374999996","5637019.196250096","73.28124955124879"
"3738","6277","6273","8","6281","26846","1377.894375","0.017912626875","5638397.090625096","73.2991621781238"
"3739","6281","6280","3","6283","26849","1378.333125","0.017918330625","5639775.423750096","73.31708050874879"
"3740","6283","6274","4","6278","26853","1377.2362500000002","0.01790407125","5641152.660000096","73.33498457999879"
"3741","6278","6276","3","6279","26856","1377.4556249999998","0.017906923124999998","5642530.1156250965","73.35289150312379"
"3742","6279","6270","1","6271","26857","1375.7006250000002","0.017884108125000003","5643905.816250096","73.37077561124879"
"3743","6271","6267","4","6271","26861","1375.7006250000002","0.017884108125000003","5645281.516875096","73.38865971937379"
"3744","6271","6263","2","6265","26863","1374.384375","0.017866996875","5646655.901250096","73.40652671624879"
"3745","6265","6257","7","6264","26870","1374.165","0.017864144999999998","5648030.066250096","73.4243908612488"
"3746","6264","6260","8","6268","26878","1375.0425000000002","0.017875552500000003","5649405.1087500965","73.4422664137488"
"3747","6268","6266","9","6275","26887","1376.578125","0.017895515625","5650781.6868750965","73.4601619293738"
"3748","6275","6267","7","6274","26894","1376.3587499999999","0.017892663749999996","5652158.045625096","73.4780545931238"
"3749","6274","6265","8","6273","26902","1376.1393750000002","0.017889811875","5653534.185000096","73.4959444049988"
"3750","6273","6268","5","6273","26907","1376.1393750000002","0.017889811875","5654910.324375097","73.51383421687379"
"3751","6273","6268","3","6271","26910","1375.7006250000002","0.017884108125000003","5656286.025000096","73.53171832499879"
"3752","6271","6267","9","6276","26919","1376.7975000000001","0.0178983675","5657662.822500097","73.54961669249879"
"3753","6276","6273","4","6277","26923","1377.0168749999998","0.017901219374999996","5659039.839375096","73.5675179118738"
"3754","6277","6272","6","6278","26929","1377.2362500000002","0.01790407125","5660417.075625096","73.5854219831238"
"3755","6278","6277","1","6278","26930","1377.2362500000002","0.01790407125","5661794.3118750965","73.6033260543738"
"3756","6278","6272","8","6280","26938","1377.675","0.017909775","5663171.986875096","73.6212358293738"
"3757","6280","6275","6","6281","26944","1377.894375","0.017912626875","5664549.8812500965","73.6391484562488"
"3758","6281","6279","6","6285","26950","1378.771875","0.017924034374999998","5665928.653125096","73.6570724906238"
"3759","6285","6280","8","6288","26958","1379.43","0.017932589999999998","5667308.083125096","73.6750050806238"
"3760","6288","6283","8","6291","26966","1380.088125","0.017941145625","5668688.171250096","73.69294622624881"
"3761","6291","6286","2","6288","26968","1379.43","0.017932589999999998","5670067.601250095","73.71087881624881"
"3762","6288","6282","7","6289","26975","1379.649375","0.017935441875","5671447.250625095","73.7288142581238"
"3763","6289","6281","3","6284","26978","1378.5525","0.0179211825","5672825.803125096","73.74673544062381"
"3764","6284","6276","9","6285","26987","1378.771875","0.017924034374999998","5674204.575000095","73.76465947499881"
"3765","6285","6282","3","6285","26990","1378.771875","0.017924034374999998","5675583.346875095","73.78258350937381"
"3766","6285","6281","9","6290","26999","1379.86875","0.01793829375","5676963.215625095","73.80052180312381"
"3767","6290","6283","9","6292","27008","1380.3075","0.017943997499999996","5678343.523125095","73.81846580062381"
"3768","6292","6283","5","6288","27013","1379.43","0.017932589999999998","5679722.953125095","73.83639839062381"
"3769","6288","6279","3","6282","27016","1378.1137499999998","0.017915478749999995","5681101.066875095","73.85431386937381"
"3770","6282","6273","1","6274","27017","1376.3587499999999","0.017892663749999996","5682477.425625094","73.87220653312382"
"3771","6274","6272","2","6274","27019","1376.3587499999999","0.017892663749999996","5683853.784375094","73.89009919687382"
"3772","6274","6269","9","6278","27028","1377.2362500000002","0.01790407125","5685231.020625094","73.90800326812382"
"3773","6278","6275","9","6284","27037","1378.5525","0.0179211825","5686609.573125094","73.92592445062382"
"3774","6284","6282","2","6284","27039","1378.5525","0.0179211825","5687988.125625094","73.94384563312383"
"3775","6284","6279","9","6288","27048","1379.43","0.017932589999999998","5689367.555625094","73.96177822312383"
"3776","6288","6283","8","6291","27056","1380.088125","0.017941145625","5690747.643750094","73.97971936874883"
"3777","6291","6288","7","6295","27063","1380.965625","0.017952553125","5692128.609375094","73.99767192187383"
"3778","6295","6294","6","6300","27069","1382.0625","0.0179668125","5693510.671875094","74.01563873437384"
"3779","6300","6295","7","6302","27076","1382.5012499999998","0.017972516249999997","5694893.173125094","74.03361125062384"
"3780","6302","6297","2","6299","27078","1381.8431249999999","0.017963960624999997","5696275.0162500935","74.05157521124883"
"3781","6299","6293","9","6302","27087","1382.5012499999998","0.017972516249999997","5697657.517500093","74.06954772749883"
"3782","6302","6294","8","6302","27095","1382.5012499999998","0.017972516249999997","5699040.018750093","74.08752024374883"
"3783","6302","6297","8","6305","27103","1383.159375","0.017981071874999997","5700423.178125093","74.10550131562383"
"3784","6305","6299","7","6306","27110","1383.37875","0.01798392375","5701806.556875093","74.12348523937382"
"3785","6306","6297","7","6304","27117","1382.9399999999998","0.017978219999999996","5703189.496875093","74.14146345937382"
"3786","6304","6296","9","6305","27126","1383.159375","0.017981071874999997","5704572.656250093","74.15944453124882"
"3787","6305","6299","8","6307","27134","1383.5981249999998","0.017986775624999996","5705956.254375093","74.17743130687383"
"3788","6307","6298","7","6305","27141","1383.159375","0.017981071874999997","5707339.4137500925","74.19541237874883"
"3789","6305","6299","7","6306","27148","1383.37875","0.01798392375","5708722.792500093","74.21339630249882"
"3790","6306","6299","8","6307","27156","1383.5981249999998","0.017986775624999996","5710106.390625092","74.23138307812383"
"3791","6307","6298","8","6306","27164","1383.37875","0.01798392375","5711489.769375092","74.24936700187382"
"3792","6306","6305","3","6308","27167","1383.8175","0.0179896275","5712873.586875092","74.26735662937382"
"3793","6308","6299","3","6302","27170","1382.5012499999998","0.017972516249999997","5714256.088125092","74.28532914562382"
"3794","6302","6296","9","6305","27179","1383.159375","0.017981071874999997","5715639.247500092","74.30331021749882"
"3795","6305","6296","9","6305","27188","1383.159375","0.017981071874999997","5717022.406875092","74.32129128937382"
"3796","6305","6297","7","6304","27195","1382.9399999999998","0.017978219999999996","5718405.346875092","74.33926950937382"
"3797","6304","6296","2","6298","27197","1381.6237500000002","0.017961108750000003","5719786.970625092","74.35723061812382"
"3798","6298","6293","5","6298","27202","1381.6237500000002","0.017961108750000003","5721168.594375093","74.37519172687382"
"3799","6298","6294","7","6301","27209","1382.2818750000001","0.017969664375","5722550.876250093","74.39316139124882"
"3800","6301","6293","6","6299","27215","1381.8431249999999","0.017963960624999997","5723932.719375093","74.41112535187382"
"3801","6299","6293","5","6298","27220","1381.6237500000002","0.017961108750000003","5725314.343125093","74.42908646062382"
"3802","6298","6290","7","6297","27227","1381.4043749999998","0.017958256875","5726695.747500093","74.44704471749883"
"3803","6297","6292","2","6294","27229","1380.74625","0.01794970125","5728076.493750093","74.46499441874883"
"3804","6294","6287","1","6288","27230","1379.43","0.017932589999999998","5729455.923750092","74.48292700874883"
"3805","6288","6282","2","6284","27232","1378.5525","0.0179211825","5730834.4762500925","74.50084819124883"
"3806","6284","6278","8","6286","27240","1378.99125","0.01792688625","5732213.467500092","74.51877507749883"
"3807","6286","6284","7","6291","27247","1380.088125","0.017941145625","5733593.555625092","74.53671622312383"
"3808","6291","6289","7","6296","27254","1381.1850000000002","0.017955405","5734974.740625092","74.55467162812383"
"3809","6296","6290","4","6294","27258","1380.74625","0.01794970125","5736355.486875092","74.57262132937383"
"3810","6294","6285","8","6293","27266","1380.5268750000002","0.017946849375","5737736.013750092","74.59056817874882"
"3811","6293","6284","1","6285","27267","1378.771875","0.017924034374999998","5739114.785625092","74.60849221312382"
"3812","6285","6278","9","6287","27276","1379.210625","0.017929738124999997","5740493.996250092","74.62642195124883"
"3813","6287","6285","6","6291","27282","1380.088125","0.017941145625","5741874.084375092","74.64436309687383"
"3814","6291","6288","7","6295","27289","1380.965625","0.017952553125","5743255.050000092","74.66231564999883"
"3815","6295","6292","5","6297","27294","1381.4043749999998","0.017958256875","5744636.454375092","74.68027390687384"
"3816","6297","6289","6","6295","27300","1380.965625","0.017952553125","5746017.420000092","74.69822645999884"
"3817","6295","6288","6","6294","27306","1380.74625","0.01794970125","5747398.166250092","74.71617616124884"
"3818","6294","6293","7","6300","27313","1382.0625","0.0179668125","5748780.228750092","74.73414297374885"
"3819","6300","6292","3","6295","27316","1380.965625","0.017952553125","5750161.194375092","74.75209552687384"
"3820","6295","6287","2","6289","27318","1379.649375","0.017935441875","5751540.843750092","74.77003096874884"
"3821","6289","6283","1","6284","27319","1378.5525","0.0179211825","5752919.396250092","74.78795215124885"
"3822","6284","6277","3","6280","27322","1377.675","0.017909775","5754297.071250092","74.80586192624885"
"3823","6280","6271","2","6273","27324","1376.1393750000002","0.017889811875","5755673.2106250925","74.82375173812385"
"3824","6273","6265","7","6272","27331","1375.9199999999998","0.017886959999999997","5757049.130625092","74.84163869812384"
"3825","6272","6265","7","6272","27338","1375.9199999999998","0.017886959999999997","5758425.050625092","74.85952565812384"
"3826","6272","6268","7","6275","27345","1376.578125","0.017895515625","5759801.628750092","74.87742117374884"
"3827","6275","6266","9","6275","27354","1376.578125","0.017895515625","5761178.206875092","74.89531668937384"
"3828","6275","6267","1","6268","27355","1375.0425000000002","0.017875552500000003","5762553.249375093","74.91319224187384"
"3829","6268","6259","5","6264","27360","1374.165","0.017864144999999998","5763927.414375093","74.93105638687385"
"3830","6264","6259","1","6260","27361","1373.2875","0.017852737499999997","5765300.701875092","74.94890912437384"
"3831","6260","6254","5","6259","27366","1373.068125","0.017849885625","5766673.770000093","74.96675900999884"
"3832","6259","6255","1","6256","27367","1372.41","0.01784133","5768046.180000093","74.98460033999883"
"3833","6256","6250","9","6259","27376","1373.068125","0.017849885625","5769419.248125093","75.00245022562383"
"3834","6259","6256","3","6259","27379","1373.068125","0.017849885625","5770792.316250093","75.02030011124883"
"3835","6259","6252","1","6253","27380","1371.7518750000002","0.017832774375000002","5772164.068125093","75.03813288562382"
"3836","6253","6244","9","6253","27389","1371.7518750000002","0.017832774375000002","5773535.820000093","75.05596565999882"
"3837","6253","6250","9","6259","27398","1373.068125","0.017849885625","5774908.888125094","75.07381554562382"
"3838","6259","6250","2","6252","27400","1371.5324999999998","0.017829922499999998","5776280.420625093","75.09164546812382"
"3839","6252","6244","2","6246","27402","1370.2162500000002","0.01781281125","5777650.636875093","75.10945827937381"
"3840","6246","6244","9","6253","27411","1371.7518750000002","0.017832774375000002","5779022.388750093","75.1272910537488"
"3841","6253","6249","5","6254","27416","1371.9712499999998","0.017835626249999997","5780394.3600000935","75.14512667999881"
"3842","6254","6248","9","6257","27425","1372.6293749999998","0.017844181874999997","5781766.989375093","75.16297086187382"
"3843","6257","6254","7","6261","27432","1373.506875","0.017855589374999998","5783140.496250093","75.18082645124882"
"3844","6261","6252","1","6253","27433","1371.7518750000002","0.017832774375000002","5784512.248125093","75.19865922562381"
"3845","6253","6252","2","6254","27435","1371.9712499999998","0.017835626249999997","5785884.2193750935","75.21649485187382"
"3846","6254","6252","5","6257","27440","1372.6293749999998","0.017844181874999997","5787256.848750093","75.23433903374882"
"3847","6257","6253","4","6257","27444","1372.6293749999998","0.017844181874999997","5788629.478125093","75.25218321562383"
"3848","6257","6252","4","6256","27448","1372.41","0.01784133","5790001.888125093","75.27002454562383"
"3849","6256","6247","9","6256","27457","1372.41","0.01784133","5791374.298125093","75.28786587562382"
"3850","6256","6249","7","6256","27464","1372.41","0.01784133","5792746.708125093","75.30570720562382"
"3851","6256","6248","3","6251","27467","1371.3131250000001","0.017827070625","5794118.021250093","75.32353427624882"
"3852","6251","6246","9","6255","27476","1372.190625","0.017838478124999998","5795490.211875093","75.34137275437382"
"3853","6255","6246","9","6255","27485","1372.190625","0.017838478124999998","5796862.402500093","75.35921123249882"
"3854","6255","6249","3","6252","27488","1371.5324999999998","0.017829922499999998","5798233.935000093","75.37704115499882"
"3855","6252","6243","9","6252","27497","1371.5324999999998","0.017829922499999998","5799605.467500092","75.39487107749882"
"3856","6252","6244","2","6246","27499","1370.2162500000002","0.01781281125","5800975.683750092","75.41268388874882"
"3857","6246","6239","4","6243","27503","1369.5581250000002","0.017804255625","5802345.2418750925","75.43048814437381"
"3858","6243","6238","3","6241","27506","1369.119375","0.017798551875","5803714.361250092","75.44828669624881"
"3859","6241","6232","2","6234","27508","1367.58375","0.017778588749999998","5805081.9450000925","75.46606528499882"
"3860","6234","6226","9","6235","27517","1367.803125","0.017781440625","5806449.748125092","75.48384672562382"
"3861","6235","6229","9","6238","27526","1368.46125","0.01778999625","5807818.209375092","75.50163672187382"
"3862","6238","6230","1","6231","27527","1366.925625","0.017770033125","5809185.135000092","75.51940675499883"
"3863","6231","6224","9","6233","27536","1367.364375","0.017775736875","5810552.499375092","75.53718249187382"
"3864","6233","6226","4","6230","27540","1366.70625","0.01776718125","5811919.205625092","75.55494967312382"
"3865","6230","6222","4","6226","27544","1365.8287500000001","0.017755773750000002","5813285.034375092","75.57270544687381"
"3866","6226","6224","5","6229","27549","1366.4868749999998","0.017764329374999995","5814651.521250092","75.59046977624881"
"3867","6229","6220","5","6225","27554","1365.609375","0.017752921874999997","5816017.130625092","75.60822269812381"
"3868","6225","6222","4","6226","27558","1365.8287500000001","0.017755773750000002","5817382.959375093","75.62597847187381"
"3869","6226","6221","8","6229","27566","1366.4868749999998","0.017764329374999995","5818749.446250093","75.6437428012488"
"3870","6229","6222","8","6230","27574","1366.70625","0.01776718125","5820116.152500093","75.6615099824988"
"3871","6230","6225","7","6232","27581","1367.1449999999998","0.017772884999999995","5821483.297500093","75.6792828674988"
"3872","6232","6223","8","6231","27589","1366.925625","0.017770033125","5822850.223125093","75.6970529006238"
"3873","6231","6225","8","6233","27597","1367.364375","0.017775736875","5824217.587500093","75.7148286374988"
"3874","6233","6225","5","6230","27602","1366.70625","0.01776718125","5825584.293750092","75.73259581874879"
"3875","6230","6224","7","6231","27609","1366.925625","0.017770033125","5826951.219375093","75.7503658518738"
"3876","6231","6228","4","6232","27613","1367.1449999999998","0.017772884999999995","5828318.364375092","75.7681387368738"
"3877","6232","6230","6","6236","27619","1368.0225","0.0177842925","5829686.386875092","75.78592302937379"
"3878","6236","6233","7","6240","27626","1368.9","0.0177957","5831055.286875092","75.80371872937378"
"3879","6240","6232","9","6241","27635","1369.119375","0.017798551875","5832424.406250092","75.82151728124879"
"3880","6241","6239","9","6248","27644","1370.6550000000002","0.017818515","5833795.061250092","75.83933579624879"
"3881","6248","6247","8","6255","27652","1372.190625","0.017838478124999998","5835167.251875092","75.85717427437379"
"3882","6255","6251","3","6254","27655","1371.9712499999998","0.017835626249999997","5836539.223125093","75.8750099006238"
"3883","6254","6251","2","6253","27657","1371.7518750000002","0.017832774375000002","5837910.975000093","75.89284267499879"
"3884","6253","6244","9","6253","27666","1371.7518750000002","0.017832774375000002","5839282.726875093","75.91067544937378"
"3885","6253","6244","2","6246","27668","1370.2162500000002","0.01781281125","5840652.943125092","75.92848826062378"
"3886","6246","6240","8","6248","27676","1370.6550000000002","0.017818515","5842023.598125093","75.94630677562378"
"3887","6248","6242","4","6246","27680","1370.2162500000002","0.01781281125","5843393.814375092","75.96411958687378"
"3888","6246","6242","9","6251","27689","1371.3131250000001","0.017827070625","5844765.127500093","75.98194665749878"
"3889","6251","6243","8","6251","27697","1371.3131250000001","0.017827070625","5846136.440625093","75.99977372812378"
"3890","6251","6243","7","6250","27704","1371.09375","0.01782421875","5847507.534375093","76.01759794687378"
"3891","6250","6247","3","6250","27707","1371.09375","0.01782421875","5848878.628125093","76.03542216562377"
"3892","6250","6242","3","6245","27710","1369.996875","0.017809959375","5850248.625000093","76.05323212499877"
"3893","6245","6240","3","6243","27713","1369.5581250000002","0.017804255625","5851618.183125094","76.07103638062377"
"3894","6243","6239","1","6240","27714","1368.9","0.0177957","5852987.083125094","76.08883208062376"
"3895","6240","6236","4","6240","27718","1368.9","0.0177957","5854355.983125094","76.10662778062375"
"3896","6240","6236","5","6241","27723","1369.119375","0.017798551875","5855725.102500094","76.12442633249876"
"3897","6241","6233","8","6241","27731","1369.119375","0.017798551875","5857094.221875094","76.14222488437376"
"3898","6241","6239","2","6241","27733","1369.119375","0.017798551875","5858463.341250094","76.16002343624876"
"3899","6241","6235","1","6236","27734","1368.0225","0.0177842925","5859831.363750094","76.17780772874876"
"3900","6236","6235","2","6237","27736","1368.241875","0.017787144374999998","5861199.605625094","76.19559487312377"
"3901","6237","6229","1","6230","27737","1366.70625","0.01776718125","5862566.311875094","76.21336205437376"
"3902","6230","6228","4","6232","27741","1367.1449999999998","0.017772884999999995","5863933.456875093","76.23113493937376"
"3903","6232","6230","6","6236","27747","1368.0225","0.0177842925","5865301.479375093","76.24891923187376"
"3904","6236","6234","3","6237","27750","1368.241875","0.017787144374999998","5866669.721250094","76.26670637624876"
"3905","6237","6228","8","6236","27758","1368.0225","0.0177842925","5868037.7437500935","76.28449066874876"
"3906","6236","6232","8","6240","27766","1368.9","0.0177957","5869406.643750094","76.30228636874875"
"3907","6240","6231","4","6235","27770","1367.803125","0.017781440625","5870774.4468750935","76.32006780937375"
"3908","6235","6231","6","6237","27776","1368.241875","0.017787144374999998","5872142.688750094","76.33785495374876"
"3909","6237","6235","6","6241","27782","1369.119375","0.017798551875","5873511.808125094","76.35565350562376"
"3910","6241","6238","5","6243","27787","1369.5581250000002","0.017804255625","5874881.366250094","76.37345776124876"
"3911","6243","6238","9","6247","27796","1370.4356249999998","0.017815663124999995","5876251.801875094","76.39127342437376"
"3912","6247","6238","5","6243","27801","1369.5581250000002","0.017804255625","5877621.360000094","76.40907767999876"
"3913","6243","6240","7","6247","27808","1370.4356249999998","0.017815663124999995","5878991.795625094","76.42689334312377"
"3914","6247","6242","5","6247","27813","1370.4356249999998","0.017815663124999995","5880362.231250094","76.44470900624877"
"3915","6247","6245","6","6251","27819","1371.3131250000001","0.017827070625","5881733.544375095","76.46253607687377"
"3916","6251","6244","7","6251","27826","1371.3131250000001","0.017827070625","5883104.857500095","76.48036314749878"
"3917","6251","6244","6","6250","27832","1371.09375","0.01782421875","5884475.951250095","76.49818736624877"
"3918","6250","6247","6","6253","27838","1371.7518750000002","0.017832774375000002","5885847.703125095","76.51602014062377"
"3919","6253","6245","9","6254","27847","1371.9712499999998","0.017835626249999997","5887219.674375095","76.53385576687377"
"3920","6254","6250","5","6255","27852","1372.190625","0.017838478124999998","5888591.865000095","76.55169424499877"
"3921","6255","6253","7","6260","27859","1373.2875","0.017852737499999997","5889965.152500095","76.56954698249876"
"3922","6260","6251","1","6252","27860","1371.5324999999998","0.017829922499999998","5891336.685000095","76.58737690499876"
"3923","6252","6250","2","6252","27862","1371.5324999999998","0.017829922499999998","5892708.217500094","76.60520682749876"
"3924","6252","6246","2","6248","27864","1370.6550000000002","0.017818515","5894078.872500095","76.62302534249876"
"3925","6248","6241","9","6250","27873","1371.09375","0.01782421875","5895449.966250095","76.64084956124876"
"3926","6250","6246","1","6247","27874","1370.4356249999998","0.017815663124999995","5896820.4018750945","76.65866522437376"
"3927","6247","6241","2","6243","27876","1369.5581250000002","0.017804255625","5898189.960000095","76.67646947999876"
"3928","6243","6235","3","6238","27879","1368.46125","0.01778999625","5899558.421250095","76.69425947624876"
"3929","6238","6236","7","6243","27886","1369.5581250000002","0.017804255625","5900927.979375095","76.71206373187376"
"3930","6243","6235","3","6238","27889","1368.46125","0.01778999625","5902296.440625095","76.72985372812376"
"3931","6238","6235","8","6243","27897","1369.5581250000002","0.017804255625","5903665.998750095","76.74765798374875"
"3932","6243","6241","3","6244","27900","1369.7775","0.0178071075","5905035.776250095","76.76546509124876"
"3933","6244","6239","1","6240","27901","1368.9","0.0177957","5906404.6762500955","76.78326079124875"
"3934","6240","6236","8","6244","27909","1369.7775","0.0178071075","5907774.453750095","76.80106789874876"
"3935","6244","6235","8","6243","27917","1369.5581250000002","0.017804255625","5909144.011875096","76.81887215437375"
"3936","6243","6237","9","6246","27926","1370.2162500000002","0.01781281125","5910514.228125095","76.83668496562375"
"3937","6246","6239","5","6244","27931","1369.7775","0.0178071075","5911884.005625095","76.85449207312375"
"3938","6244","6240","2","6242","27933","1369.33875","0.017801403749999997","5913253.344375095","76.87229347687375"
"3939","6242","6237","6","6243","27939","1369.5581250000002","0.017804255625","5914622.902500096","76.89009773249875"
"3940","6243","6237","5","6242","27944","1369.33875","0.017801403749999997","5915992.241250096","76.90789913624874"
"3941","6242","6233","3","6236","27947","1368.0225","0.0177842925","5917360.263750096","76.92568342874874"
"3942","6236","6234","7","6241","27954","1369.119375","0.017798551875","5918729.383125096","76.94348198062374"
"3943","6241","6235","6","6241","27960","1369.119375","0.017798551875","5920098.502500095","76.96128053249875"
"3944","6241","6238","2","6240","27962","1368.9","0.0177957","5921467.402500096","76.97907623249874"
"3945","6240","6235","9","6244","27971","1369.7775","0.0178071075","5922837.180000096","76.99688333999875"
"3946","6244","6239","8","6247","27979","1370.4356249999998","0.017815663124999995","5924207.615625096","77.01469900312375"
"3947","6247","6241","6","6247","27985","1370.4356249999998","0.017815663124999995","5925578.0512500955","77.03251466624876"
"3948","6247","6241","3","6244","27988","1369.7775","0.0178071075","5926947.828750095","77.05032177374876"
"3949","6244","6239","2","6241","27990","1369.119375","0.017798551875","5928316.948125095","77.06812032562377"
"3950","6241","6240","5","6245","27995","1369.996875","0.017809959375","5929686.945000095","77.08593028499877"
"3951","6245","6238","5","6243","28000","1369.5581250000002","0.017804255625","5931056.503125096","77.10373454062376"
"3952","6243","6242","5","6247","28005","1370.4356249999998","0.017815663124999995","5932426.938750096","77.12155020374877"
"3953","6247","6245","8","6253","28013","1371.7518750000002","0.017832774375000002","5933798.690625096","77.13938297812376"
"3954","6253","6249","6","6255","28019","1372.190625","0.017838478124999998","5935170.881250096","77.15722145624876"
"3955","6255","6252","7","6259","28026","1373.068125","0.017849885625","5936543.949375096","77.17507134187376"
"3956","6259","6251","1","6252","28027","1371.5324999999998","0.017829922499999998","5937915.4818750955","77.19290126437376"
"3957","6252","6250","9","6259","28036","1373.068125","0.017849885625","5939288.550000096","77.21075114999876"
"3958","6259","6250","3","6253","28039","1371.7518750000002","0.017832774375000002","5940660.301875096","77.22858392437375"
"3959","6253","6249","1","6250","28040","1371.09375","0.01782421875","5942031.395625096","77.24640814312374"
"3960","6250","6241","7","6248","28047","1370.6550000000002","0.017818515","5943402.050625096","77.26422665812375"
"3961","6248","6247","8","6255","28055","1372.190625","0.017838478124999998","5944774.241250096","77.28206513624875"
"3962","6255","6253","6","6259","28061","1373.068125","0.017849885625","5946147.309375096","77.29991502187374"
"3963","6259","6254","3","6257","28064","1372.6293749999998","0.017844181874999997","5947519.938750096","77.31775920374875"
"3964","6257","6254","1","6255","28065","1372.190625","0.017838478124999998","5948892.1293750955","77.33559768187375"
"3965","6255","6248","5","6253","28070","1371.7518750000002","0.017832774375000002","5950263.881250096","77.35343045624874"
"3966","6253","6247","3","6250","28073","1371.09375","0.01782421875","5951634.975000096","77.37125467499874"
"3967","6250","6245","3","6248","28076","1370.6550000000002","0.017818515","5953005.630000096","77.38907318999874"
"3968","6248","6242","5","6247","28081","1370.4356249999998","0.017815663124999995","5954376.065625096","77.40688885312375"
"3969","6247","6246","8","6254","28089","1371.9712499999998","0.017835626249999997","5955748.036875096","77.42472447937375"
"3970","6254","6245","9","6254","28098","1371.9712499999998","0.017835626249999997","5957120.008125097","77.44256010562376"
"3971","6254","6249","3","6252","28101","1371.5324999999998","0.017829922499999998","5958491.540625096","77.46039002812375"
"3972","6252","6243","1","6244","28102","1369.7775","0.0178071075","5959861.318125096","77.47819713562376"
"3973","6244","6239","7","6246","28109","1370.2162500000002","0.01781281125","5961231.534375096","77.49600994687376"
"3974","6246","6241","9","6250","28118","1371.09375","0.01782421875","5962602.628125096","77.51383416562375"
"3975","6250","6242","4","6246","28122","1370.2162500000002","0.01781281125","5963972.844375095","77.53164697687374"
"3976","6246","6245","1","6246","28123","1370.2162500000002","0.01781281125","5965343.060625095","77.54945978812374"
"3977","6246","6237","9","6246","28132","1370.2162500000002","0.01781281125","5966713.2768750945","77.56727259937374"
"3978","6246","6243","1","6244","28133","1369.7775","0.0178071075","5968083.054375094","77.58507970687374"
"3979","6244","6236","2","6238","28135","1368.46125","0.01778999625","5969451.515625094","77.60286970312374"
"3980","6238","6230","8","6238","28143","1368.46125","0.01778999625","5970819.976875094","77.62065969937375"
"3981","6238","6235","4","6239","28147","1368.680625","0.017792848125","5972188.657500094","77.63845254749874"
"3982","6239","6232","7","6239","28154","1368.680625","0.017792848125","5973557.338125094","77.65624539562374"
"3983","6239","6232","6","6238","28160","1368.46125","0.01778999625","5974925.799375094","77.67403539187374"
"3984","6238","6234","9","6243","28169","1369.5581250000002","0.017804255625","5976295.357500094","77.69183964749874"
"3985","6243","6242","2","6244","28171","1369.7775","0.0178071075","5977665.135000094","77.70964675499874"
"3986","6244","6237","4","6241","28175","1369.119375","0.017798551875","5979034.254375094","77.72744530687375"
"3987","6241","6240","5","6245","28180","1369.996875","0.017809959375","5980404.251250094","77.74525526624875"
"3988","6245","6240","5","6245","28185","1369.996875","0.017809959375","5981774.248125094","77.76306522562375"
"3989","6245","6241","5","6246","28190","1370.2162500000002","0.01781281125","5983144.464375094","77.78087803687374"
"3990","6246","6243","5","6248","28195","1370.6550000000002","0.017818515","5984515.119375094","77.79869655187375"
"3991","6248","6245","4","6249","28199","1370.8743749999999","0.017821366874999998","5985885.9937500935","77.81651791874874"
"3992","6249","6246","2","6248","28201","1370.6550000000002","0.017818515","5987256.648750094","77.83433643374875"
"3993","6248","6247","8","6255","28209","1372.190625","0.017838478124999998","5988628.839375094","77.85217491187375"
"3994","6255","6248","3","6251","28212","1371.3131250000001","0.017827070625","5990000.152500094","77.87000198249875"
"3995","6251","6248","9","6257","28221","1372.6293749999998","0.017844181874999997","5991372.7818750935","77.88784616437376"
"3996","6257","6253","6","6259","28227","1373.068125","0.017849885625","5992745.850000094","77.90569604999875"
"3997","6259","6253","8","6261","28235","1373.506875","0.017855589374999998","5994119.356875094","77.92355163937376"
"3998","6261","6254","8","6262","28243","1373.72625","0.01785844125","5995493.083125094","77.94141008062375"
"3999","6262","6256","6","6262","28249","1373.72625","0.01785844125","5996866.809375094","77.95926852187375"
"4000","6262","6258","9","6267","28258","1374.823125","0.017872700624999998","5998241.632500094","77.97714122249876"
"4001","6267","6263","2","6265","28260","1374.384375","0.017866996875","5999616.016875095","77.99500821937376"
"4002","6265","6259","1","6260","28261","1373.2875","0.017852737499999997","6000989.304375094","78.01286095687375"
"4003","6260","6255","4","6259","28265","1373.068125","0.017849885625","6002362.372500095","78.03071084249875"
"4004","6259","6255","3","6258","28268","1372.84875","0.01784703375","6003735.2212500945","78.04855787624875"
"4005","6258","6256","3","6259","28271","1373.068125","0.017849885625","6005108.289375095","78.06640776187375"
"4006","6259","6251","6","6257","28277","1372.6293749999998","0.017844181874999997","6006480.918750094","78.08425194374875"
"4007","6257","6248","8","6256","28285","1372.41","0.01784133","6007853.328750094","78.10209327374875"
"4008","6256","6253","5","6258","28290","1372.84875","0.01784703375","6009226.177500094","78.11994030749875"
"4009","6258","6254","4","6258","28294","1372.84875","0.01784703375","6010599.026250094","78.13778734124875"
"4010","6258","6254","4","6258","28298","1372.84875","0.01784703375","6011971.875000094","78.15563437499875"
"4011","6258","6256","1","6257","28299","1372.6293749999998","0.017844181874999997","6013344.504375094","78.17347855687376"
"4012","6257","6249","8","6257","28307","1372.6293749999998","0.017844181874999997","6014717.133750093","78.19132273874877"
"4013","6257","6248","6","6254","28313","1371.9712499999998","0.017835626249999997","6016089.105000094","78.20915836499877"
"4014","6254","6252","1","6253","28314","1371.7518750000002","0.017832774375000002","6017460.856875094","78.22699113937377"
"4015","6253","6248","2","6250","28316","1371.09375","0.01782421875","6018831.950625094","78.24481535812376"
"4016","6250","6243","5","6248","28321","1370.6550000000002","0.017818515","6020202.605625094","78.26263387312376"
"4017","6248","6242","1","6243","28322","1369.5581250000002","0.017804255625","6021572.163750094","78.28043812874876"
"4018","6243","6238","2","6240","28324","1368.9","0.0177957","6022941.063750095","78.29823382874875"
"4019","6240","6235","8","6243","28332","1369.5581250000002","0.017804255625","6024310.621875095","78.31603808437374"
"4020","6243","6241","9","6250","28341","1371.09375","0.01782421875","6025681.715625095","78.33386230312374"
"4021","6250","6244","9","6253","28350","1371.7518750000002","0.017832774375000002","6027053.467500095","78.35169507749873"
"4022","6253","6248","1","6249","28351","1370.8743749999999","0.017821366874999998","6028424.341875095","78.36951644437373"
"4023","6249","6240","2","6242","28353","1369.33875","0.017801403749999997","6029793.680625095","78.38731784812373"
"4024","6242","6241","5","6246","28358","1370.2162500000002","0.01781281125","6031163.896875095","78.40513065937373"
"4025","6246","6243","9","6252","28367","1371.5324999999998","0.017829922499999998","6032535.429375094","78.42296058187372"
"4026","6252","6250","8","6258","28375","1372.84875","0.01784703375","6033908.278125094","78.44080761562373"
"4027","6258","6254","3","6257","28378","1372.6293749999998","0.017844181874999997","6035280.907500094","78.45865179749873"
"4028","6257","6253","3","6256","28381","1372.41","0.01784133","6036653.317500094","78.47649312749873"
"4029","6256","6253","1","6254","28382","1371.9712499999998","0.017835626249999997","6038025.288750094","78.49432875374873"
"4030","6254","6247","6","6253","28388","1371.7518750000002","0.017832774375000002","6039397.040625094","78.51216152812373"
"4031","6253","6249","2","6251","28390","1371.3131250000001","0.017827070625","6040768.353750095","78.52998859874873"
"4032","6251","6250","1","6251","28391","1371.3131250000001","0.017827070625","6042139.666875095","78.54781566937373"
"4033","6251","6248","4","6252","28395","1371.5324999999998","0.017829922499999998","6043511.199375095","78.56564559187373"
"4034","6252","6251","2","6253","28397","1371.7518750000002","0.017832774375000002","6044882.951250095","78.58347836624873"
"4035","6253","6252","5","6257","28402","1372.6293749999998","0.017844181874999997","6046255.5806250945","78.60132254812373"
"4036","6257","6253","8","6261","28410","1373.506875","0.017855589374999998","6047629.087500094","78.61917813749874"
"4037","6261","6255","6","6261","28416","1373.506875","0.017855589374999998","6049002.594375094","78.63703372687374"
"4038","6261","6260","3","6263","28419","1373.945625","0.017861293125","6050376.540000094","78.65489501999873"
"4039","6263","6262","1","6263","28420","1373.945625","0.017861293125","6051750.485625094","78.67275631312373"
"4040","6263","6254","2","6256","28422","1372.41","0.01784133","6053122.895625094","78.69059764312372"
"4041","6256","6248","6","6254","28428","1371.9712499999998","0.017835626249999997","6054494.866875094","78.70843326937373"
"4042","6254","6246","4","6250","28432","1371.09375","0.01782421875","6055865.960625094","78.72625748812372"
"4043","6250","6247","6","6253","28438","1371.7518750000002","0.017832774375000002","6057237.712500094","78.74409026249872"
"4044","6253","6247","4","6251","28442","1371.3131250000001","0.017827070625","6058609.025625095","78.76191733312372"
"4045","6251","6245","9","6254","28451","1371.9712499999998","0.017835626249999997","6059980.996875095","78.77975295937372"
"4046","6254","6249","3","6252","28454","1371.5324999999998","0.017829922499999998","6061352.529375095","78.79758288187372"
"4047","6252","6250","9","6259","28463","1373.068125","0.017849885625","6062725.597500095","78.81543276749872"
"4048","6259","6257","1","6258","28464","1372.84875","0.01784703375","6064098.446250095","78.83327980124872"
"4049","6258","6250","3","6253","28467","1371.7518750000002","0.017832774375000002","6065470.198125095","78.85111257562372"
"4050","6253","6250","8","6258","28475","1372.84875","0.01784703375","6066843.046875095","78.86895960937372"
"4051","6258","6253","4","6257","28479","1372.6293749999998","0.017844181874999997","6068215.676250095","78.88680379124872"
"4052","6257","6249","3","6252","28482","1371.5324999999998","0.017829922499999998","6069587.208750094","78.90463371374872"
"4053","6252","6243","5","6248","28487","1370.6550000000002","0.017818515","6070957.863750095","78.92245222874872"
"4054","6248","6246","9","6255","28496","1372.190625","0.017838478124999998","6072330.054375094","78.94029070687372"
"4055","6255","6251","9","6260","28505","1373.2875","0.017852737499999997","6073703.341875094","78.95814344437372"
"4056","6260","6256","9","6265","28514","1374.384375","0.017866996875","6075077.726250094","78.97601044124872"
"4057","6265","6262","4","6266","28518","1374.60375","0.01786984875","6076452.330000094","78.99388028999871"
"4058","6266","6259","8","6267","28526","1374.823125","0.017872700624999998","6077827.153125094","79.01175299062372"
"4059","6267","6265","6","6271","28532","1375.7006250000002","0.017884108125000003","6079202.853750094","79.02963709874872"
"4060","6271","6265","2","6267","28534","1374.823125","0.017872700624999998","6080577.676875094","79.04750979937373"
"4061","6267","6260","8","6268","28542","1375.0425000000002","0.017875552500000003","6081952.719375094","79.06538535187373"
"4062","6268","6263","9","6272","28551","1375.9199999999998","0.017886959999999997","6083328.639375094","79.08327231187373"
"4063","6272","6269","9","6278","28560","1377.2362500000002","0.01790407125","6084705.875625094","79.10117638312373"
"4064","6278","6273","3","6276","28563","1376.7975000000001","0.0178983675","6086082.673125095","79.11907475062372"
"4065","6276","6267","2","6269","28565","1375.261875","0.017878404374999997","6087457.935000095","79.13695315499872"
"4066","6269","6264","1","6265","28566","1374.384375","0.017866996875","6088832.319375095","79.15482015187372"
"4067","6265","6263","1","6264","28567","1374.165","0.017864144999999998","6090206.484375095","79.17268429687373"
"4068","6264","6261","9","6270","28576","1375.48125","0.017881256249999998","6091581.965625095","79.19056555312373"
"4069","6270","6267","3","6270","28579","1375.48125","0.017881256249999998","6092957.446875095","79.20844680937374"
"4070","6270","6264","3","6267","28582","1374.823125","0.017872700624999998","6094332.2700000955","79.22631950999875"
"4071","6267","6260","9","6269","28591","1375.261875","0.017878404374999997","6095707.531875095","79.24419791437374"
"4072","6269","6260","2","6262","28593","1373.72625","0.01785844125","6097081.258125096","79.26205635562374"
"4073","6262","6259","1","6260","28594","1373.2875","0.017852737499999997","6098454.545625095","79.27990909312373"
"4074","6260","6253","5","6258","28599","1372.84875","0.01784703375","6099827.394375095","79.29775612687374"
"4075","6258","6249","3","6252","28602","1371.5324999999998","0.017829922499999998","6101198.926875095","79.31558604937374"
"4076","6252","6248","2","6250","28604","1371.09375","0.01782421875","6102570.020625095","79.33341026812373"
"4077","6250","6247","1","6248","28605","1370.6550000000002","0.017818515","6103940.675625095","79.35122878312373"
"4078","6248","6239","4","6243","28609","1369.5581250000002","0.017804255625","6105310.233750096","79.36903303874873"
"4079","6243","6241","9","6250","28618","1371.09375","0.01782421875","6106681.327500096","79.38685725749872"
"4080","6250","6248","5","6253","28623","1371.7518750000002","0.017832774375000002","6108053.079375096","79.40469003187371"
"4081","6253","6245","1","6246","28624","1370.2162500000002","0.01781281125","6109423.295625095","79.42250284312371"
"4082","6246","6238","9","6247","28633","1370.4356249999998","0.017815663124999995","6110793.731250095","79.44031850624872"
"4083","6247","6243","9","6252","28642","1371.5324999999998","0.017829922499999998","6112165.263750095","79.45814842874871"
"4084","6252","6251","9","6260","28651","1373.2875","0.017852737499999997","6113538.551250095","79.47600116624871"
"4085","6260","6258","2","6260","28653","1373.2875","0.017852737499999997","6114911.838750094","79.4938539037487"
"4086","6260","6255","9","6264","28662","1374.165","0.017864144999999998","6116286.003750094","79.5117180487487"
"4087","6264","6262","5","6267","28667","1374.823125","0.017872700624999998","6117660.826875094","79.52959074937371"
"4088","6267","6266","5","6271","28672","1375.7006250000002","0.017884108125000003","6119036.527500094","79.54747485749871"
"4089","6271","6268","2","6270","28674","1375.48125","0.017881256249999998","6120412.008750094","79.56535611374872"
"4090","6270","6269","9","6278","28683","1377.2362500000002","0.01790407125","6121789.245000094","79.58326018499872"
"4091","6278","6269","5","6274","28688","1376.3587499999999","0.017892663749999996","6123165.603750094","79.60115284874873"
"4092","6274","6270","7","6277","28695","1377.0168749999998","0.017901219374999996","6124542.620625094","79.61905406812373"
"4093","6277","6273","8","6281","28703","1377.894375","0.017912626875","6125920.515000094","79.63696669499873"
"4094","6281","6273","1","6274","28704","1376.3587499999999","0.017892663749999996","6127296.873750093","79.65485935874874"
"4095","6274","6271","6","6277","28710","1377.0168749999998","0.017901219374999996","6128673.890625093","79.67276057812374"
"4096","6277","6273","4","6277","28714","1377.0168749999998","0.017901219374999996","6130050.907500093","79.69066179749875"
"4097","6277","6275","4","6279","28718","1377.4556249999998","0.017906923124999998","6131428.363125093","79.70856872062375"
"4098","6279","6277","6","6283","28724","1378.333125","0.017918330625","6132806.696250093","79.72648705124874"
"4099","6283","6274","2","6276","28726","1376.7975000000001","0.0178983675","6134183.4937500935","79.74438541874873"
"4100","6276","6271","2","6273","28728","1376.1393750000002","0.017889811875","6135559.633125094","79.76227523062373"
"4101","6273","6267","8","6275","28736","1376.578125","0.017895515625","6136936.211250094","79.78017074624873"
"4102","6275","6273","4","6277","28740","1377.0168749999998","0.017901219374999996","6138313.2281250935","79.79807196562373"
"4103","6277","6270","5","6275","28745","1376.578125","0.017895515625","6139689.8062500935","79.81596748124873"
"4104","6275","6272","2","6274","28747","1376.3587499999999","0.017892663749999996","6141066.165000093","79.83386014499874"
"4105","6274","6268","1","6269","28748","1375.261875","0.017878404374999997","6142441.426875093","79.85173854937374"
"4106","6269","6264","9","6273","28757","1376.1393750000002","0.017889811875","6143817.566250093","79.86962836124873"
"4107","6273","6270","2","6272","28759","1375.9199999999998","0.017886959999999997","6145193.486250093","79.88751532124873"
"4108","6272","6269","7","6276","28766","1376.7975000000001","0.0178983675","6146570.283750094","79.90541368874872"
"4109","6276","6268","2","6270","28768","1375.48125","0.017881256249999998","6147945.765000094","79.92329494499873"
"4110","6270","6266","9","6275","28777","1376.578125","0.017895515625","6149322.343125094","79.94119046062373"
"4111","6275","6272","6","6278","28783","1377.2362500000002","0.01790407125","6150699.579375094","79.95909453187373"
"4112","6278","6274","6","6280","28789","1377.675","0.017909775","6152077.254375094","79.97700430687374"
"4113","6280","6279","6","6285","28795","1378.771875","0.017924034374999998","6153456.026250093","79.99492834124874"
"4114","6285","6279","5","6284","28800","1378.5525","0.0179211825","6154834.5787500935","80.01284952374874"
"4115","6284","6277","2","6279","28802","1377.4556249999998","0.017906923124999998","6156212.034375094","80.03075644687374"
"4116","6279","6277","4","6281","28806","1377.894375","0.017912626875","6157589.928750094","80.04866907374874"
"4117","6281","6274","1","6275","28807","1376.578125","0.017895515625","6158966.506875094","80.06656458937374"
"4118","6275","6271","3","6274","28810","1376.3587499999999","0.017892663749999996","6160342.865625094","80.08445725312374"
"4119","6274","6272","2","6274","28812","1376.3587499999999","0.017892663749999996","6161719.224375093","80.10234991687375"
"4120","6274","6269","1","6270","28813","1375.48125","0.017881256249999998","6163094.705625094","80.12023117312376"
"4121","6270","6263","6","6269","28819","1375.261875","0.017878404374999997","6164469.967500093","80.13810957749875"
"4122","6269","6266","2","6268","28821","1375.0425000000002","0.017875552500000003","6165845.010000094","80.15598512999875"
"4123","6268","6261","8","6269","28829","1375.261875","0.017878404374999997","6167220.271875094","80.17386353437375"
"4124","6269","6265","6","6271","28835","1375.7006250000002","0.017884108125000003","6168595.972500093","80.19174764249875"
"4125","6271","6269","8","6277","28843","1377.0168749999998","0.017901219374999996","6169972.989375093","80.20964886187376"
"4126","6277","6276","6","6282","28849","1378.1137499999998","0.017915478749999995","6171351.103125093","80.22756434062376"
"4127","6282","6277","1","6278","28850","1377.2362500000002","0.01790407125","6172728.339375093","80.24546841187376"
"4128","6278","6272","6","6278","28856","1377.2362500000002","0.01790407125","6174105.575625093","80.26337248312376"
"4129","6278","6269","3","6272","28859","1375.9199999999998","0.017886959999999997","6175481.495625093","80.28125944312376"
"4130","6272","6263","6","6269","28865","1375.261875","0.017878404374999997","6176856.7575000925","80.29913784749876"
"4131","6269","6268","8","6276","28873","1376.7975000000001","0.0178983675","6178233.555000093","80.31703621499875"
"4132","6276","6267","8","6275","28881","1376.578125","0.017895515625","6179610.133125093","80.33493173062375"
"4133","6275","6268","1","6269","28882","1375.261875","0.017878404374999997","6180985.395000093","80.35281013499875"
"4134","6269","6268","8","6276","28890","1376.7975000000001","0.0178983675","6182362.192500093","80.37070850249874"
"4135","6276","6270","1","6271","28891","1375.7006250000002","0.017884108125000003","6183737.893125093","80.38859261062375"
"4136","6271","6270","6","6276","28897","1376.7975000000001","0.0178983675","6185114.690625093","80.40649097812374"
"4137","6276","6275","6","6281","28903","1377.894375","0.017912626875","6186492.585000093","80.42440360499874"
"4138","6281","6276","6","6282","28909","1378.1137499999998","0.017915478749999995","6187870.698750093","80.44231908374874"
"4139","6282","6274","6","6280","28915","1377.675","0.017909775","6189248.373750092","80.46022885874875"
"4140","6280","6277","1","6278","28916","1377.2362500000002","0.01790407125","6190625.610000093","80.47813292999875"
"4141","6278","6272","5","6277","28921","1377.0168749999998","0.017901219374999996","6192002.626875092","80.49603414937376"
"4142","6277","6271","3","6274","28924","1376.3587499999999","0.017892663749999996","6193378.985625092","80.51392681312376"
"4143","6274","6267","6","6273","28930","1376.1393750000002","0.017889811875","6194755.125000092","80.53181662499875"
"4144","6273","6268","8","6276","28938","1376.7975000000001","0.0178983675","6196131.922500093","80.54971499249875"
"4145","6276","6272","7","6279","28945","1377.4556249999998","0.017906923124999998","6197509.378125093","80.56762191562375"
"4146","6279","6271","7","6278","28952","1377.2362500000002","0.01790407125","6198886.614375093","80.58552598687375"
"4147","6278","6273","7","6280","28959","1377.675","0.017909775","6200264.289375093","80.60343576187375"
"4148","6280","6271","1","6272","28960","1375.9199999999998","0.017886959999999997","6201640.209375093","80.62132272187375"
"4149","6272","6269","7","6276","28967","1376.7975000000001","0.0178983675","6203017.006875093","80.63922108937375"
"4150","6276","6270","3","6273","28970","1376.1393750000002","0.017889811875","6204393.146250093","80.65711090124874"
"4151","6273","6267","6","6273","28976","1376.1393750000002","0.017889811875","6205769.285625094","80.67500071312374"
"4152","6273","6271","1","6272","28977","1375.9199999999998","0.017886959999999997","6207145.205625094","80.69288767312374"
"4153","6272","6271","9","6280","28986","1377.675","0.017909775","6208522.880625093","80.71079744812374"
"4154","6280","6278","3","6281","28989","1377.894375","0.017912626875","6209900.7750000935","80.72871007499874"
"4155","6281","6277","6","6283","28995","1378.333125","0.017918330625","6211279.108125093","80.74662840562374"
"4156","6283","6278","9","6287","29004","1379.210625","0.017929738124999997","6212658.318750094","80.76455814374874"
"4157","6287","6281","4","6285","29008","1378.771875","0.017924034374999998","6214037.090625093","80.78248217812374"
"4158","6285","6276","9","6285","29017","1378.771875","0.017924034374999998","6215415.862500093","80.80040621249874"
"4159","6285","6277","2","6279","29019","1377.4556249999998","0.017906923124999998","6216793.318125093","80.81831313562374"
"4160","6279","6272","8","6280","29027","1377.675","0.017909775","6218170.993125093","80.83622291062375"
"4161","6280","6273","8","6281","29035","1377.894375","0.017912626875","6219548.887500093","80.85413553749875"
"4162","6281","6274","6","6280","29041","1377.675","0.017909775","6220926.562500093","80.87204531249876"
"4163","6280","6271","1","6272","29042","1375.9199999999998","0.017886959999999997","6222302.482500093","80.88993227249875"
"4164","6272","6264","5","6269","29047","1375.261875","0.017878404374999997","6223677.744375093","80.90781067687375"
"4165","6269","6264","3","6267","29050","1374.823125","0.017872700624999998","6225052.567500093","80.92568337749876"
"4166","6267","6260","9","6269","29059","1375.261875","0.017878404374999997","6226427.829375093","80.94356178187375"
"4167","6269","6260","6","6266","29065","1374.60375","0.01786984875","6227802.433125093","80.96143163062375"
"4168","6266","6263","4","6267","29069","1374.823125","0.017872700624999998","6229177.256250093","80.97930433124876"
"4169","6267","6259","5","6264","29074","1374.165","0.017864144999999998","6230551.421250093","80.99716847624876"
"4170","6264","6256","5","6261","29079","1373.506875","0.017855589374999998","6231924.928125093","81.01502406562376"
"4171","6261","6259","1","6260","29080","1373.2875","0.017852737499999997","6233298.215625092","81.03287680312376"
"4172","6260","6256","5","6261","29085","1373.506875","0.017855589374999998","6234671.722500092","81.05073239249876"
"4173","6261","6253","1","6254","29086","1371.9712499999998","0.017835626249999997","6236043.693750093","81.06856801874876"
"4174","6254","6253","5","6258","29091","1372.84875","0.01784703375","6237416.542500093","81.08641505249877"
"4175","6258","6255","3","6258","29094","1372.84875","0.01784703375","6238789.391250093","81.10426208624877"
"4176","6258","6254","8","6262","29102","1373.72625","0.01785844125","6240163.117500093","81.12212052749877"
"4177","6262","6261","9","6270","29111","1375.48125","0.017881256249999998","6241538.598750093","81.14000178374877"
"4178","6270","6268","9","6277","29120","1377.0168749999998","0.017901219374999996","6242915.615625093","81.15790300312378"
"4179","6277","6271","3","6274","29123","1376.3587499999999","0.017892663749999996","6244291.974375092","81.17579566687378"
"4180","6274","6265","3","6268","29126","1375.0425000000002","0.017875552500000003","6245667.016875093","81.19367121937378"
"4181","6268","6267","5","6272","29131","1375.9199999999998","0.017886959999999997","6247042.936875093","81.21155817937378"
"4182","6272","6270","3","6273","29134","1376.1393750000002","0.017889811875","6248419.076250093","81.22944799124878"
"4183","6273","6270","5","6275","29139","1376.578125","0.017895515625","6249795.654375093","81.24734350687378"
"4184","6275","6271","3","6274","29142","1376.3587499999999","0.017892663749999996","6251172.013125093","81.26523617062378"
"4185","6274","6272","1","6273","29143","1376.1393750000002","0.017889811875","6252548.152500093","81.28312598249877"
"4186","6273","6267","1","6268","29144","1375.0425000000002","0.017875552500000003","6253923.195000093","81.30100153499878"
"4187","6268","6263","7","6270","29151","1375.48125","0.017881256249999998","6255298.676250094","81.31888279124878"
"4188","6270","6261","3","6264","29154","1374.165","0.017864144999999998","6256672.841250094","81.33674693624879"
"4189","6264","6255","4","6259","29158","1373.068125","0.017849885625","6258045.909375094","81.35459682187378"
"4190","6259","6251","3","6254","29161","1371.9712499999998","0.017835626249999997","6259417.880625094","81.37243244812379"
"4191","6254","6250","8","6258","29169","1372.84875","0.01784703375","6260790.729375094","81.39027948187379"
"4192","6258","6254","3","6257","29172","1372.6293749999998","0.017844181874999997","6262163.358750094","81.4081236637488"
"4193","6257","6255","8","6263","29180","1373.945625","0.017861293125","6263537.304375093","81.42598495687379"
"4194","6263","6260","3","6263","29183","1373.945625","0.017861293125","6264911.250000093","81.44384624999878"
"4195","6263","6262","2","6264","29185","1374.165","0.017864144999999998","6266285.415000093","81.46171039499879"
"4196","6264","6257","2","6259","29187","1373.068125","0.017849885625","6267658.483125093","81.47956028062379"
"4197","6259","6257","1","6258","29188","1372.84875","0.01784703375","6269031.331875093","81.49740731437379"
"4198","6258","6254","9","6263","29197","1373.945625","0.017861293125","6270405.277500093","81.51526860749878"
"4199","6263","6261","2","6263","29199","1373.945625","0.017861293125","6271779.223125093","81.53312990062378"
"4200","6263","6260","4","6264","29203","1374.165","0.017864144999999998","6273153.388125093","81.55099404562378"
"4201","6264","6262","4","6266","29207","1374.60375","0.01786984875","6274527.9918750925","81.56886389437378"
"4202","6266","6262","1","6263","29208","1373.945625","0.017861293125","6275901.937500092","81.58672518749877"
"4203","6263","6258","4","6262","29212","1373.72625","0.01785844125","6277275.6637500925","81.60458362874877"
"4204","6262","6261","4","6265","29216","1374.384375","0.017866996875","6278650.048125093","81.62245062562377"
"4205","6265","6257","7","6264","29223","1374.165","0.017864144999999998","6280024.213125093","81.64031477062377"
"4206","6264","6261","5","6266","29228","1374.60375","0.01786984875","6281398.816875093","81.65818461937377"
"4207","6266","6264","6","6270","29234","1375.48125","0.017881256249999998","6282774.298125093","81.67606587562378"
"4208","6270","6264","5","6269","29239","1375.261875","0.017878404374999997","6284149.560000093","81.69394427999877"
"4209","6269","6263","1","6264","29240","1374.165","0.017864144999999998","6285523.725000093","81.71180842499878"
"4210","6264","6262","3","6265","29243","1374.384375","0.017866996875","6286898.109375093","81.72967542187378"
"4211","6265","6264","3","6267","29246","1374.823125","0.017872700624999998","6288272.932500093","81.74754812249878"
"4212","6267","6264","8","6272","29254","1375.9199999999998","0.017886959999999997","6289648.852500093","81.76543508249878"
"4213","6272","6269","8","6277","29262","1377.0168749999998","0.017901219374999996","6291025.869375093","81.78333630187379"
"4214","6277","6273","7","6280","29269","1377.675","0.017909775","6292403.544375093","81.8012460768738"
"4215","6280","6275","4","6279","29273","1377.4556249999998","0.017906923124999998","6293781.000000093","81.81915299999879"
"4216","6279","6277","6","6283","29279","1378.333125","0.017918330625","6295159.333125093","81.83707133062379"
"4217","6283","6277","9","6286","29288","1378.99125","0.01792688625","6296538.324375093","81.85499821687378"
"4218","6286","6279","4","6283","29292","1378.333125","0.017918330625","6297916.657500093","81.87291654749878"
"4219","6283","6276","4","6280","29296","1377.675","0.017909775","6299294.332500093","81.89082632249878"
"4220","6280","6278","7","6285","29303","1378.771875","0.017924034374999998","6300673.104375092","81.90875035687378"
"4221","6285","6283","5","6288","29308","1379.43","0.017932589999999998","6302052.534375092","81.92668294687378"
"4222","6288","6280","2","6282","29310","1378.1137499999998","0.017915478749999995","6303430.648125092","81.94459842562378"
"4223","6282","6274","5","6279","29315","1377.4556249999998","0.017906923124999998","6304808.103750092","81.96250534874878"
"4224","6279","6275","9","6284","29324","1378.5525","0.0179211825","6306186.656250092","81.98042653124878"
"4225","6284","6277","5","6282","29329","1378.1137499999998","0.017915478749999995","6307564.770000092","81.99834200999878"
"4226","6282","6277","8","6285","29337","1378.771875","0.017924034374999998","6308943.541875091","82.01626604437378"
"4227","6285","6279","6","6285","29343","1378.771875","0.017924034374999998","6310322.313750091","82.03419007874878"
"4228","6285","6277","3","6280","29346","1377.675","0.017909775","6311699.988750091","82.05209985374879"
"4229","6280","6278","8","6286","29354","1378.99125","0.01792688625","6313078.980000091","82.07002673999878"
"4230","6286","6279","6","6285","29360","1378.771875","0.017924034374999998","6314457.75187509","82.08795077437378"
"4231","6285","6284","7","6291","29367","1380.088125","0.017941145625","6315837.84000009","82.10589191999878"
"4232","6291","6287","9","6296","29376","1381.1850000000002","0.017955405","6317219.02500009","82.12384732499878"
"4233","6296","6289","3","6292","29379","1380.3075","0.017943997499999996","6318599.33250009","82.14179132249878"
"4234","6292","6284","2","6286","29381","1378.99125","0.01792688625","6319978.32375009","82.15971820874877"
"4235","6286","6283","5","6288","29386","1379.43","0.017932589999999998","6321357.75375009","82.17765079874877"
"4236","6288","6285","9","6294","29395","1380.74625","0.01794970125","6322738.500000089","82.19560049999878"
"4237","6294","6291","9","6300","29404","1382.0625","0.0179668125","6324120.562500089","82.21356731249878"
"4238","6300","6295","4","6299","29408","1381.8431249999999","0.017963960624999997","6325502.405625089","82.23153127312378"
"4239","6299","6290","6","6296","29414","1381.1850000000002","0.017955405","6326883.590625089","82.24948667812377"
"4240","6296","6293","8","6301","29422","1382.2818750000001","0.017969664375","6328265.872500089","82.26745634249878"
"4241","6301","6298","2","6300","29424","1382.0625","0.0179668125","6329647.935000089","82.28542315499878"
"4242","6300","6298","3","6301","29427","1382.2818750000001","0.017969664375","6331030.216875089","82.30339281937378"
"4243","6301","6296","9","6305","29436","1383.159375","0.017981071874999997","6332413.376250089","82.32137389124878"
"4244","6305","6296","6","6302","29442","1382.5012499999998","0.017972516249999997","6333795.877500089","82.33934640749878"
"4245","6302","6299","4","6303","29446","1382.7206250000002","0.017975368125000002","6335178.598125089","82.35732177562377"
"4246","6303","6294","1","6295","29447","1380.965625","0.017952553125","6336559.563750089","82.37527432874877"
"4247","6295","6294","3","6297","29450","1381.4043749999998","0.017958256875","6337940.968125089","82.39323258562378"
"4248","6297","6291","6","6297","29456","1381.4043749999998","0.017958256875","6339322.372500089","82.41119084249878"
"4249","6297","6292","3","6295","29459","1380.965625","0.017952553125","6340703.338125089","82.42914339562378"
"4250","6295","6289","8","6297","29467","1381.4043749999998","0.017958256875","6342084.742500089","82.44710165249879"
"4251","6297","6293","5","6298","29472","1381.6237500000002","0.017961108750000003","6343466.366250089","82.46506276124879"
"4252","6298","6296","6","6302","29478","1382.5012499999998","0.017972516249999997","6344848.867500089","82.48303527749879"
"4253","6302","6296","1","6297","29479","1381.4043749999998","0.017958256875","6346230.271875089","82.50099353437379"
"4254","6297","6290","7","6297","29486","1381.4043749999998","0.017958256875","6347611.676250089","82.5189517912488"
"4255","6297","6291","1","6292","29487","1380.3075","0.017943997499999996","6348991.983750089","82.5368957887488"
"4256","6292","6288","1","6289","29488","1379.649375","0.017935441875","6350371.633125089","82.55483123062379"
"4257","6289","6281","5","6286","29493","1378.99125","0.01792688625","6351750.624375089","82.57275811687379"
"4258","6286","6285","1","6286","29494","1378.99125","0.01792688625","6353129.615625089","82.59068500312378"
"4259","6286","6277","9","6286","29503","1378.99125","0.01792688625","6354508.606875089","82.60861188937378"
"4260","6286","6279","3","6282","29506","1378.1137499999998","0.017915478749999995","6355886.720625089","82.62652736812377"
"4261","6282","6277","4","6281","29510","1377.894375","0.017912626875","6357264.615000089","82.64443999499878"
"4262","6281","6272","3","6275","29513","1376.578125","0.017895515625","6358641.193125089","82.66233551062378"
"4263","6275","6267","9","6276","29522","1376.7975000000001","0.0178983675","6360017.990625089","82.68023387812377"
"4264","6276","6273","9","6282","29531","1378.1137499999998","0.017915478749999995","6361396.104375089","82.69814935687377"
"4265","6282","6281","9","6290","29540","1379.86875","0.01793829375","6362775.973125089","82.71608765062378"
"4266","6290","6289","9","6298","29549","1381.6237500000002","0.017961108750000003","6364157.596875089","82.73404875937378"
"4267","6298","6292","5","6297","29554","1381.4043749999998","0.017958256875","6365539.001250089","82.75200701624878"
"4268","6297","6291","1","6292","29555","1380.3075","0.017943997499999996","6366919.308750089","82.76995101374878"
"4269","6292","6283","1","6284","29556","1378.5525","0.0179211825","6368297.8612500895","82.78787219624878"
"4270","6284","6283","5","6288","29561","1379.43","0.017932589999999998","6369677.291250089","82.80580478624879"
"4271","6288","6286","5","6291","29566","1380.088125","0.017941145625","6371057.379375089","82.82374593187379"
"4272","6291","6286","4","6290","29570","1379.86875","0.01793829375","6372437.248125089","82.8416842256238"
"4273","6290","6287","2","6289","29572","1379.649375","0.017935441875","6373816.897500089","82.85961966749879"
"4274","6289","6281","1","6282","29573","1378.1137499999998","0.017915478749999995","6375195.011250089","82.87753514624879"
"4275","6282","6277","5","6282","29578","1378.1137499999998","0.017915478749999995","6376573.1250000885","82.89545062499879"
"4276","6282","6276","8","6284","29586","1378.5525","0.0179211825","6377951.677500089","82.91337180749879"
"4277","6284","6275","4","6279","29590","1377.4556249999998","0.017906923124999998","6379329.133125089","82.93127873062379"
"4278","6279","6272","6","6278","29596","1377.2362500000002","0.01790407125","6380706.369375089","82.94918280187379"
"4279","6278","6275","6","6281","29602","1377.894375","0.017912626875","6382084.263750089","82.96709542874879"
"4280","6281","6274","1","6275","29603","1376.578125","0.017895515625","6383460.841875089","82.98499094437379"
"4281","6275","6274","4","6278","29607","1377.2362500000002","0.01790407125","6384838.078125089","83.00289501562379"
"4282","6278","6274","7","6281","29614","1377.894375","0.017912626875","6386215.97250009","83.0208076424988"
"4283","6281","6280","9","6289","29623","1379.649375","0.017935441875","6387595.62187509","83.03874308437379"
"4284","6289","6288","4","6292","29627","1380.3075","0.017943997499999996","6388975.92937509","83.05668708187379"
"4285","6292","6284","6","6290","29633","1379.86875","0.01793829375","6390355.79812509","83.0746253756238"
"4286","6290","6289","5","6294","29638","1380.74625","0.01794970125","6391736.54437509","83.0925750768738"
"4287","6294","6290","5","6295","29643","1380.965625","0.017952553125","6393117.51000009","83.1105276299988"
"4288","6295","6293","1","6294","29644","1380.74625","0.01794970125","6394498.25625009","83.1284773312488"
"4289","6294","6287","3","6290","29647","1379.86875","0.01793829375","6395878.12500009","83.14641562499881"
"4290","6290","6283","9","6292","29656","1380.3075","0.017943997499999996","6397258.43250009","83.16435962249881"
"4291","6292","6290","9","6299","29665","1381.8431249999999","0.017963960624999997","6398640.27562509","83.1823235831238"
"4292","6299","6293","8","6301","29673","1382.2818750000001","0.017969664375","6400022.55750009","83.2002932474988"
"4293","6301","6293","4","6297","29677","1381.4043749999998","0.017958256875","6401403.96187509","83.21825150437381"
"4294","6297","6289","6","6295","29683","1380.965625","0.017952553125","6402784.927500091","83.23620405749881"
"4295","6295","6291","2","6293","29685","1380.5268750000002","0.017946849375","6404165.454375091","83.2541509068738"
"4296","6293","6288","6","6294","29691","1380.74625","0.01794970125","6405546.200625091","83.27210060812381"
"4297","6294","6291","9","6300","29700","1382.0625","0.0179668125","6406928.263125091","83.29006742062381"
"4298","6300","6297","4","6301","29704","1382.2818750000001","0.017969664375","6408310.545000091","83.30803708499882"
"4299","6301","6295","4","6299","29708","1381.8431249999999","0.017963960624999997","6409692.388125091","83.32600104562381"
"4300","6299","6294","2","6296","29710","1381.1850000000002","0.017955405","6411073.57312509","83.3439564506238"
"4301","6296","6288","8","6296","29718","1381.1850000000002","0.017955405","6412454.75812509","83.3619118556238"
"4302","6296","6294","1","6295","29719","1380.965625","0.017952553125","6413835.72375009","83.3798644087488"
"4303","6295","6290","3","6293","29722","1380.5268750000002","0.017946849375","6415216.250625091","83.3978112581238"
"4304","6293","6290","2","6292","29724","1380.3075","0.017943997499999996","6416596.558125091","83.4157552556238"
"4305","6292","6284","7","6291","29731","1380.088125","0.017941145625","6417976.646250091","83.4336964012488"
"4306","6291","6290","9","6299","29740","1381.8431249999999","0.017963960624999997","6419358.48937509","83.45166036187379"
"4307","6299","6290","6","6296","29746","1381.1850000000002","0.017955405","6420739.67437509","83.46961576687379"
"4308","6296","6288","4","6292","29750","1380.3075","0.017943997499999996","6422119.98187509","83.48755976437378"
"4309","6292","6287","8","6295","29758","1380.965625","0.017952553125","6423500.94750009","83.50551231749878"
"4310","6295","6294","4","6298","29762","1381.6237500000002","0.017961108750000003","6424882.57125009","83.52347342624878"
"4311","6298","6295","2","6297","29764","1381.4043749999998","0.017958256875","6426263.97562509","83.54143168312379"
"4312","6297","6293","5","6298","29769","1381.6237500000002","0.017961108750000003","6427645.599375091","83.55939279187379"
"4313","6298","6291","6","6297","29775","1381.4043749999998","0.017958256875","6429027.0037500905","83.5773510487488"
"4314","6297","6290","5","6295","29780","1380.965625","0.017952553125","6430407.969375091","83.5953036018738"
"4315","6295","6286","5","6291","29785","1380.088125","0.017941145625","6431788.05750009","83.6132447474988"
"4316","6291","6283","1","6284","29786","1378.5525","0.0179211825","6433166.610000091","83.6311659299988"
"4317","6284","6278","2","6280","29788","1377.675","0.017909775","6434544.2850000905","83.64907570499881"
"4318","6280","6273","6","6279","29794","1377.4556249999998","0.017906923124999998","6435921.740625091","83.6669826281238"
"4319","6279","6272","9","6281","29803","1377.894375","0.017912626875","6437299.635000091","83.6848952549988"
"4320","6281","6274","1","6275","29804","1376.578125","0.017895515625","6438676.213125091","83.7027907706238"
"4321","6275","6267","5","6272","29809","1375.9199999999998","0.017886959999999997","6440052.133125091","83.7206777306238"
"4322","6272","6268","7","6275","29816","1376.578125","0.017895515625","6441428.711250091","83.7385732462488"
"4323","6275","6272","2","6274","29818","1376.3587499999999","0.017892663749999996","6442805.070000091","83.75646590999881"
"4324","6274","6272","3","6275","29821","1376.578125","0.017895515625","6444181.648125091","83.77436142562381"
"4325","6275","6274","5","6279","29826","1377.4556249999998","0.017906923124999998","6445559.103750091","83.7922683487488"
"4326","6279","6272","2","6274","29828","1376.3587499999999","0.017892663749999996","6446935.462500091","83.81016101249881"
"4327","6274","6270","9","6279","29837","1377.4556249999998","0.017906923124999998","6448312.918125091","83.8280679356238"
"4328","6279","6275","8","6283","29845","1378.333125","0.017918330625","6449691.251250091","83.8459862662488"
"4329","6283","6277","9","6286","29854","1378.99125","0.01792688625","6451070.242500091","83.8639131524988"
"4330","6286","6284","4","6288","29858","1379.43","0.017932589999999998","6452449.672500091","83.8818457424988"
"4331","6288","6284","4","6288","29862","1379.43","0.017932589999999998","6453829.10250009","83.8997783324988"
"4332","6288","6280","5","6285","29867","1378.771875","0.017924034374999998","6455207.87437509","83.9177023668738"
"4333","6285","6282","6","6288","29873","1379.43","0.017932589999999998","6456587.30437509","83.9356349568738"
"4334","6288","6287","1","6288","29874","1379.43","0.017932589999999998","6457966.734375089","83.9535675468738"
"4335","6288","6283","6","6289","29880","1379.649375","0.017935441875","6459346.383750089","83.9715029887488"
"4336","6289","6285","7","6292","29887","1380.3075","0.017943997499999996","6460726.69125009","83.9894469862488"
"4337","6292","6289","8","6297","29895","1381.4043749999998","0.017958256875","6462108.0956250895","84.0074052431238"
"4338","6297","6293","9","6302","29904","1382.5012499999998","0.017972516249999997","6463490.596875089","84.0253777593738"
"4339","6302","6299","6","6305","29910","1383.159375","0.017981071874999997","6464873.756250089","84.0433588312488"
"4340","6305","6298","1","6299","29911","1381.8431249999999","0.017963960624999997","6466255.599375089","84.06132279187379"
"4341","6299","6297","1","6298","29912","1381.6237500000002","0.017961108750000003","6467637.223125089","84.07928390062379"
"4342","6298","6292","8","6300","29920","1382.0625","0.0179668125","6469019.285625089","84.0972507131238"
"4343","6300","6296","4","6300","29924","1382.0625","0.0179668125","6470401.348125089","84.1152175256238"
"4344","6300","6293","4","6297","29928","1381.4043749999998","0.017958256875","6471782.752500089","84.13317578249881"
"4345","6297","6294","6","6300","29934","1382.0625","0.0179668125","6473164.815000089","84.15114259499882"
"4346","6300","6299","9","6308","29943","1383.8175","0.0179896275","6474548.632500089","84.16913222249882"
"4347","6308","6301","9","6310","29952","1384.25625","0.017995331249999996","6475932.888750088","84.18712755374882"
"4348","6310","6308","5","6313","29957","1384.914375","0.018003886875","6477317.803125088","84.20513144062382"
"4349","6313","6312","4","6316","29961","1385.5725","0.0180124425","6478703.375625088","84.22314388312381"
"4350","6316","6307","1","6308","29962","1383.8175","0.0179896275","6480087.193125088","84.24113351062381"
"4351","6308","6303","2","6305","29964","1383.159375","0.017981071874999997","6481470.352500088","84.25911458249881"
"4352","6305","6304","3","6307","29967","1383.5981249999998","0.017986775624999996","6482853.950625087","84.27710135812382"
"4353","6307","6301","1","6302","29968","1382.5012499999998","0.017972516249999997","6484236.451875087","84.29507387437381"
"4354","6302","6293","2","6295","29970","1380.965625","0.017952553125","6485617.417500087","84.31302642749881"
"4355","6295","6289","3","6292","29973","1380.3075","0.017943997499999996","6486997.725000087","84.33097042499881"
"4356","6292","6286","5","6291","29978","1380.088125","0.017941145625","6488377.813125087","84.34891157062381"
"4357","6291","6283","7","6290","29985","1379.86875","0.01793829375","6489757.681875087","84.36684986437382"
"4358","6290","6283","3","6286","29988","1378.99125","0.01792688625","6491136.673125087","84.38477675062381"
"4359","6286","6277","1","6278","29989","1377.2362500000002","0.01790407125","6492513.909375087","84.40268082187382"
"4360","6278","6277","7","6284","29996","1378.5525","0.0179211825","6493892.461875088","84.42060200437382"
"4361","6284","6278","1","6279","29997","1377.4556249999998","0.017906923124999998","6495269.917500088","84.43850892749882"
"4362","6279","6278","2","6280","29999","1377.675","0.017909775","6496647.592500088","84.45641870249882"
"4363","6280","6276","6","6282","30005","1378.1137499999998","0.017915478749999995","6498025.706250087","84.47433418124882"
"4364","6282","6279","6","6285","30011","1378.771875","0.017924034374999998","6499404.478125087","84.49225821562382"
"4365","6285","6276","6","6282","30017","1378.1137499999998","0.017915478749999995","6500782.591875087","84.51017369437382"
"4366","6282","6281","9","6290","30026","1379.86875","0.01793829375","6502162.460625087","84.52811198812383"
"4367","6290","6286","6","6292","30032","1380.3075","0.017943997499999996","6503542.768125087","84.54605598562382"
"4368","6292","6287","6","6293","30038","1380.5268750000002","0.017946849375","6504923.2950000875","84.56400283499882"
"4369","6293","6284","9","6293","30047","1380.5268750000002","0.017946849375","6506303.821875088","84.58194968437381"
"4370","6293","6289","1","6290","30048","1379.86875","0.01793829375","6507683.690625088","84.59988797812382"
"4371","6290","6288","6","6294","30054","1380.74625","0.01794970125","6509064.436875088","84.61783767937382"
"4372","6294","6288","7","6295","30061","1380.965625","0.017952553125","6510445.402500088","84.63579023249882"
"4373","6295","6293","8","6301","30069","1382.2818750000001","0.017969664375","6511827.684375089","84.65375989687382"
"4374","6301","6296","4","6300","30073","1382.0625","0.0179668125","6513209.746875089","84.67172670937383"
"4375","6300","6299","6","6305","30079","1383.159375","0.017981071874999997","6514592.9062500885","84.68970778124883"
"4376","6305","6299","6","6305","30085","1383.159375","0.017981071874999997","6515976.065625088","84.70768885312383"
"4377","6305","6297","5","6302","30090","1382.5012499999998","0.017972516249999997","6517358.566875088","84.72566136937382"
"4378","6302","6299","6","6305","30096","1383.159375","0.017981071874999997","6518741.726250088","84.74364244124882"
"4379","6305","6300","2","6302","30098","1382.5012499999998","0.017972516249999997","6520124.227500088","84.76161495749882"
"4380","6302","6300","6","6306","30104","1383.37875","0.01798392375","6521507.606250088","84.77959888124882"
"4381","6306","6300","1","6301","30105","1382.2818750000001","0.017969664375","6522889.888125088","84.79756854562382"
"4382","6301","6298","1","6299","30106","1381.8431249999999","0.017963960624999997","6524271.731250088","84.81553250624881"
"4383","6299","6293","6","6299","30112","1381.8431249999999","0.017963960624999997","6525653.574375087","84.83349646687381"
"4384","6299","6294","9","6303","30121","1382.7206250000002","0.017975368125000002","6527036.2950000875","84.8514718349988"
"4385","6303","6298","5","6303","30126","1382.7206250000002","0.017975368125000002","6528419.015625088","84.8694472031238"
"4386","6303","6299","9","6308","30135","1383.8175","0.0179896275","6529802.833125087","84.8874368306238"
"4387","6308","6305","9","6314","30144","1385.13375","0.018006738749999997","6531187.9668750875","84.9054435693738"
"4388","6314","6305","7","6312","30151","1384.695","0.018001035","6532572.661875088","84.9234446043738"
"4389","6312","6310","4","6314","30155","1385.13375","0.018006738749999997","6533957.795625088","84.9414513431238"
"4390","6314","6307","9","6316","30164","1385.5725","0.0180124425","6535343.368125088","84.9594637856238"
"4391","6316","6307","7","6314","30171","1385.13375","0.018006738749999997","6536728.501875088","84.9774705243738"
"4392","6314","6311","8","6319","30179","1386.230625","0.018020998124999996","6538114.7325000875","84.9954915224988"
"4393","6319","6318","2","6320","30181","1386.45","0.01802385","6539501.182500088","85.0135153724988"
"4394","6320","6316","3","6319","30184","1386.230625","0.018020998124999996","6540887.4131250875","85.0315363706238"
"4395","6319","6316","7","6323","30191","1387.1081250000002","0.018032405625","6542274.521250088","85.04956877624879"
"4396","6323","6320","7","6327","30198","1387.9856249999998","0.018043813124999995","6543662.5068750875","85.0676125893738"
"4397","6327","6319","9","6328","30207","1388.2050000000002","0.018046665","6545050.711875088","85.0856592543738"
"4398","6328","6323","5","6328","30212","1388.2050000000002","0.018046665","6546438.916875088","85.1037059193738"
"4399","6328","6319","5","6324","30217","1387.3274999999999","0.0180352575","6547826.244375087","85.1217411768738"
"4400","6324","6322","9","6331","30226","1388.863125","0.018055220625","6549215.1075000875","85.1397963974988"
"4401","6331","6328","5","6333","30231","1389.301875","0.018060924375","6550604.409375087","85.1578573218738"
"4402","6333","6324","5","6329","30236","1388.4243749999998","0.018049516874999998","6551992.833750088","85.1759068387488"
"4403","6329","6325","2","6327","30238","1387.9856249999998","0.018043813124999995","6553380.8193750875","85.1939506518738"
"4404","6327","6323","7","6330","30245","1388.64375","0.01805236875","6554769.463125087","85.21200302062381"
"4405","6330","6322","4","6326","30249","1387.7662500000001","0.01804096125","6556157.229375088","85.2300439818738"
"4406","6326","6325","7","6332","30256","1389.0824999999998","0.018058072499999994","6557546.311875087","85.2481020543738"
"4407","6332","6329","5","6334","30261","1389.52125","0.01806377625","6558935.833125087","85.2661658306238"
"4408","6334","6332","4","6336","30265","1389.96","0.01806948","6560325.793125087","85.2842353106238"
"4409","6336","6330","5","6335","30270","1389.740625","0.018066628124999998","6561715.533750087","85.3023019387488"
"4410","6335","6330","9","6339","30279","1390.618125","0.018078035625","6563106.151875087","85.3203799743738"
"4411","6339","6337","8","6345","30287","1391.934375","0.018095146875","6564498.086250087","85.33847512124879"
"4412","6345","6339","9","6348","30296","1392.5925000000002","0.018103702500000003","6565890.6787500875","85.35657882374879"
"4413","6348","6340","1","6341","30297","1391.056875","0.018083739374999998","6567281.735625087","85.37466256312379"
"4414","6341","6337","1","6338","30298","1390.39875","0.01807518375","6568672.134375087","85.39273774687379"
"4415","6338","6334","8","6342","30306","1391.27625","0.01808659125","6570063.410625087","85.41082433812379"
"4416","6342","6339","9","6348","30315","1392.5925000000002","0.018103702500000003","6571456.003125087","85.42892804062379"
"4417","6348","6345","5","6350","30320","1393.03125","0.018109406249999998","6572849.034375087","85.4470374468738"
"4418","6350","6349","7","6356","30327","1394.3475","0.0181265175","6574243.3818750875","85.46516396437379"
"4419","6356","6351","3","6354","30330","1393.9087499999998","0.018120813749999996","6575637.290625088","85.48328477812379"
"4420","6354","6348","1","6349","30331","1392.8118749999999","0.018106554374999997","6577030.102500088","85.50139133249878"
"4421","6349","6340","1","6341","30332","1391.056875","0.018083739374999998","6578421.159375087","85.51947507187379"
"4422","6341","6332","4","6336","30336","1389.96","0.01806948","6579811.119375087","85.53754455187378"
"4423","6336","6328","3","6331","30339","1388.863125","0.018055220625","6581199.9825000875","85.55559977249878"
"4424","6331","6324","9","6333","30348","1389.301875","0.018060924375","6582589.284375087","85.57366069687379"
"4425","6333","6330","2","6332","30350","1389.0824999999998","0.018058072499999994","6583978.366875087","85.59171876937378"
"4426","6332","6327","5","6332","30355","1389.0824999999998","0.018058072499999994","6585367.449375086","85.60977684187378"
"4427","6332","6323","8","6331","30363","1388.863125","0.018055220625","6586756.312500087","85.62783206249878"
"4428","6331","6330","7","6337","30370","1390.179375","0.018072331874999997","6588146.491875087","85.64590439437379"
"4429","6337","6336","6","6342","30376","1391.27625","0.01808659125","6589537.768125087","85.66399098562378"
"4430","6342","6335","4","6339","30380","1390.618125","0.018078035625","6590928.386250087","85.68206902124878"
"4431","6339","6332","3","6335","30383","1389.740625","0.018066628124999998","6592318.126875087","85.70013564937378"
"4432","6335","6332","8","6340","30391","1390.8375","0.0180808875","6593708.964375087","85.71821653687378"
"4433","6340","6332","6","6338","30397","1390.39875","0.01807518375","6595099.363125087","85.73629172062378"
"4434","6338","6332","1","6333","30398","1389.301875","0.018060924375","6596488.665000087","85.75435264499879"
"4435","6333","6325","3","6328","30401","1388.2050000000002","0.018046665","6597876.870000087","85.77239930999879"
"4436","6328","6327","3","6330","30404","1388.64375","0.01805236875","6599265.513750087","85.7904516787488"
"4437","6330","6325","1","6326","30405","1387.7662500000001","0.01804096125","6600653.280000087","85.80849263999879"
"4438","6326","6320","1","6321","30406","1386.6693750000002","0.018026701875000002","6602039.949375086","85.82651934187379"
"4439","6321","6316","4","6320","30410","1386.45","0.01802385","6603426.399375087","85.8445431918738"
"4440","6320","6314","1","6315","30411","1385.353125","0.018009590625","6604811.752500087","85.8625527824988"
"4441","6315","6308","8","6316","30419","1385.5725","0.0180124425","6606197.325000087","85.88056522499879"
"4442","6316","6313","5","6318","30424","1386.0112500000002","0.018018146250000002","6607583.336250087","85.89858337124879"
"4443","6318","6310","3","6313","30427","1384.914375","0.018003886875","6608968.250625087","85.91658725812378"
"4444","6313","6309","5","6314","30432","1385.13375","0.018006738749999997","6610353.384375087","85.93459399687379"
"4445","6314","6312","1","6313","30433","1384.914375","0.018003886875","6611738.298750087","85.95259788374878"
"4446","6313","6307","2","6309","30435","1384.036875","0.017992479375","6613122.335625087","85.97059036312378"
"4447","6309","6308","7","6315","30442","1385.353125","0.018009590625","6614507.688750087","85.98859995374877"
"4448","6315","6311","8","6319","30450","1386.230625","0.018020998124999996","6615893.919375087","86.00662095187377"
"4449","6319","6314","6","6320","30456","1386.45","0.01802385","6617280.369375087","86.02464480187378"
"4450","6320","6311","8","6319","30464","1386.230625","0.018020998124999996","6618666.600000087","86.04266579999877"
"4451","6319","6312","9","6321","30473","1386.6693750000002","0.018026701875000002","6620053.269375087","86.06069250187377"
"4452","6321","6313","7","6320","30480","1386.45","0.01802385","6621439.719375087","86.07871635187378"
"4453","6320","6314","9","6323","30489","1387.1081250000002","0.018032405625","6622826.827500087","86.09674875749877"
"4454","6323","6316","3","6319","30492","1386.230625","0.018020998124999996","6624213.058125087","86.11476975562377"
"4455","6319","6310","3","6313","30495","1384.914375","0.018003886875","6625597.972500087","86.13277364249876"
"4456","6313","6312","8","6320","30503","1386.45","0.01802385","6626984.422500087","86.15079749249877"
"4457","6320","6312","3","6315","30506","1385.353125","0.018009590625","6628369.775625087","86.16880708312377"
"4458","6315","6314","4","6318","30510","1386.0112500000002","0.018018146250000002","6629755.786875088","86.18682522937377"
"4459","6318","6315","4","6319","30514","1386.230625","0.018020998124999996","6631142.017500088","86.20484622749876"
"4460","6319","6313","5","6318","30519","1386.0112500000002","0.018018146250000002","6632528.028750088","86.22286437374876"
"4461","6318","6313","7","6320","30526","1386.45","0.01802385","6633914.478750088","86.24088822374877"
"4462","6320","6315","3","6318","30529","1386.0112500000002","0.018018146250000002","6635300.490000089","86.25890636999877"
"4463","6318","6310","2","6312","30531","1384.695","0.018001035","6636685.185000089","86.27690740499877"
"4464","6312","6309","7","6316","30538","1385.5725","0.0180124425","6638070.757500089","86.29491984749876"
"4465","6316","6313","2","6315","30540","1385.353125","0.018009590625","6639456.110625089","86.31292943812376"
"4466","6315","6311","3","6314","30543","1385.13375","0.018006738749999997","6640841.244375089","86.33093617687376"
"4467","6314","6311","6","6317","30549","1385.791875","0.018015294374999997","6642227.036250089","86.34895147124877"
"4468","6317","6311","3","6314","30552","1385.13375","0.018006738749999997","6643612.170000089","86.36695820999877"
"4469","6314","6305","6","6311","30558","1384.475625","0.017998183125","6644996.645625089","86.38495639312377"
"4470","6311","6307","3","6310","30561","1384.25625","0.017995331249999996","6646380.901875089","86.40295172437378"
"4471","6310","6307","2","6309","30563","1384.036875","0.017992479375","6647764.938750089","86.42094420374877"
"4472","6309","6306","6","6312","30569","1384.695","0.018001035","6649149.633750089","86.43894523874877"
"4473","6312","6310","2","6312","30571","1384.695","0.018001035","6650534.32875009","86.45694627374877"
"4474","6312","6311","5","6316","30576","1385.5725","0.0180124425","6651919.9012500895","86.47495871624876"
"4475","6316","6310","8","6318","30584","1386.0112500000002","0.018018146250000002","6653305.91250009","86.49297686249876"
"4476","6318","6312","3","6315","30587","1385.353125","0.018009590625","6654691.26562509","86.51098645312376"
"4477","6315","6306","2","6308","30589","1383.8175","0.0179896275","6656075.08312509","86.52897608062376"
"4478","6308","6303","9","6312","30598","1384.695","0.018001035","6657459.7781250905","86.54697711562376"
"4479","6312","6306","8","6314","30606","1385.13375","0.018006738749999997","6658844.911875091","86.56498385437376"
"4480","6314","6309","3","6312","30609","1384.695","0.018001035","6660229.606875091","86.58298488937376"
"4481","6312","6309","4","6313","30613","1384.914375","0.018003886875","6661614.521250091","86.60098877624876"
"4482","6313","6312","2","6314","30615","1385.13375","0.018006738749999997","6662999.655000091","86.61899551499876"
"4483","6314","6309","5","6314","30620","1385.13375","0.018006738749999997","6664384.788750091","86.63700225374876"
"4484","6314","6309","5","6314","30625","1385.13375","0.018006738749999997","6665769.922500091","86.65500899249876"
"4485","6314","6313","1","6314","30626","1385.13375","0.018006738749999997","6667155.056250091","86.67301573124877"
"4486","6314","6313","8","6321","30634","1386.6693750000002","0.018026701875000002","6668541.72562509","86.69104243312377"
"4487","6321","6317","5","6322","30639","1386.8887499999998","0.018029553749999996","6669928.61437509","86.70907198687377"
"4488","6322","6315","9","6324","30648","1387.3274999999999","0.0180352575","6671315.94187509","86.72710724437377"
"4489","6324","6316","2","6318","30650","1386.0112500000002","0.018018146250000002","6672701.95312509","86.74512539062377"
"4490","6318","6312","1","6313","30651","1384.914375","0.018003886875","6674086.86750009","86.76312927749876"
"4491","6313","6310","7","6317","30658","1385.791875","0.018015294374999997","6675472.65937509","86.78114457187377"
"4492","6317","6316","3","6319","30661","1386.230625","0.018020998124999996","6676858.89000009","86.79916556999876"
"4493","6319","6316","8","6324","30669","1387.3274999999999","0.0180352575","6678246.21750009","86.81720082749877"
"4494","6324","6321","5","6326","30674","1387.7662500000001","0.01804096125","6679633.98375009","86.83524178874876"
"4495","6326","6320","5","6325","30679","1387.546875","0.018038109375","6681021.53062509","86.85327989812376"
"4496","6325","6317","1","6318","30680","1386.0112500000002","0.018018146250000002","6682407.54187509","86.87129804437376"
"4497","6318","6313","5","6318","30685","1386.0112500000002","0.018018146250000002","6683793.553125091","86.88931619062376"
"4498","6318","6314","9","6323","30694","1387.1081250000002","0.018032405625","6685180.661250091","86.90734859624875"
"4499","6323","6322","9","6331","30703","1388.863125","0.018055220625","6686569.524375091","86.92540381687375"
"4500","6331","6325","5","6330","30708","1388.64375","0.01805236875","6687958.168125091","86.94345618562376"
"4501","6330","6322","2","6324","30710","1387.3274999999999","0.0180352575","6689345.495625091","86.96149144312376"
"4502","6324","6318","6","6324","30716","1387.3274999999999","0.0180352575","6690732.82312509","86.97952670062377"
"4503","6324","6316","1","6317","30717","1385.791875","0.018015294374999997","6692118.615000091","86.99754199499877"
"4504","6317","6310","1","6311","30718","1384.475625","0.017998183125","6693503.0906250905","87.01554017812377"
"4505","6311","6304","7","6311","30725","1384.475625","0.017998183125","6694887.5662500905","87.03353836124877"
"4506","6311","6308","8","6316","30733","1385.5725","0.0180124425","6696273.13875009","87.05155080374877"
"4507","6316","6315","4","6319","30737","1386.230625","0.018020998124999996","6697659.36937509","87.06957180187376"
"4508","6319","6315","6","6321","30743","1386.6693750000002","0.018026701875000002","6699046.03875009","87.08759850374877"
"4509","6321","6318","1","6319","30744","1386.230625","0.018020998124999996","6700432.26937509","87.10561950187376"
"4510","6319","6310","5","6315","30749","1385.353125","0.018009590625","6701817.62250009","87.12362909249876"
"4511","6315","6310","7","6317","30756","1385.791875","0.018015294374999997","6703203.41437509","87.14164438687376"
"4512","6317","6308","3","6311","30759","1384.475625","0.017998183125","6704587.89000009","87.15964256999877"
"4513","6311","6306","6","6312","30765","1384.695","0.018001035","6705972.58500009","87.17764360499876"
"4514","6312","6305","6","6311","30771","1384.475625","0.017998183125","6707357.06062509","87.19564178812377"
"4515","6311","6307","7","6314","30778","1385.13375","0.018006738749999997","6708742.19437509","87.21364852687377"
"4516","6314","6309","7","6316","30785","1385.5725","0.0180124425","6710127.76687509","87.23166096937376"
"4517","6316","6314","8","6322","30793","1386.8887499999998","0.018029553749999996","6711514.65562509","87.24969052312376"
"4518","6322","6317","3","6320","30796","1386.45","0.01802385","6712901.10562509","87.26771437312377"
"4519","6320","6312","7","6319","30803","1386.230625","0.018020998124999996","6714287.33625009","87.28573537124876"
"4520","6319","6317","5","6322","30808","1386.8887499999998","0.018029553749999996","6715674.22500009","87.30376492499876"
"4521","6322","6314","5","6319","30813","1386.230625","0.018020998124999996","6717060.45562509","87.32178592312376"
"4522","6319","6310","3","6313","30816","1384.914375","0.018003886875","6718445.3700000895","87.33978980999875"
"4523","6313","6310","9","6319","30825","1386.230625","0.018020998124999996","6719831.600625089","87.35781080812374"
"4524","6319","6311","2","6313","30827","1384.914375","0.018003886875","6721216.515000089","87.37581469499874"
"4525","6313","6312","6","6318","30833","1386.0112500000002","0.018018146250000002","6722602.5262500895","87.39383284124874"
"4526","6318","6316","7","6323","30840","1387.1081250000002","0.018032405625","6723989.63437509","87.41186524687373"
"4527","6323","6315","2","6317","30842","1385.791875","0.018015294374999997","6725375.42625009","87.42988054124874"
"4528","6317","6311","6","6317","30848","1385.791875","0.018015294374999997","6726761.21812509","87.44789583562374"
"4529","6317","6311","9","6320","30857","1386.45","0.01802385","6728147.66812509","87.46591968562375"
"4530","6320","6313","1","6314","30858","1385.13375","0.018006738749999997","6729532.80187509","87.48392642437375"
"4531","6314","6312","4","6316","30862","1385.5725","0.0180124425","6730918.37437509","87.50193886687374"
"4532","6316","6314","6","6320","30868","1386.45","0.01802385","6732304.82437509","87.51996271687375"
"4533","6320","6317","7","6324","30875","1387.3274999999999","0.0180352575","6733692.15187509","87.53799797437375"
"4534","6324","6315","1","6316","30876","1385.5725","0.0180124425","6735077.72437509","87.55601041687375"
"4535","6316","6315","4","6319","30880","1386.230625","0.018020998124999996","6736463.9550000895","87.57403141499874"
"4536","6319","6314","5","6319","30885","1386.230625","0.018020998124999996","6737850.185625089","87.59205241312374"
"4537","6319","6315","1","6316","30886","1385.5725","0.0180124425","6739235.758125089","87.61006485562373"
"4538","6316","6315","6","6321","30892","1386.6693750000002","0.018026701875000002","6740622.427500089","87.62809155749873"
"4539","6321","6315","4","6319","30896","1386.230625","0.018020998124999996","6742008.658125089","87.64611255562373"
"4540","6319","6310","3","6313","30899","1384.914375","0.018003886875","6743393.572500088","87.66411644249872"
"4541","6313","6308","6","6314","30905","1385.13375","0.018006738749999997","6744778.706250088","87.68212318124873"
"4542","6314","6309","2","6311","30907","1384.475625","0.017998183125","6746163.181875088","87.70012136437373"
"4543","6311","6306","9","6315","30916","1385.353125","0.018009590625","6747548.535000089","87.71813095499873"
"4544","6315","6311","4","6315","30920","1385.353125","0.018009590625","6748933.888125089","87.73614054562373"
"4545","6315","6308","4","6312","30924","1384.695","0.018001035","6750318.583125089","87.75414158062372"
"4546","6312","6308","3","6311","30927","1384.475625","0.017998183125","6751703.058750089","87.77213976374873"
"4547","6311","6307","2","6309","30929","1384.036875","0.017992479375","6753087.0956250895","87.79013224312372"
"4548","6309","6300","7","6307","30936","1383.5981249999998","0.017986775624999996","6754470.693750089","87.80811901874873"
"4549","6307","6303","9","6312","30945","1384.695","0.018001035","6755855.388750089","87.82612005374872"
"4550","6312","6311","2","6313","30947","1384.914375","0.018003886875","6757240.303125089","87.84412394062372"
"4551","6313","6311","5","6316","30952","1385.5725","0.0180124425","6758625.875625089","87.86213638312371"
"4552","6316","6309","5","6314","30957","1385.13375","0.018006738749999997","6760011.009375089","87.88014312187372"
"4553","6314","6308","9","6317","30966","1385.791875","0.018015294374999997","6761396.801250089","87.89815841624872"
"4554","6317","6310","8","6318","30974","1386.0112500000002","0.018018146250000002","6762782.812500089","87.91617656249872"
"4555","6318","6313","7","6320","30981","1386.45","0.01802385","6764169.26250009","87.93420041249873"
"4556","6320","6313","9","6322","30990","1386.8887499999998","0.018029553749999996","6765556.1512500895","87.95222996624872"
"4557","6322","6314","2","6316","30992","1385.5725","0.0180124425","6766941.723750089","87.97024240874872"
"4558","6316","6314","6","6320","30998","1386.45","0.01802385","6768328.1737500895","87.98826625874872"
"4559","6320","6319","8","6327","31006","1387.9856249999998","0.018043813124999995","6769716.159375089","88.00631007187373"
"4560","6327","6321","6","6327","31012","1387.9856249999998","0.018043813124999995","6771104.145000089","88.02435388499873"
"4561","6327","6319","8","6327","31020","1387.9856249999998","0.018043813124999995","6772492.130625089","88.04239769812374"
"4562","6327","6321","3","6324","31023","1387.3274999999999","0.0180352575","6773879.458125088","88.06043295562374"
"4563","6324","6321","8","6329","31031","1388.4243749999998","0.018049516874999998","6775267.882500089","88.07848247249873"
"4564","6329","6328","7","6335","31038","1389.740625","0.018066628124999998","6776657.623125088","88.09654910062373"
"4565","6335","6331","4","6335","31042","1389.740625","0.018066628124999998","6778047.363750088","88.11461572874873"
"4566","6335","6330","1","6331","31043","1388.863125","0.018055220625","6779436.226875088","88.13267094937373"
"4567","6331","6323","5","6328","31048","1388.2050000000002","0.018046665","6780824.431875088","88.15071761437373"
"4568","6328","6320","5","6325","31053","1387.546875","0.018038109375","6782211.978750088","88.16875572374873"
"4569","6325","6316","8","6324","31061","1387.3274999999999","0.0180352575","6783599.306250088","88.18679098124873"
"4570","6324","6318","2","6320","31063","1386.45","0.01802385","6784985.756250088","88.20481483124874"
"4571","6320","6316","4","6320","31067","1386.45","0.01802385","6786372.206250088","88.22283868124875"
"4572","6320","6313","8","6321","31075","1386.6693750000002","0.018026701875000002","6787758.875625088","88.24086538312375"
"4573","6321","6314","4","6318","31079","1386.0112500000002","0.018018146250000002","6789144.886875088","88.25888352937375"
"4574","6318","6317","5","6322","31084","1386.8887499999998","0.018029553749999996","6790531.775625088","88.27691308312374"
"4575","6322","6313","7","6320","31091","1386.45","0.01802385","6791918.225625088","88.29493693312375"
"4576","6320","6313","2","6315","31093","1385.353125","0.018009590625","6793303.578750089","88.31294652374875"
"4577","6315","6312","3","6315","31096","1385.353125","0.018009590625","6794688.931875089","88.33095611437375"
"4578","6315","6312","9","6321","31105","1386.6693750000002","0.018026701875000002","6796075.601250089","88.34898281624875"
"4579","6321","6316","5","6321","31110","1386.6693750000002","0.018026701875000002","6797462.270625088","88.36700951812375"
"4580","6321","6317","1","6318","31111","1386.0112500000002","0.018018146250000002","6798848.281875089","88.38502766437375"
"4581","6318","6316","2","6318","31113","1386.0112500000002","0.018018146250000002","6800234.293125089","88.40304581062375"
"4582","6318","6310","3","6313","31116","1384.914375","0.018003886875","6801619.207500089","88.42104969749874"
"4583","6313","6305","8","6313","31124","1384.914375","0.018003886875","6803004.121875089","88.43905358437374"
"4584","6313","6307","9","6316","31133","1385.5725","0.0180124425","6804389.694375088","88.45706602687373"
"4585","6316","6307","5","6312","31138","1384.695","0.018001035","6805774.389375089","88.47506706187373"
"4586","6312","6310","5","6315","31143","1385.353125","0.018009590625","6807159.742500089","88.49307665249873"
"4587","6315","6306","2","6308","31145","1383.8175","0.0179896275","6808543.560000089","88.51106627999873"
"4588","6308","6305","6","6311","31151","1384.475625","0.017998183125","6809928.035625089","88.52906446312373"
"4589","6311","6309","5","6314","31156","1385.13375","0.018006738749999997","6811313.169375089","88.54707120187373"
"4590","6314","6306","1","6307","31157","1383.5981249999998","0.017986775624999996","6812696.767500089","88.56505797749874"
"4591","6307","6306","5","6311","31162","1384.475625","0.017998183125","6814081.2431250885","88.58305616062374"
"4592","6311","6305","9","6314","31171","1385.13375","0.018006738749999997","6815466.376875089","88.60106289937374"
"4593","6314","6313","3","6316","31174","1385.5725","0.0180124425","6816851.949375088","88.61907534187374"
"4594","6316","6314","3","6317","31177","1385.791875","0.018015294374999997","6818237.741250088","88.63709063624874"
"4595","6317","6315","9","6324","31186","1387.3274999999999","0.0180352575","6819625.068750088","88.65512589374875"
"4596","6324","6320","6","6326","31192","1387.7662500000001","0.01804096125","6821012.835000088","88.67316685499874"
"4597","6326","6318","6","6324","31198","1387.3274999999999","0.0180352575","6822400.162500088","88.69120211249874"
"4598","6324","6322","2","6324","31200","1387.3274999999999","0.0180352575","6823787.490000088","88.70923736999875"
"4599","6324","6315","5","6320","31205","1386.45","0.01802385","6825173.940000088","88.72726121999875"
"4600","6320","6315","3","6318","31208","1386.0112500000002","0.018018146250000002","6826559.951250088","88.74527936624875"
"4601","6318","6314","1","6315","31209","1385.353125","0.018009590625","6827945.304375089","88.76328895687375"
"4602","6315","6313","4","6317","31213","1385.791875","0.018015294374999997","6829331.096250089","88.78130425124876"
"4603","6317","6308","9","6317","31222","1385.791875","0.018015294374999997","6830716.888125089","88.79931954562376"
"4604","6317","6313","2","6315","31224","1385.353125","0.018009590625","6832102.241250089","88.81732913624876"
"4605","6315","6310","8","6318","31232","1386.0112500000002","0.018018146250000002","6833488.25250009","88.83534728249876"
"4606","6318","6317","7","6324","31239","1387.3274999999999","0.0180352575","6834875.5800000895","88.85338253999876"
"4607","6324","6323","9","6332","31248","1389.0824999999998","0.018058072499999994","6836264.662500089","88.87144061249876"
"4608","6332","6329","4","6333","31252","1389.301875","0.018060924375","6837653.964375089","88.88950153687377"
"4609","6333","6329","4","6333","31256","1389.301875","0.018060924375","6839043.266250089","88.90756246124877"
"4610","6333","6332","9","6341","31265","1391.056875","0.018083739374999998","6840434.323125089","88.92564620062377"
"4611","6341","6338","2","6340","31267","1390.8375","0.0180808875","6841825.160625089","88.94372708812378"
"4612","6340","6334","8","6342","31275","1391.27625","0.01808659125","6843216.436875089","88.96181367937378"
"4613","6342","6339","7","6346","31282","1392.1537500000002","0.01809799875","6844608.590625089","88.97991167812377"
"4614","6346","6342","6","6348","31288","1392.5925000000002","0.018103702500000003","6846001.183125089","88.99801538062377"
"4615","6348","6345","3","6348","31291","1392.5925000000002","0.018103702500000003","6847393.775625089","89.01611908312377"
"4616","6348","6343","6","6349","31297","1392.8118749999999","0.018106554374999997","6848786.587500089","89.03422563749876"
"4617","6349","6342","2","6344","31299","1391.715","0.018092294999999998","6850178.302500089","89.05231793249877"
"4618","6344","6339","9","6348","31308","1392.5925000000002","0.018103702500000003","6851570.895000089","89.07042163499877"
"4619","6348","6345","3","6348","31311","1392.5925000000002","0.018103702500000003","6852963.487500089","89.08852533749877"
"4620","6348","6346","7","6353","31318","1393.6893750000002","0.018117961875","6854357.176875089","89.10664329937377"
"4621","6353","6348","8","6356","31326","1394.3475","0.0181265175","6855751.524375089","89.12476981687377"
"4622","6356","6351","6","6357","31332","1394.5668749999998","0.018129369374999996","6857146.091250089","89.14289918624877"
"4623","6357","6356","3","6359","31335","1395.005625","0.018135073124999998","6858541.096875089","89.16103425937376"
"4624","6359","6351","9","6360","31344","1395.225","0.018137925","6859936.321875089","89.17917218437377"
"4625","6360","6351","9","6360","31353","1395.225","0.018137925","6861331.5468750885","89.19731010937377"
"4626","6360","6352","9","6361","31362","1395.444375","0.018140776875","6862726.991250088","89.21545088624877"
"4627","6361","6354","6","6360","31368","1395.225","0.018137925","6864122.216250088","89.23358881124878"
"4628","6360","6359","9","6368","31377","1396.9800000000002","0.01816074","6865519.1962500885","89.25174955124878"
"4629","6368","6364","7","6371","31384","1397.6381250000002","0.018169295625","6866916.834375088","89.26991884687378"
"4630","6371","6366","6","6372","31390","1397.8574999999998","0.018172147499999996","6868314.691875088","89.28809099437377"
"4631","6372","6371","5","6376","31395","1398.7350000000001","0.018183555","6869713.426875088","89.30627454937377"
"4632","6376","6373","2","6375","31397","1398.515625","0.018180703125","6871111.942500088","89.32445525249877"
"4633","6375","6369","8","6377","31405","1398.9543749999998","0.018186406874999995","6872510.896875088","89.34264165937377"
"4634","6377","6372","4","6376","31409","1398.7350000000001","0.018183555","6873909.631875088","89.36082521437376"
"4635","6376","6374","4","6378","31413","1399.1737500000002","0.01818925875","6875308.8056250885","89.37901447312376"
"4636","6378","6371","9","6380","31422","1399.6125","0.0181949625","6876708.418125088","89.39720943562376"
"4637","6380","6372","8","6380","31430","1399.6125","0.0181949625","6878108.030625088","89.41540439812377"
"4638","6380","6375","9","6384","31439","1400.49","0.01820637","6879508.520625088","89.43361076812377"
"4639","6384","6375","6","6381","31445","1399.831875","0.018197814375","6880908.3525000885","89.45180858249877"
"4640","6381","6373","2","6375","31447","1398.515625","0.018180703125","6882306.8681250885","89.46998928562377"
"4641","6375","6374","5","6379","31452","1399.3931249999998","0.018192110624999997","6883706.261250089","89.48818139624876"
"4642","6379","6372","3","6375","31455","1398.515625","0.018180703125","6885104.776875089","89.50636209937376"
"4643","6375","6373","4","6377","31459","1398.9543749999998","0.018186406874999995","6886503.731250089","89.52454850624876"
"4644","6377","6369","1","6370","31460","1397.41875","0.01816644375","6887901.150000089","89.54271494999877"
"4645","6370","6362","8","6370","31468","1397.41875","0.01816644375","6889298.568750089","89.56088139374877"
"4646","6370","6361","8","6369","31476","1397.199375","0.018163591875","6890695.768125089","89.57904498562377"
"4647","6369","6361","3","6364","31479","1396.1025","0.018149332499999997","6892091.870625089","89.59719431812377"
"4648","6364","6358","9","6367","31488","1396.760625","0.018157888124999997","6893488.631250089","89.61535220624877"
"4649","6367","6361","7","6368","31495","1396.9800000000002","0.01816074","6894885.6112500895","89.63351294624877"
"4650","6368","6365","4","6369","31499","1397.199375","0.018163591875","6896282.810625089","89.65167653812377"
"4651","6369","6368","3","6371","31502","1397.6381250000002","0.018169295625","6897680.448750089","89.66984583374877"
"4652","6371","6364","7","6371","31509","1397.6381250000002","0.018169295625","6899078.0868750885","89.68801512937377"
"4653","6371","6368","5","6373","31514","1398.0768750000002","0.018174999375","6900476.163750089","89.70619012874877"
"4654","6373","6368","4","6372","31518","1397.8574999999998","0.018172147499999996","6901874.021250089","89.72436227624877"
"4655","6372","6365","3","6368","31521","1396.9800000000002","0.01816074","6903271.001250089","89.74252301624877"
"4656","6368","6363","7","6370","31528","1397.41875","0.01816644375","6904668.420000089","89.76068945999877"
"4657","6370","6361","6","6367","31534","1396.760625","0.018157888124999997","6906065.180625089","89.77884734812378"
"4658","6367","6359","6","6365","31540","1396.321875","0.018152184375","6907461.50250009","89.79699953249877"
"4659","6365","6361","9","6370","31549","1397.41875","0.01816644375","6908858.92125009","89.81516597624878"
"4660","6370","6366","6","6372","31555","1397.8574999999998","0.018172147499999996","6910256.77875009","89.83333812374877"
"4661","6372","6369","8","6377","31563","1398.9543749999998","0.018186406874999995","6911655.73312509","89.85152453062378"
"4662","6377","6370","1","6371","31564","1397.6381250000002","0.018169295625","6913053.371250089","89.86969382624878"
"4663","6371","6365","5","6370","31569","1397.41875","0.01816644375","6914450.790000089","89.88786026999878"
"4664","6370","6362","9","6371","31578","1397.6381250000002","0.018169295625","6915848.428125089","89.90602956562378"
"4665","6371","6364","3","6367","31581","1396.760625","0.018157888124999997","6917245.188750089","89.92418745374879"
"4666","6367","6358","2","6360","31583","1395.225","0.018137925","6918640.413750089","89.94232537874879"
"4667","6360","6358","4","6362","31587","1395.66375","0.018143628749999998","6920036.077500089","89.96046900749879"
"4668","6362","6354","3","6357","31590","1394.5668749999998","0.018129369374999996","6921430.644375089","89.97859837687379"
"4669","6357","6353","5","6358","31595","1394.78625","0.01813222125","6922825.4306250885","89.99673059812379"
"4670","6358","6349","3","6352","31598","1393.4699999999998","0.018115109999999997","6924218.900625088","90.01484570812379"
"4671","6352","6344","8","6352","31606","1393.4699999999998","0.018115109999999997","6925612.370625088","90.03296081812378"
"4672","6352","6347","4","6351","31610","1393.2506250000001","0.018112258125","6927005.621250088","90.05107307624878"
"4673","6351","6343","8","6351","31618","1393.2506250000001","0.018112258125","6928398.871875089","90.06918533437378"
"4674","6351","6342","6","6348","31624","1392.5925000000002","0.018103702500000003","6929791.464375089","90.08728903687378"
"4675","6348","6344","4","6348","31628","1392.5925000000002","0.018103702500000003","6931184.056875089","90.10539273937378"
"4676","6348","6342","7","6349","31635","1392.8118749999999","0.018106554374999997","6932576.868750089","90.12349929374878"
"4677","6349","6343","6","6349","31641","1392.8118749999999","0.018106554374999997","6933969.6806250885","90.14160584812377"
"4678","6349","6340","3","6343","31644","1391.4956250000002","0.018089443125000004","6935361.176250089","90.15969529124878"
"4679","6343","6336","3","6339","31647","1390.618125","0.018078035625","6936751.794375089","90.17777332687378"
"4680","6339","6332","1","6333","31648","1389.301875","0.018060924375","6938141.096250089","90.19583425124878"
"4681","6333","6332","2","6334","31650","1389.52125","0.01806377625","6939530.617500089","90.21389802749879"
"4682","6334","6331","2","6333","31652","1389.301875","0.018060924375","6940919.919375089","90.23195895187379"
"4683","6333","6328","6","6334","31658","1389.52125","0.01806377625","6942309.440625089","90.2500227281238"
"4684","6334","6326","7","6333","31665","1389.301875","0.018060924375","6943698.742500089","90.2680836524988"
"4685","6333","6331","8","6339","31673","1390.618125","0.018078035625","6945089.360625089","90.2861616881238"
"4686","6339","6331","6","6337","31679","1390.179375","0.018072331874999997","6946479.540000089","90.3042340199988"
"4687","6337","6334","4","6338","31683","1390.39875","0.01807518375","6947869.938750089","90.3223092037488"
"4688","6338","6336","7","6343","31690","1391.4956250000002","0.018089443125000004","6949261.43437509","90.34039864687381"
"4689","6343","6337","4","6341","31694","1391.056875","0.018083739374999998","6950652.491250089","90.35848238624881"
"4690","6341","6332","4","6336","31698","1389.96","0.01806948","6952042.451250089","90.3765518662488"
"4691","6336","6329","3","6332","31701","1389.0824999999998","0.018058072499999994","6953431.533750089","90.3946099387488"
"4692","6332","6326","9","6335","31710","1389.740625","0.018066628124999998","6954821.2743750885","90.4126765668738"
"4693","6335","6333","3","6336","31713","1389.96","0.01806948","6956211.2343750885","90.4307460468738"
"4694","6336","6329","7","6336","31720","1389.96","0.01806948","6957601.194375088","90.44881552687379"
"4695","6336","6333","2","6335","31722","1389.740625","0.018066628124999998","6958990.935000088","90.46688215499879"
"4696","6335","6331","7","6338","31729","1390.39875","0.01807518375","6960381.333750088","90.48495733874879"
"4697","6338","6329","1","6330","31730","1388.64375","0.01805236875","6961769.977500088","90.50300970749879"
"4698","6330","6325","3","6328","31733","1388.2050000000002","0.018046665","6963158.182500088","90.52105637249879"
"4699","6328","6323","3","6326","31736","1387.7662500000001","0.01804096125","6964545.948750088","90.53909733374878"
"4700","6326","6322","6","6328","31742","1388.2050000000002","0.018046665","6965934.153750088","90.55714399874878"
"4701","6328","6322","2","6324","31744","1387.3274999999999","0.0180352575","6967321.481250088","90.57517925624879"
"4702","6324","6317","6","6323","31750","1387.1081250000002","0.018032405625","6968708.589375088","90.59321166187378"
"4703","6323","6315","7","6322","31757","1386.8887499999998","0.018029553749999996","6970095.478125088","90.61124121562378"
"4704","6322","6320","9","6329","31766","1388.4243749999998","0.018049516874999998","6971483.902500088","90.62929073249877"
"4705","6329","6321","1","6322","31767","1386.8887499999998","0.018029553749999996","6972870.791250088","90.64732028624877"
"4706","6322","6317","8","6325","31775","1387.546875","0.018038109375","6974258.338125088","90.66535839562377"
"4707","6325","6323","9","6332","31784","1389.0824999999998","0.018058072499999994","6975647.420625088","90.68341646812377"
"4708","6332","6331","2","6333","31786","1389.301875","0.018060924375","6977036.722500088","90.70147739249877"
"4709","6333","6332","7","6339","31793","1390.618125","0.018078035625","6978427.340625088","90.71955542812377"
"4710","6339","6335","8","6343","31801","1391.4956250000002","0.018089443125000004","6979818.836250088","90.73764487124878"
"4711","6343","6339","4","6343","31805","1391.4956250000002","0.018089443125000004","6981210.331875089","90.75573431437378"
"4712","6343","6341","8","6349","31813","1392.8118749999999","0.018106554374999997","6982603.143750088","90.77384086874878"
"4713","6349","6342","1","6343","31814","1391.4956250000002","0.018089443125000004","6983994.639375089","90.79193031187378"
"4714","6343","6337","1","6338","31815","1390.39875","0.01807518375","6985385.038125088","90.81000549562378"
"4715","6338","6330","6","6336","31821","1389.96","0.01806948","6986774.998125088","90.82807497562378"
"4716","6336","6328","5","6333","31826","1389.301875","0.018060924375","6988164.300000088","90.84613589999879"
"4717","6333","6324","9","6333","31835","1389.301875","0.018060924375","6989553.601875088","90.86419682437379"
"4718","6333","6328","9","6337","31844","1390.179375","0.018072331874999997","6990943.7812500885","90.8822691562488"
"4719","6337","6335","6","6341","31850","1391.056875","0.018083739374999998","6992334.838125088","90.9003528956238"
"4720","6341","6336","6","6342","31856","1391.27625","0.01808659125","6993726.114375088","90.9184394868738"
"4721","6342","6341","8","6349","31864","1392.8118749999999","0.018106554374999997","6995118.926250088","90.93654604124879"
"4722","6349","6340","6","6346","31870","1392.1537500000002","0.01809799875","6996511.080000088","90.95464403999878"
"4723","6346","6337","7","6344","31877","1391.715","0.018092294999999998","6997902.7950000875","90.97273633499879"
"4724","6344","6339","2","6341","31879","1391.056875","0.018083739374999998","6999293.851875087","90.99082007437379"
"4725","6341","6333","9","6342","31888","1391.27625","0.01808659125","7000685.128125087","91.00890666562378"
"4726","6342","6339","8","6347","31896","1392.3731249999998","0.018100850624999998","7002077.501250087","91.02700751624879"
"4727","6347","6341","9","6350","31905","1393.03125","0.018109406249999998","7003470.532500087","91.04511692249879"
"4728","6350","6346","5","6351","31910","1393.2506250000001","0.018112258125","7004863.783125088","91.0632291806238"
"4729","6351","6345","3","6348","31913","1392.5925000000002","0.018103702500000003","7006256.375625088","91.08133288312379"
"4730","6348","6343","1","6344","31914","1391.715","0.018092294999999998","7007648.090625088","91.0994251781238"
"4731","6344","6342","3","6345","31917","1391.934375","0.018095146875","7009040.025000088","91.1175203249988"
"4732","6345","6337","8","6345","31925","1391.934375","0.018095146875","7010431.959375088","91.13561547187379"
"4733","6345","6342","9","6351","31934","1393.2506250000001","0.018112258125","7011825.210000088","91.15372772999879"
"4734","6351","6347","2","6349","31936","1392.8118749999999","0.018106554374999997","7013218.021875088","91.17183428437379"
"4735","6349","6348","8","6356","31944","1394.3475","0.0181265175","7014612.369375088","91.18996080187378"
"4736","6356","6348","3","6351","31947","1393.2506250000001","0.018112258125","7016005.620000089","91.20807305999878"
"4737","6351","6347","5","6352","31952","1393.4699999999998","0.018115109999999997","7017399.090000088","91.22618816999878"
"4738","6352","6345","6","6351","31958","1393.2506250000001","0.018112258125","7018792.340625089","91.24430042812378"
"4739","6351","6348","4","6352","31962","1393.4699999999998","0.018115109999999997","7020185.810625088","91.26241553812378"
"4740","6352","6346","6","6352","31968","1393.4699999999998","0.018115109999999997","7021579.280625088","91.28053064812377"
"4741","6352","6344","4","6348","31972","1392.5925000000002","0.018103702500000003","7022971.873125088","91.29863435062377"
"4742","6348","6339","4","6343","31976","1391.4956250000002","0.018089443125000004","7024363.368750089","91.31672379374878"
"4743","6343","6341","3","6344","31979","1391.715","0.018092294999999998","7025755.083750089","91.33481608874878"
"4744","6344","6343","8","6351","31987","1393.2506250000001","0.018112258125","7027148.334375089","91.35292834687378"
"4745","6351","6348","9","6357","31996","1394.5668749999998","0.018129369374999996","7028542.901250089","91.37105771624879"
"4746","6357","6350","6","6356","32002","1394.3475","0.0181265175","7029937.248750089","91.38918423374878"
"4747","6356","6354","6","6360","32008","1395.225","0.018137925","7031332.473750088","91.40732215874878"
"4748","6360","6353","2","6355","32010","1394.128125","0.018123665624999997","7032726.601875088","91.42544582437378"
"4749","6355","6350","1","6351","32011","1393.2506250000001","0.018112258125","7034119.8525000885","91.44355808249878"
"4750","6351","6348","6","6354","32017","1393.9087499999998","0.018120813749999996","7035513.761250089","91.46167889624878"
"4751","6354","6348","9","6357","32026","1394.5668749999998","0.018129369374999996","7036908.3281250885","91.47980826562379"
"4752","6357","6350","8","6358","32034","1394.78625","0.01813222125","7038303.114375088","91.49794048687379"
"4753","6358","6353","8","6361","32042","1395.444375","0.018140776875","7039698.558750088","91.51608126374879"
"4754","6361","6352","6","6358","32048","1394.78625","0.01813222125","7041093.345000088","91.53421348499879"
"4755","6358","6355","5","6360","32053","1395.225","0.018137925","7042488.570000088","91.55235140999879"
"4756","6360","6354","3","6357","32056","1394.5668749999998","0.018129369374999996","7043883.136875087","91.5704807793738"
"4757","6357","6349","5","6354","32061","1393.9087499999998","0.018120813749999996","7045277.045625088","91.5886015931238"
"4758","6354","6353","4","6357","32065","1394.5668749999998","0.018129369374999996","7046671.612500087","91.6067309624988"
"4759","6357","6356","1","6357","32066","1394.5668749999998","0.018129369374999996","7048066.179375087","91.6248603318738"
"4760","6357","6356","6","6362","32072","1395.66375","0.018143628749999998","7049461.843125087","91.6430039606238"
"4761","6362","6359","1","6360","32073","1395.225","0.018137925","7050857.068125087","91.6611418856238"
"4762","6360","6359","9","6368","32082","1396.9800000000002","0.01816074","7052254.048125087","91.6793026256238"
"4763","6368","6365","5","6370","32087","1397.41875","0.01816644375","7053651.4668750875","91.69746906937381"
"4764","6370","6366","3","6369","32090","1397.199375","0.018163591875","7055048.666250087","91.7156326612488"
"4765","6369","6365","3","6368","32093","1396.9800000000002","0.01816074","7056445.646250088","91.7337934012488"
"4766","6368","6361","6","6367","32099","1396.760625","0.018157888124999997","7057842.406875088","91.7519512893738"
"4767","6367","6360","2","6362","32101","1395.66375","0.018143628749999998","7059238.070625088","91.7700949181238"
"4768","6362","6357","1","6358","32102","1394.78625","0.01813222125","7060632.856875088","91.7882271393738"
"4769","6358","6356","5","6361","32107","1395.444375","0.018140776875","7062028.301250088","91.8063679162488"
"4770","6361","6358","7","6365","32114","1396.321875","0.018152184375","7063424.623125088","91.8245201006238"
"4771","6365","6357","9","6366","32123","1396.54125","0.01815503625","7064821.164375088","91.8426751368738"
"4772","6366","6365","8","6373","32131","1398.0768750000002","0.018174999375","7066219.241250088","91.8608501362488"
"4773","6373","6367","9","6376","32140","1398.7350000000001","0.018183555","7067617.976250089","91.8790336912488"
"4774","6376","6371","6","6377","32146","1398.9543749999998","0.018186406874999995","7069016.9306250885","91.8972200981238"
"4775","6377","6374","6","6380","32152","1399.6125","0.0181949625","7070416.543125088","91.9154150606238"
"4776","6380","6378","6","6384","32158","1400.49","0.01820637","7071817.033125089","91.9336214306238"
"4777","6384","6383","2","6385","32160","1400.709375","0.018209221874999997","7073217.742500088","91.9518306524988"
"4778","6385","6381","7","6388","32167","1401.3675","0.0182177775","7074619.110000088","91.9700484299988"
"4779","6388","6383","3","6386","32170","1400.92875","0.01821207375","7076020.038750088","91.98826050374879"
"4780","6386","6384","1","6385","32171","1400.709375","0.018209221874999997","7077420.7481250875","92.00646972562379"
"4781","6385","6383","1","6384","32172","1400.49","0.01820637","7078821.238125088","92.02467609562379"
"4782","6384","6375","5","6380","32177","1399.6125","0.0181949625","7080220.8506250875","92.0428710581238"
"4783","6380","6377","6","6383","32183","1400.270625","0.018203518125000002","7081621.121250087","92.0610745762488"
"4784","6383","6382","9","6391","32192","1402.025625","0.018226333124999997","7083023.146875087","92.0793009093738"
"4785","6391","6388","9","6397","32201","1403.3418749999998","0.018243444374999997","7084426.488750087","92.0975443537488"
"4786","6397","6388","8","6396","32209","1403.1225000000002","0.0182405925","7085829.611250087","92.11578494624881"
"4787","6396","6388","7","6395","32216","1402.903125","0.018237740625","7087232.514375087","92.1340226868738"
"4788","6395","6393","1","6394","32217","1402.68375","0.018234888749999997","7088635.198125087","92.1522575756238"
"4789","6394","6393","7","6400","32224","1404.0","0.018251999999999997","7090039.198125087","92.17050957562381"
"4790","6400","6391","4","6395","32228","1402.903125","0.018237740625","7091442.101250087","92.18874731624881"
"4791","6395","6390","1","6391","32229","1402.025625","0.018226333124999997","7092844.126875087","92.20697364937381"
"4792","6391","6387","6","6393","32235","1402.4643750000002","0.018232036875000003","7094246.591250087","92.22520568624881"
"4793","6393","6385","9","6394","32244","1402.68375","0.018234888749999997","7095649.275000087","92.24344057499881"
"4794","6394","6385","6","6391","32250","1402.025625","0.018226333124999997","7097051.300625087","92.26166690812381"
"4795","6391","6384","7","6391","32257","1402.025625","0.018226333124999997","7098453.326250087","92.27989324124881"
"4796","6391","6385","2","6387","32259","1401.148125","0.018214925625","7099854.474375087","92.29810816687382"
"4797","6387","6386","6","6392","32265","1402.245","0.018229185","7101256.719375087","92.31633735187381"
"4798","6392","6385","5","6390","32270","1401.80625","0.01822348125","7102658.525625087","92.33456083312382"
"4799","6390","6382","2","6384","32272","1400.49","0.01820637","7104059.015625088","92.35276720312382"
"4800","6384","6380","1","6381","32273","1399.831875","0.018197814375","7105458.847500088","92.37096501749882"
"4801","6381","6374","8","6382","32281","1400.0512499999998","0.018200666249999997","7106858.898750087","92.38916568374881"
"4802","6382","6374","6","6380","32287","1399.6125","0.0181949625","7108258.511250087","92.40736064624882"
"4803","6380","6374","3","6377","32290","1398.9543749999998","0.018186406874999995","7109657.465625087","92.42554705312382"
"4804","6377","6374","3","6377","32293","1398.9543749999998","0.018186406874999995","7111056.420000087","92.44373345999882"
"4805","6377","6371","6","6377","32299","1398.9543749999998","0.018186406874999995","7112455.374375086","92.46191986687383"
"4806","6377","6369","4","6373","32303","1398.0768750000002","0.018174999375","7113853.451250087","92.48009486624883"
"4807","6373","6371","4","6375","32307","1398.515625","0.018180703125","7115251.966875087","92.49827556937383"
"4808","6375","6367","1","6368","32308","1396.9800000000002","0.01816074","7116648.946875087","92.51643630937383"
"4809","6368","6367","7","6374","32315","1398.2962499999999","0.018177851249999998","7118047.243125087","92.53461416062383"
"4810","6374","6366","4","6370","32319","1397.41875","0.01816644375","7119444.661875087","92.55278060437384"
"4811","6370","6361","6","6367","32325","1396.760625","0.018157888124999997","7120841.422500087","92.57093849249884"
"4812","6367","6363","3","6366","32328","1396.54125","0.01815503625","7122237.963750087","92.58909352874883"
"4813","6366","6364","7","6371","32335","1397.6381250000002","0.018169295625","7123635.601875086","92.60726282437383"
"4814","6371","6367","3","6370","32338","1397.41875","0.01816644375","7125033.0206250865","92.62542926812384"
"4815","6370","6366","3","6369","32341","1397.199375","0.018163591875","7126430.220000086","92.64359285999883"
"4816","6369","6366","5","6371","32346","1397.6381250000002","0.018169295625","7127827.858125086","92.66176215562383"
"4817","6371","6367","4","6371","32350","1397.6381250000002","0.018169295625","7129225.4962500855","92.67993145124883"
"4818","6371","6363","1","6364","32351","1396.1025","0.018149332499999997","7130621.598750086","92.69808078374884"
"4819","6364","6356","4","6360","32355","1395.225","0.018137925","7132016.823750085","92.71621870874884"
"4820","6360","6357","3","6360","32358","1395.225","0.018137925","7133412.048750085","92.73435663374885"
"4821","6360","6353","8","6361","32366","1395.444375","0.018140776875","7134807.493125085","92.75249741062385"
"4822","6361","6355","2","6357","32368","1394.5668749999998","0.018129369374999996","7136202.060000084","92.77062677999885"
"4823","6357","6353","6","6359","32374","1395.005625","0.018135073124999998","7137597.065625085","92.78876185312384"
"4824","6359","6353","9","6362","32383","1395.66375","0.018143628749999998","7138992.729375085","92.80690548187384"
"4825","6362","6360","8","6368","32391","1396.9800000000002","0.01816074","7140389.709375085","92.82506622187384"
"4826","6368","6363","5","6368","32396","1396.9800000000002","0.01816074","7141786.689375086","92.84322696187384"
"4827","6368","6362","3","6365","32399","1396.321875","0.018152184375","7143183.011250086","92.86137914624884"
"4828","6365","6361","5","6366","32404","1396.54125","0.01815503625","7144579.552500086","92.87953418249883"
"4829","6366","6359","8","6367","32412","1396.760625","0.018157888124999997","7145976.313125086","92.89769207062383"
"4830","6367","6363","2","6365","32414","1396.321875","0.018152184375","7147372.635000086","92.91584425499883"
"4831","6365","6356","9","6365","32423","1396.321875","0.018152184375","7148768.956875087","92.93399643937383"
"4832","6365","6361","2","6363","32425","1395.883125","0.018146480625","7150164.840000086","92.95214291999883"
"4833","6363","6356","8","6364","32433","1396.1025","0.018149332499999997","7151560.9425000865","92.97029225249884"
"4834","6364","6362","5","6367","32438","1396.760625","0.018157888124999997","7152957.703125087","92.98845014062384"
"4835","6367","6362","4","6366","32442","1396.54125","0.01815503625","7154354.244375086","93.00660517687383"
"4836","6366","6357","4","6361","32446","1395.444375","0.018140776875","7155749.688750086","93.02474595374883"
"4837","6361","6355","4","6359","32450","1395.005625","0.018135073124999998","7157144.694375087","93.04288102687383"
"4838","6359","6356","6","6362","32456","1395.66375","0.018143628749999998","7158540.358125087","93.06102465562383"
"4839","6362","6357","9","6366","32465","1396.54125","0.01815503625","7159936.899375087","93.07917969187382"
"4840","6366","6362","7","6369","32472","1397.199375","0.018163591875","7161334.0987500865","93.09734328374881"
"4841","6369","6368","2","6370","32474","1397.41875","0.01816644375","7162731.517500087","93.11550972749882"
"4842","6370","6362","3","6365","32477","1396.321875","0.018152184375","7164127.839375087","93.13366191187382"
"4843","6365","6361","5","6366","32482","1396.54125","0.01815503625","7165524.380625087","93.15181694812381"
"4844","6366","6362","7","6369","32489","1397.199375","0.018163591875","7166921.580000087","93.1699805399988"
"4845","6369","6365","5","6370","32494","1397.41875","0.01816644375","7168318.998750087","93.18814698374881"
"4846","6370","6368","4","6372","32498","1397.8574999999998","0.018172147499999996","7169716.856250087","93.2063191312488"
"4847","6372","6363","9","6372","32507","1397.8574999999998","0.018172147499999996","7171114.713750087","93.2244912787488"
"4848","6372","6367","8","6375","32515","1398.515625","0.018180703125","7172513.229375087","93.2426719818738"
"4849","6375","6372","2","6374","32517","1398.2962499999999","0.018177851249999998","7173911.525625086","93.2608498331238"
"4850","6374","6372","8","6380","32525","1399.6125","0.0181949625","7175311.138125086","93.2790447956238"
"4851","6380","6378","5","6383","32530","1400.270625","0.018203518125000002","7176711.408750086","93.29724831374881"
"4852","6383","6375","3","6378","32533","1399.1737500000002","0.01818925875","7178110.582500086","93.31543757249881"
"4853","6378","6369","5","6374","32538","1398.2962499999999","0.018177851249999998","7179508.878750086","93.33361542374881"
"4854","6374","6367","9","6376","32547","1398.7350000000001","0.018183555","7180907.613750086","93.3517989787488"
"4855","6376","6368","3","6371","32550","1397.6381250000002","0.018169295625","7182305.251875086","93.3699682743738"
"4856","6371","6363","8","6371","32558","1397.6381250000002","0.018169295625","7183702.890000085","93.3881375699988"
"4857","6371","6365","4","6369","32562","1397.199375","0.018163591875","7185100.089375085","93.4063011618738"
"4858","6369","6363","5","6368","32567","1396.9800000000002","0.01816074","7186497.069375086","93.4244619018738"
"4859","6368","6360","6","6366","32573","1396.54125","0.01815503625","7187893.610625085","93.44261693812379"
"4860","6366","6365","9","6374","32582","1398.2962499999999","0.018177851249999998","7189291.906875085","93.4607947893738"
"4861","6374","6373","5","6378","32587","1399.1737500000002","0.01818925875","7190691.080625085","93.47898404812379"
"4862","6378","6374","8","6382","32595","1400.0512499999998","0.018200666249999997","7192091.131875085","93.49718471437379"
"4863","6382","6377","7","6384","32602","1400.49","0.01820637","7193491.621875085","93.51539108437379"
"4864","6384","6381","7","6388","32609","1401.3675","0.0182177775","7194892.989375085","93.53360886187379"
"4865","6388","6383","5","6388","32614","1401.3675","0.0182177775","7196294.356875084","93.55182663937379"
"4866","6388","6381","6","6387","32620","1401.148125","0.018214925625","7197695.505000085","93.57004156499879"
"4867","6387","6384","2","6386","32622","1400.92875","0.01821207375","7199096.433750085","93.58825363874878"
"4868","6386","6378","9","6387","32631","1401.148125","0.018214925625","7200497.581875085","93.60646856437378"
"4869","6387","6378","1","6379","32632","1399.3931249999998","0.018192110624999997","7201896.975000085","93.62466067499878"
"4870","6379","6372","9","6381","32641","1399.831875","0.018197814375","7203296.806875085","93.64285848937378"
"4871","6381","6372","7","6379","32648","1399.3931249999998","0.018192110624999997","7204696.200000086","93.66105059999877"
"4872","6379","6372","9","6381","32657","1399.831875","0.018197814375","7206096.031875086","93.67924841437377"
"4873","6381","6374","9","6383","32666","1400.270625","0.018203518125000002","7207496.302500086","93.69745193249878"
"4874","6383","6379","4","6383","32670","1400.270625","0.018203518125000002","7208896.573125086","93.71565545062379"
"4875","6383","6375","2","6377","32672","1398.9543749999998","0.018186406874999995","7210295.5275000855","93.73384185749879"
"4876","6377","6370","7","6377","32679","1398.9543749999998","0.018186406874999995","7211694.481875085","93.75202826437379"
"4877","6377","6372","7","6379","32686","1399.3931249999998","0.018192110624999997","7213093.875000086","93.77022037499879"
"4878","6379","6377","5","6382","32691","1400.0512499999998","0.018200666249999997","7214493.926250085","93.78842104124878"
"4879","6382","6377","3","6380","32694","1399.6125","0.0181949625","7215893.538750085","93.80661600374879"
"4880","6380","6377","9","6386","32703","1400.92875","0.01821207375","7217294.467500085","93.82482807749878"
"4881","6386","6385","2","6387","32705","1401.148125","0.018214925625","7218695.615625085","93.84304300312378"
"4882","6387","6382","6","6388","32711","1401.3675","0.0182177775","7220096.983125085","93.86126078062378"
"4883","6388","6385","4","6389","32715","1401.586875","0.018220629375","7221498.570000085","93.87948140999877"
"4884","6389","6383","1","6384","32716","1400.49","0.01820637","7222899.060000085","93.89768777999878"
"4885","6384","6382","6","6388","32722","1401.3675","0.0182177775","7224300.427500085","93.91590555749877"
"4886","6388","6384","4","6388","32726","1401.3675","0.0182177775","7225701.795000085","93.93412333499877"
"4887","6388","6381","5","6386","32731","1400.92875","0.01821207375","7227102.723750085","93.95233540874877"
"4888","6386","6383","1","6384","32732","1400.49","0.01820637","7228503.213750085","93.97054177874877"
"4889","6384","6375","4","6379","32736","1399.3931249999998","0.018192110624999997","7229902.606875085","93.98873388937376"
"4890","6379","6375","2","6377","32738","1398.9543749999998","0.018186406874999995","7231301.561250085","94.00692029624877"
"4891","6377","6373","2","6375","32740","1398.515625","0.018180703125","7232700.076875085","94.02510099937376"
"4892","6375","6369","5","6374","32745","1398.2962499999999","0.018177851249999998","7234098.373125085","94.04327885062376"
"4893","6374","6373","4","6377","32749","1398.9543749999998","0.018186406874999995","7235497.327500084","94.06146525749877"
"4894","6377","6373","7","6380","32756","1399.6125","0.0181949625","7236896.940000084","94.07966021999877"
"4895","6380","6379","6","6385","32762","1400.709375","0.018209221874999997","7238297.649375084","94.09786944187377"
"4896","6385","6383","6","6389","32768","1401.586875","0.018220629375","7239699.236250084","94.11609007124876"
"4897","6389","6387","4","6391","32772","1402.025625","0.018226333124999997","7241101.261875084","94.13431640437376"
"4898","6391","6386","7","6393","32779","1402.4643750000002","0.018232036875000003","7242503.726250084","94.15254844124877"
"4899","6393","6392","5","6397","32784","1403.3418749999998","0.018243444374999997","7243907.068125084","94.17079188562377"
"4900","6397","6395","4","6399","32788","1403.7806249999999","0.018249148124999996","7245310.848750084","94.18904103374877"
"4901","6399","6394","4","6398","32792","1403.5612500000002","0.018246296250000002","7246714.410000084","94.20728732999876"
"4902","6398","6389","7","6396","32799","1403.1225000000002","0.0182405925","7248117.532500084","94.22552792249877"
"4903","6396","6393","3","6396","32802","1403.1225000000002","0.0182405925","7249520.655000083","94.24376851499878"
"4904","6396","6390","3","6393","32805","1402.4643750000002","0.018232036875000003","7250923.119375084","94.26200055187378"
"4905","6393","6389","7","6396","32812","1403.1225000000002","0.0182405925","7252326.241875083","94.28024114437379"
"4906","6396","6394","4","6398","32816","1403.5612500000002","0.018246296250000002","7253729.803125083","94.29848744062379"
"4907","6398","6395","1","6396","32817","1403.1225000000002","0.0182405925","7255132.925625083","94.3167280331238"
"4908","6396","6387","9","6396","32826","1403.1225000000002","0.0182405925","7256536.048125083","94.3349686256238"
"4909","6396","6394","1","6395","32827","1402.903125","0.018237740625","7257938.951250083","94.3532063662488"
"4910","6395","6393","9","6402","32836","1404.4387499999998","0.018257703749999996","7259343.390000083","94.3714640699988"
"4911","6402","6401","7","6408","32843","1405.755","0.018274815","7260749.145000082","94.38973888499879"
"4912","6408","6404","1","6405","32844","1405.096875","0.018266259375","7262154.241875082","94.40800514437379"
"4913","6405","6404","8","6412","32852","1406.6325","0.018286222499999998","7263560.874375083","94.42629136687378"
"4914","6412","6410","1","6411","32853","1406.413125","0.018283370625","7264967.2875000825","94.44457473749878"
"4915","6411","6402","5","6407","32858","1405.5356249999998","0.018271963124999995","7266372.823125082","94.46284670062379"
"4916","6407","6405","4","6409","32862","1405.974375","0.018277666874999998","7267778.797500082","94.48112436749878"
"4917","6409","6406","8","6414","32870","1407.07125","0.01829192625","7269185.868750082","94.49941629374878"
"4918","6414","6408","2","6410","32872","1406.19375","0.01828051875","7270592.062500082","94.51769681249878"
"4919","6410","6407","2","6409","32874","1405.974375","0.018277666874999998","7271998.036875082","94.53597447937378"
"4920","6409","6406","6","6412","32880","1406.6325","0.018286222499999998","7273404.6693750825","94.55426070187377"
"4921","6412","6403","3","6406","32883","1405.31625","0.01826911125","7274809.985625083","94.57252981312378"
"4922","6406","6404","2","6406","32885","1405.31625","0.01826911125","7276215.301875083","94.59079892437379"
"4923","6406","6401","3","6404","32888","1404.8774999999998","0.018263407499999995","7277620.179375083","94.60906233187379"
"4924","6404","6402","3","6405","32891","1405.096875","0.018266259375","7279025.276250083","94.62732859124878"
"4925","6405","6404","2","6406","32893","1405.31625","0.01826911125","7280430.592500083","94.64559770249879"
"4926","6406","6401","6","6407","32899","1405.5356249999998","0.018271963124999995","7281836.128125083","94.66386966562379"
"4927","6407","6403","9","6412","32908","1406.6325","0.018286222499999998","7283242.760625083","94.68215588812379"
"4928","6412","6410","1","6411","32909","1406.413125","0.018283370625","7284649.173750083","94.70043925874879"
"4929","6411","6410","2","6412","32911","1406.6325","0.018286222499999998","7286055.806250083","94.71872548124878"
"4930","6412","6407","8","6415","32919","1407.290625","0.018294778125","7287463.096875084","94.73702025937378"
"4931","6415","6410","8","6418","32927","1407.9487500000002","0.01830333375","7288871.045625084","94.75532359312378"
"4932","6418","6409","6","6415","32933","1407.290625","0.018294778125","7290278.336250084","94.77361837124877"
"4933","6415","6407","3","6410","32936","1406.19375","0.01828051875","7291684.530000084","94.79189888999878"
"4934","6410","6401","4","6405","32940","1405.096875","0.018266259375","7293089.626875084","94.81016514937377"
"4935","6405","6399","2","6401","32942","1404.2193750000001","0.018254851875000002","7294493.846250084","94.82842000124877"
"4936","6401","6394","7","6401","32949","1404.2193750000001","0.018254851875000002","7295898.065625085","94.84667485312377"
"4937","6401","6397","8","6405","32957","1405.096875","0.018266259375","7297303.162500084","94.86494111249877"
"4938","6405","6403","7","6410","32964","1406.19375","0.01828051875","7298709.356250084","94.88322163124877"
"4939","6410","6402","3","6405","32967","1405.096875","0.018266259375","7300114.453125084","94.90148789062377"
"4940","6405","6404","9","6413","32976","1406.851875","0.018289074375","7301521.3050000835","94.91977696499877"
"4941","6413","6405","9","6414","32985","1407.07125","0.01829192625","7302928.376250084","94.93806889124878"
"4942","6414","6411","8","6419","32993","1408.168125","0.018306185625","7304336.544375083","94.95637507687377"
"4943","6419","6411","1","6412","32994","1406.6325","0.018286222499999998","7305743.176875084","94.97466129937376"
"4944","6412","6408","6","6414","33000","1407.07125","0.01829192625","7307150.248125084","94.99295322562376"
"4945","6414","6406","8","6414","33008","1407.07125","0.01829192625","7308557.319375084","95.01124515187377"
"4946","6414","6411","6","6417","33014","1407.729375","0.018300481874999996","7309965.048750084","95.02954563374877"
"4947","6417","6409","9","6418","33023","1407.9487500000002","0.01830333375","7311372.997500084","95.04784896749877"
"4948","6418","6416","5","6421","33028","1408.6068750000002","0.018311889375","7312781.604375084","95.06616085687376"
"4949","6421","6419","7","6426","33035","1409.7037500000001","0.01832614875","7314191.308125084","95.08448700562377"
"4950","6426","6424","5","6429","33040","1410.3618749999998","0.018334704374999997","7315601.670000085","95.10282170999876"
"4951","6429","6428","4","6432","33044","1411.0199999999998","0.018343259999999997","7317012.690000084","95.12116496999876"
"4952","6432","6431","6","6437","33050","1412.116875","0.018357519375","7318424.8068750845","95.13952248937376"
"4953","6437","6436","6","6442","33056","1413.21375","0.018371778749999998","7319838.020625085","95.15789426812375"
"4954","6442","6438","1","6439","33057","1412.555625","0.018363223124999998","7321250.576250085","95.17625749124875"
"4955","6439","6437","7","6444","33064","1413.6525","0.018377482499999997","7322664.2287500845","95.19463497374875"
"4956","6444","6436","5","6441","33069","1412.994375","0.018368926875","7324077.223125084","95.21300390062375"
"4957","6441","6440","4","6444","33073","1413.6525","0.018377482499999997","7325490.875625084","95.23138138312375"
"4958","6444","6443","8","6451","33081","1415.1881250000001","0.018397445625","7326906.0637500845","95.24977882874875"
"4959","6451","6444","4","6448","33085","1414.5300000000002","0.01838889","7328320.593750085","95.26816771874874"
"4960","6448","6439","2","6441","33087","1412.994375","0.018368926875","7329733.5881250845","95.28653664562374"
"4961","6441","6436","2","6438","33089","1412.33625","0.01836037125","7331145.924375084","95.30489701687374"
"4962","6438","6430","5","6435","33094","1411.678125","0.018351815624999997","7332557.602500084","95.32324883249873"
"4963","6435","6426","9","6435","33103","1411.678125","0.018351815624999997","7333969.2806250835","95.34160064812373"
"4964","6435","6429","2","6431","33105","1410.800625","0.018340408125","7335380.081250084","95.35994105624873"
"4965","6431","6423","7","6430","33112","1410.58125","0.018337556249999998","7336790.662500083","95.37827861249873"
"4966","6430","6428","9","6437","33121","1412.116875","0.018357519375","7338202.779375084","95.39663613187373"
"4967","6437","6434","2","6436","33123","1411.8975","0.018354667499999998","7339614.676875084","95.41499079937374"
"4968","6436","6430","1","6431","33124","1410.800625","0.018340408125","7341025.477500084","95.43333120749874"
"4969","6431","6422","3","6425","33127","1409.484375","0.018323296875","7342434.961875084","95.45165450437374"
"4970","6425","6422","8","6430","33135","1410.58125","0.018337556249999998","7343845.543125084","95.46999206062374"
"4971","6430","6422","8","6430","33143","1410.58125","0.018337556249999998","7345256.1243750835","95.48832961687374"
"4972","6430","6427","4","6431","33147","1410.800625","0.018340408125","7346666.925000084","95.50667002499874"
"4973","6431","6423","4","6427","33151","1409.9231249999998","0.018329000624999998","7348076.848125083","95.52499902562374"
"4974","6427","6423","5","6428","33156","1410.1425000000002","0.018331852500000002","7349486.990625083","95.54333087812374"
"4975","6428","6425","6","6431","33162","1410.800625","0.018340408125","7350897.791250084","95.56167128624874"
"4976","6431","6430","1","6431","33163","1410.800625","0.018340408125","7352308.591875084","95.58001169437374"
"4977","6431","6430","8","6438","33171","1412.33625","0.01836037125","7353720.928125083","95.59837206562374"
"4978","6438","6435","1","6436","33172","1411.8975","0.018354667499999998","7355132.825625083","95.61672673312374"
"4979","6436","6427","2","6429","33174","1410.3618749999998","0.018334704374999997","7356543.187500084","95.63506143749873"
"4980","6429","6420","9","6429","33183","1410.3618749999998","0.018334704374999997","7357953.549375084","95.65339614187373"
"4981","6429","6428","4","6432","33187","1411.0199999999998","0.018343259999999997","7359364.569375084","95.67173940187372"
"4982","6432","6423","4","6427","33191","1409.9231249999998","0.018329000624999998","7360774.4925000835","95.69006840249872"
"4983","6427","6422","3","6425","33194","1409.484375","0.018323296875","7362183.9768750835","95.70839169937372"
"4984","6425","6423","1","6424","33195","1409.2649999999999","0.018320444999999998","7363593.241875083","95.72671214437372"
"4985","6424","6422","3","6425","33198","1409.484375","0.018323296875","7365002.726250083","95.74503544124872"
"4986","6425","6422","5","6427","33203","1409.9231249999998","0.018329000624999998","7366412.649375083","95.76336444187372"
"4987","6427","6419","8","6427","33211","1409.9231249999998","0.018329000624999998","7367822.572500083","95.78169344249872"
"4988","6427","6418","7","6425","33218","1409.484375","0.018323296875","7369232.056875083","95.80001673937372"
"4989","6425","6416","2","6418","33220","1407.9487500000002","0.01830333375","7370640.005625083","95.81832007312372"
"4990","6418","6417","8","6425","33228","1409.484375","0.018323296875","7372049.490000083","95.83664336999871"
"4991","6425","6422","9","6431","33237","1410.800625","0.018340408125","7373460.290625083","95.85498377812371"
"4992","6431","6422","8","6430","33245","1410.58125","0.018337556249999998","7374870.871875083","95.87332133437371"
"4993","6430","6428","1","6429","33246","1410.3618749999998","0.018334704374999997","7376281.2337500835","95.8916560387487"
"4994","6429","6420","7","6427","33253","1409.9231249999998","0.018329000624999998","7377691.156875083","95.90998503937371"
"4995","6427","6422","7","6429","33260","1410.3618749999998","0.018334704374999997","7379101.518750084","95.9283197437487"
"4996","6429","6424","5","6429","33265","1410.3618749999998","0.018334704374999997","7380511.880625084","95.9466544481237"
"4997","6429","6422","3","6425","33268","1409.484375","0.018323296875","7381921.365000084","95.96497774499869"
"4998","6425","6422","8","6430","33276","1410.58125","0.018337556249999998","7383331.946250084","95.9833153012487"
"4999","6430","6422","7","6429","33283","1410.3618749999998","0.018334704374999997","7384742.308125084","96.00165000562369"
"5000","6429","6425","7","6432","33290","1411.0199999999998","0.018343259999999997","7386153.328125084","96.01999326562368"
"5001","6432","6431","1","6432","33291","1411.0199999999998","0.018343259999999997","7387564.348125083","96.03833652562368"
"5002","6432","6425","7","6432","33298","1411.0199999999998","0.018343259999999997","7388975.368125083","96.05667978562367"
"5003","6432","6425","3","6428","33301","1410.1425000000002","0.018331852500000002","7390385.510625083","96.07501163812367"
"5004","6428","6424","1","6425","33302","1409.484375","0.018323296875","7391794.995000083","96.09333493499867"
"5005","6425","6421","5","6426","33307","1409.7037500000001","0.01832614875","7393204.698750083","96.11166108374867"
"5006","6426","6417","2","6419","33309","1408.168125","0.018306185625","7394612.866875083","96.12996726937367"
"5007","6419","6417","4","6421","33313","1408.6068750000002","0.018311889375","7396021.473750083","96.14827915874866"
"5008","6421","6412","4","6416","33317","1407.51","0.01829763","7397428.983750083","96.16657678874867"
"5009","6416","6412","8","6420","33325","1408.3875","0.0183090375","7398837.371250083","96.18488582624867"
"5010","6420","6418","9","6427","33334","1409.9231249999998","0.018329000624999998","7400247.2943750825","96.20321482687368"
"5011","6427","6424","3","6427","33337","1409.9231249999998","0.018329000624999998","7401657.217500082","96.22154382749868"
"5012","6427","6425","2","6427","33339","1409.9231249999998","0.018329000624999998","7403067.140625082","96.23987282812368"
"5013","6427","6426","1","6427","33340","1409.9231249999998","0.018329000624999998","7404477.063750082","96.25820182874868"
"5014","6427","6426","1","6427","33341","1409.9231249999998","0.018329000624999998","7405886.986875081","96.27653082937368"
"5015","6427","6419","9","6428","33350","1410.1425000000002","0.018331852500000002","7407297.1293750815","96.29486268187368"
"5016","6428","6425","6","6431","33356","1410.800625","0.018340408125","7408707.930000082","96.31320308999868"
"5017","6431","6428","3","6431","33359","1410.800625","0.018340408125","7410118.730625082","96.33154349812368"
"5018","6431","6423","1","6424","33360","1409.2649999999999","0.018320444999999998","7411527.9956250815","96.34986394312368"
"5019","6424","6415","8","6423","33368","1409.0456250000002","0.018317593125","7412937.041250082","96.36818153624868"
"5020","6423","6415","5","6420","33373","1408.3875","0.0183090375","7414345.428750082","96.38649057374869"
"5021","6420","6415","3","6418","33376","1407.9487500000002","0.01830333375","7415753.377500082","96.40479390749869"
"5022","6418","6412","3","6415","33379","1407.290625","0.018294778125","7417160.668125083","96.42308868562368"
"5023","6415","6409","1","6410","33380","1406.19375","0.01828051875","7418566.861875082","96.44136920437369"
"5024","6410","6404","8","6412","33388","1406.6325","0.018286222499999998","7419973.494375083","96.45965542687368"
"5025","6412","6405","6","6411","33394","1406.413125","0.018283370625","7421379.907500083","96.47793879749868"
"5026","6411","6406","6","6412","33400","1406.6325","0.018286222499999998","7422786.540000083","96.49622501999868"
"5027","6412","6405","2","6407","33402","1405.5356249999998","0.018271963124999995","7424192.0756250825","96.51449698312368"
"5028","6407","6402","3","6405","33405","1405.096875","0.018266259375","7425597.172500082","96.53276324249867"
"5029","6405","6399","8","6407","33413","1405.5356249999998","0.018271963124999995","7427002.708125082","96.55103520562368"
"5030","6407","6398","7","6405","33420","1405.096875","0.018266259375","7428407.805000082","96.56930146499867"
"5031","6405","6403","4","6407","33424","1405.5356249999998","0.018271963124999995","7429813.340625081","96.58757342812368"
"5032","6407","6400","1","6401","33425","1404.2193750000001","0.018254851875000002","7431217.560000082","96.60582827999868"
"5033","6401","6393","6","6399","33431","1403.7806249999999","0.018249148124999996","7432621.340625081","96.62407742812367"
"5034","6399","6394","1","6395","33432","1402.903125","0.018237740625","7434024.243750081","96.64231516874867"
"5035","6395","6387","4","6391","33436","1402.025625","0.018226333124999997","7435426.269375081","96.66054150187367"
"5036","6391","6389","7","6396","33443","1403.1225000000002","0.0182405925","7436829.391875081","96.67878209437367"
"5037","6396","6389","6","6395","33449","1402.903125","0.018237740625","7438232.295000081","96.69701983499867"
"5038","6395","6394","3","6397","33452","1403.3418749999998","0.018243444374999997","7439635.636875081","96.71526327937367"
"5039","6397","6393","4","6397","33456","1403.3418749999998","0.018243444374999997","7441038.978750081","96.73350672374868"
"5040","6397","6396","1","6397","33457","1403.3418749999998","0.018243444374999997","7442442.320625081","96.75175016812368"
"5041","6397","6388","9","6397","33466","1403.3418749999998","0.018243444374999997","7443845.662500081","96.76999361249868"
"5042","6397","6394","4","6398","33470","1403.5612500000002","0.018246296250000002","7445249.223750081","96.78823990874868"
"5043","6398","6395","2","6397","33472","1403.3418749999998","0.018243444374999997","7446652.565625081","96.80648335312368"
"5044","6397","6396","7","6403","33479","1404.6581250000002","0.018260555625","7448057.223750081","96.82474390874869"
"5045","6403","6394","2","6396","33481","1403.1225000000002","0.0182405925","7449460.3462500805","96.8429845012487"
"5046","6396","6393","6","6399","33487","1403.7806249999999","0.018249148124999996","7450864.12687508","96.86123364937369"
"5047","6399","6396","3","6399","33490","1403.7806249999999","0.018249148124999996","7452267.90750008","96.87948279749868"
"5048","6399","6396","3","6399","33493","1403.7806249999999","0.018249148124999996","7453671.6881250795","96.89773194562368"
"5049","6399","6397","1","6398","33494","1403.5612500000002","0.018246296250000002","7455075.24937508","96.91597824187367"
"5050","6398","6390","3","6393","33497","1402.4643750000002","0.018232036875000003","7456477.71375008","96.93421027874868"
"5051","6393","6391","9","6400","33506","1404.0","0.018251999999999997","7457881.71375008","96.95246227874868"
"5052","6400","6391","4","6395","33510","1402.903125","0.018237740625","7459284.61687508","96.97070001937368"
"5053","6395","6388","1","6389","33511","1401.586875","0.018220629375","7460686.20375008","96.98892064874867"
"5054","6389","6384","3","6387","33514","1401.148125","0.018214925625","7462087.351875081","97.00713557437368"
"5055","6387","6380","8","6388","33522","1401.3675","0.0182177775","7463488.71937508","97.02535335187368"
"5056","6388","6379","1","6380","33523","1399.6125","0.0181949625","7464888.33187508","97.04354831437368"
"5057","6380","6375","9","6384","33532","1400.49","0.01820637","7466288.8218750805","97.06175468437368"
"5058","6384","6382","7","6389","33539","1401.586875","0.018220629375","7467690.4087500805","97.07997531374868"
"5059","6389","6381","1","6382","33540","1400.0512499999998","0.018200666249999997","7469090.46000008","97.09817597999867"
"5060","6382","6375","5","6380","33545","1399.6125","0.0181949625","7470490.07250008","97.11637094249868"
"5061","6380","6379","6","6385","33551","1400.709375","0.018209221874999997","7471890.7818750795","97.13458016437367"
"5062","6385","6378","3","6381","33554","1399.831875","0.018197814375","7473290.61375008","97.15277797874867"
"5063","6381","6376","5","6381","33559","1399.831875","0.018197814375","7474690.44562508","97.17097579312367"
"5064","6381","6374","4","6378","33563","1399.1737500000002","0.01818925875","7476089.61937508","97.18916505187367"
"5065","6378","6374","2","6376","33565","1398.7350000000001","0.018183555","7477488.35437508","97.20734860687367"
"5066","6376","6367","4","6371","33569","1397.6381250000002","0.018169295625","7478885.99250008","97.22551790249867"
"5067","6371","6369","9","6378","33578","1399.1737500000002","0.01818925875","7480285.16625008","97.24370716124866"
"5068","6378","6377","7","6384","33585","1400.49","0.01820637","7481685.65625008","97.26191353124867"
"5069","6384","6383","6","6389","33591","1401.586875","0.018220629375","7483087.24312508","97.28013416062366"
"5070","6389","6383","8","6391","33599","1402.025625","0.018226333124999997","7484489.26875008","97.29836049374866"
"5071","6391","6387","3","6390","33602","1401.80625","0.01822348125","7485891.07500008","97.31658397499866"
"5072","6390","6381","1","6382","33603","1400.0512499999998","0.018200666249999997","7487291.12625008","97.33478464124866"
"5073","6382","6381","1","6382","33604","1400.0512499999998","0.018200666249999997","7488691.177500079","97.35298530749866"
"5074","6382","6375","9","6384","33613","1400.49","0.01820637","7490091.66750008","97.37119167749866"
"5075","6384","6383","8","6391","33621","1402.025625","0.018226333124999997","7491493.693125079","97.38941801062366"
"5076","6391","6389","5","6394","33626","1402.68375","0.018234888749999997","7492896.376875079","97.40765289937366"
"5077","6394","6393","1","6394","33627","1402.68375","0.018234888749999997","7494299.060625079","97.42588778812366"
"5078","6394","6385","5","6390","33632","1401.80625","0.01822348125","7495700.866875079","97.44411126937366"
"5079","6390","6386","9","6395","33641","1402.903125","0.018237740625","7497103.77000008","97.46234900999866"
"5080","6395","6393","4","6397","33645","1403.3418749999998","0.018243444374999997","7498507.11187508","97.48059245437366"
"5081","6397","6388","7","6395","33652","1402.903125","0.018237740625","7499910.01500008","97.49883019499866"
"5082","6395","6391","4","6395","33656","1402.903125","0.018237740625","7501312.91812508","97.51706793562366"
"5083","6395","6391","2","6393","33658","1402.4643750000002","0.018232036875000003","7502715.38250008","97.53529997249866"
"5084","6393","6384","7","6391","33665","1402.025625","0.018226333124999997","7504117.40812508","97.55352630562366"
"5085","6391","6387","3","6390","33668","1401.80625","0.01822348125","7505519.214375081","97.57174978687367"
"5086","6390","6382","9","6391","33677","1402.025625","0.018226333124999997","7506921.24000008","97.58997611999867"
"5087","6391","6382","4","6386","33681","1400.92875","0.01821207375","7508322.16875008","97.60818819374866"
"5088","6386","6377","5","6382","33686","1400.0512499999998","0.018200666249999997","7509722.22000008","97.62638885999866"
"5089","6382","6378","3","6381","33689","1399.831875","0.018197814375","7511122.05187508","97.64458667437366"
"5090","6381","6377","9","6386","33698","1400.92875","0.01821207375","7512522.98062508","97.66279874812365"
"5091","6386","6384","5","6389","33703","1401.586875","0.018220629375","7513924.56750008","97.68101937749864"
"5092","6389","6385","1","6386","33704","1400.92875","0.01821207375","7515325.49625008","97.69923145124864"
"5093","6386","6378","7","6385","33711","1400.709375","0.018209221874999997","7516726.20562508","97.71744067312363"
"5094","6385","6376","7","6383","33718","1400.270625","0.018203518125000002","7518126.476250079","97.73564419124864"
"5095","6383","6380","1","6381","33719","1399.831875","0.018197814375","7519526.30812508","97.75384200562364"
"5096","6381","6374","2","6376","33721","1398.7350000000001","0.018183555","7520925.04312508","97.77202556062363"
"5097","6376","6369","5","6374","33726","1398.2962499999999","0.018177851249999998","7522323.33937508","97.79020341187363"
"5098","6374","6368","5","6373","33731","1398.0768750000002","0.018174999375","7523721.41625008","97.80837841124864"
"5099","6373","6366","5","6371","33736","1397.6381250000002","0.018169295625","7525119.054375079","97.82654770687364"
"5100","6371","6362","8","6370","33744","1397.41875","0.01816644375","7526516.47312508","97.84471415062364"
"5101","6370","6364","9","6373","33753","1398.0768750000002","0.018174999375","7527914.55000008","97.86288914999865"
"5102","6373","6370","2","6372","33755","1397.8574999999998","0.018172147499999996","7529312.40750008","97.88106129749865"
"5103","6372","6365","8","6373","33763","1398.0768750000002","0.018174999375","7530710.48437508","97.89923629687365"
"5104","6373","6364","1","6365","33764","1396.321875","0.018152184375","7532106.8062500805","97.91738848124865"
"5105","6365","6362","3","6365","33767","1396.321875","0.018152184375","7533503.128125081","97.93554066562365"
"5106","6365","6356","5","6361","33772","1395.444375","0.018140776875","7534898.572500081","97.95368144249865"
"5107","6361","6355","7","6362","33779","1395.66375","0.018143628749999998","7536294.236250081","97.97182507124865"
"5108","6362","6360","9","6369","33788","1397.199375","0.018163591875","7537691.435625081","97.98998866312364"
"5109","6369","6361","6","6367","33794","1396.760625","0.018157888124999997","7539088.196250081","98.00814655124864"
"5110","6367","6366","3","6369","33797","1397.199375","0.018163591875","7540485.395625081","98.02631014312364"
"5111","6369","6367","6","6373","33803","1398.0768750000002","0.018174999375","7541883.472500081","98.04448514249864"
"5112","6373","6369","2","6371","33805","1397.6381250000002","0.018169295625","7543281.110625081","98.06265443812364"
"5113","6371","6366","7","6373","33812","1398.0768750000002","0.018174999375","7544679.187500081","98.08082943749865"
"5114","6373","6372","6","6378","33818","1399.1737500000002","0.01818925875","7546078.361250081","98.09901869624865"
"5115","6378","6371","9","6380","33827","1399.6125","0.0181949625","7547477.973750081","98.11721365874865"
"5116","6380","6372","3","6375","33830","1398.515625","0.018180703125","7548876.489375081","98.13539436187365"
"5117","6375","6371","2","6373","33832","1398.0768750000002","0.018174999375","7550274.566250081","98.15356936124866"
"5118","6373","6368","3","6371","33835","1397.6381250000002","0.018169295625","7551672.204375081","98.17173865687366"
"5119","6371","6363","9","6372","33844","1397.8574999999998","0.018172147499999996","7553070.061875081","98.18991080437365"
"5120","6372","6368","3","6371","33847","1397.6381250000002","0.018169295625","7554467.70000008","98.20808009999865"
"5121","6371","6367","1","6368","33848","1396.9800000000002","0.01816074","7555864.680000081","98.22624083999865"
"5122","6368","6363","9","6372","33857","1397.8574999999998","0.018172147499999996","7557262.537500081","98.24441298749865"
"5123","6372","6368","9","6377","33866","1398.9543749999998","0.018186406874999995","7558661.49187508","98.26259939437365"
"5124","6377","6375","9","6384","33875","1400.49","0.01820637","7560061.981875081","98.28080576437365"
"5125","6384","6375","2","6377","33877","1398.9543749999998","0.018186406874999995","7561460.93625008","98.29899217124866"
"5126","6377","6369","3","6372","33880","1397.8574999999998","0.018172147499999996","7562858.79375008","98.31716431874865"
"5127","6372","6366","3","6369","33883","1397.199375","0.018163591875","7564255.99312508","98.33532791062365"
"5128","6369","6360","1","6361","33884","1395.444375","0.018140776875","7565651.43750008","98.35346868749865"
"5129","6361","6352","8","6360","33892","1395.225","0.018137925","7567046.66250008","98.37160661249865"
"5130","6360","6358","7","6365","33899","1396.321875","0.018152184375","7568442.98437508","98.38975879687365"
"5131","6365","6359","4","6363","33903","1395.883125","0.018146480625","7569838.86750008","98.40790527749866"
"5132","6363","6354","2","6356","33905","1394.3475","0.0181265175","7571233.21500008","98.42603179499865"
"5133","6356","6348","6","6354","33911","1393.9087499999998","0.018120813749999996","7572627.12375008","98.44415260874865"
"5134","6354","6349","3","6352","33914","1393.4699999999998","0.018115109999999997","7574020.59375008","98.46226771874865"
"5135","6352","6345","3","6348","33917","1392.5925000000002","0.018103702500000003","7575413.18625008","98.48037142124865"
"5136","6348","6339","8","6347","33925","1392.3731249999998","0.018100850624999998","7576805.55937508","98.49847227187365"
"5137","6347","6344","7","6351","33932","1393.2506250000001","0.018112258125","7578198.810000081","98.51658452999865"
"5138","6351","6350","6","6356","33938","1394.3475","0.0181265175","7579593.157500081","98.53471104749865"
"5139","6356","6349","9","6358","33947","1394.78625","0.01813222125","7580987.943750081","98.55284326874865"
"5140","6358","6351","6","6357","33953","1394.5668749999998","0.018129369374999996","7582382.51062508","98.57097263812365"
"5141","6357","6353","2","6355","33955","1394.128125","0.018123665624999997","7583776.63875008","98.58909630374865"
"5142","6355","6351","4","6355","33959","1394.128125","0.018123665624999997","7585170.76687508","98.60721996937365"
"5143","6355","6353","4","6357","33963","1394.5668749999998","0.018129369374999996","7586565.333750079","98.62534933874865"
"5144","6357","6351","6","6357","33969","1394.5668749999998","0.018129369374999996","7587959.900625079","98.64347870812365"
"5145","6357","6348","6","6354","33975","1393.9087499999998","0.018120813749999996","7589353.809375079","98.66159952187365"
"5146","6354","6346","8","6354","33983","1393.9087499999998","0.018120813749999996","7590747.71812508","98.67972033562366"
"5147","6354","6348","8","6356","33991","1394.3475","0.0181265175","7592142.06562508","98.69784685312365"
"5148","6356","6352","9","6361","34000","1395.444375","0.018140776875","7593537.51000008","98.71598762999865"
"5149","6361","6355","6","6361","34006","1395.444375","0.018140776875","7594932.95437508","98.73412840687365"
"5150","6361","6356","9","6365","34015","1396.321875","0.018152184375","7596329.27625008","98.75228059124865"
"5151","6365","6360","5","6365","34020","1396.321875","0.018152184375","7597725.598125081","98.77043277562365"
"5152","6365","6362","1","6363","34021","1395.883125","0.018146480625","7599121.48125008","98.78857925624865"
"5153","6363","6354","7","6361","34028","1395.444375","0.018140776875","7600516.92562508","98.80672003312365"
"5154","6361","6356","7","6363","34035","1395.883125","0.018146480625","7601912.80875008","98.82486651374866"
"5155","6363","6361","1","6362","34036","1395.66375","0.018143628749999998","7603308.47250008","98.84301014249866"
"5156","6362","6360","3","6363","34039","1395.883125","0.018146480625","7604704.35562508","98.86115662312366"
"5157","6363","6355","5","6360","34044","1395.225","0.018137925","7606099.58062508","98.87929454812367"
"5158","6360","6353","1","6354","34045","1393.9087499999998","0.018120813749999996","7607493.48937508","98.89741536187367"
"5159","6354","6347","5","6352","34050","1393.4699999999998","0.018115109999999997","7608886.95937508","98.91553047187367"
"5160","6352","6344","9","6353","34059","1393.6893750000002","0.018117961875","7610280.64875008","98.93364843374867"
"5161","6353","6349","8","6357","34067","1394.5668749999998","0.018129369374999996","7611675.215625079","98.95177780312368"
"5162","6357","6351","3","6354","34070","1393.9087499999998","0.018120813749999996","7613069.12437508","98.96989861687368"
"5163","6354","6348","4","6352","34074","1393.4699999999998","0.018115109999999997","7614462.5943750795","98.98801372687367"
"5164","6352","6343","7","6350","34081","1393.03125","0.018109406249999998","7615855.6256250795","99.00612313312368"
"5165","6350","6342","6","6348","34087","1392.5925000000002","0.018103702500000003","7617248.21812508","99.02422683562368"
"5166","6348","6344","6","6350","34093","1393.03125","0.018109406249999998","7618641.24937508","99.04233624187368"
"5167","6350","6342","5","6347","34098","1392.3731249999998","0.018100850624999998","7620033.62250008","99.06043709249869"
"5168","6347","6344","6","6350","34104","1393.03125","0.018109406249999998","7621426.65375008","99.0785464987487"
"5169","6350","6345","2","6347","34106","1392.3731249999998","0.018100850624999998","7622819.02687508","99.0966473493737"
"5170","6347","6339","8","6347","34114","1392.3731249999998","0.018100850624999998","7624211.40000008","99.1147481999987"
"5171","6347","6338","5","6343","34119","1391.4956250000002","0.018089443125000004","7625602.89562508","99.13283764312371"
"5172","6343","6337","1","6338","34120","1390.39875","0.01807518375","7626993.29437508","99.15091282687371"
"5173","6338","6332","4","6336","34124","1389.96","0.01806948","7628383.25437508","99.1689823068737"
"5174","6336","6334","3","6337","34127","1390.179375","0.018072331874999997","7629773.43375008","99.1870546387487"
"5175","6337","6336","4","6340","34131","1390.8375","0.0180808875","7631164.27125008","99.20513552624871"
"5176","6340","6333","4","6337","34135","1390.179375","0.018072331874999997","7632554.450625081","99.22320785812371"
"5177","6337","6334","6","6340","34141","1390.8375","0.0180808875","7633945.288125081","99.24128874562372"
"5178","6340","6337","5","6342","34146","1391.27625","0.01808659125","7635336.564375081","99.25937533687372"
"5179","6342","6333","7","6340","34153","1390.8375","0.0180808875","7636727.4018750815","99.27745622437372"
"5180","6340","6337","4","6341","34157","1391.056875","0.018083739374999998","7638118.458750081","99.29553996374872"
"5181","6341","6338","6","6344","34163","1391.715","0.018092294999999998","7639510.173750081","99.31363225874873"
"5182","6344","6336","1","6337","34164","1390.179375","0.018072331874999997","7640900.353125081","99.33170459062373"
"5183","6337","6331","8","6339","34172","1390.618125","0.018078035625","7642290.971250081","99.34978262624873"
"5184","6339","6337","2","6339","34174","1390.618125","0.018078035625","7643681.5893750815","99.36786066187372"
"5185","6339","6332","8","6340","34182","1390.8375","0.0180808875","7645072.426875082","99.38594154937373"
"5186","6340","6334","5","6339","34187","1390.618125","0.018078035625","7646463.045000082","99.40401958499872"
"5187","6339","6338","2","6340","34189","1390.8375","0.0180808875","7647853.882500082","99.42210047249873"
"5188","6340","6332","8","6340","34197","1390.8375","0.0180808875","7649244.720000083","99.44018135999873"
"5189","6340","6337","7","6344","34204","1391.715","0.018092294999999998","7650636.4350000825","99.45827365499873"
"5190","6344","6338","6","6344","34210","1391.715","0.018092294999999998","7652028.150000082","99.47636594999874"
"5191","6344","6338","8","6346","34218","1392.1537500000002","0.01809799875","7653420.303750082","99.49446394874873"
"5192","6346","6339","5","6344","34223","1391.715","0.018092294999999998","7654812.018750082","99.51255624374873"
"5193","6344","6341","9","6350","34232","1393.03125","0.018109406249999998","7656205.050000082","99.53066564999874"
"5194","6350","6347","3","6350","34235","1393.03125","0.018109406249999998","7657598.081250082","99.54877505624874"
"5195","6350","6345","1","6346","34236","1392.1537500000002","0.01809799875","7658990.235000081","99.56687305499874"
"5196","6346","6342","4","6346","34240","1392.1537500000002","0.01809799875","7660382.388750081","99.58497105374873"
"5197","6346","6342","1","6343","34241","1391.4956250000002","0.018089443125000004","7661773.884375081","99.60306049687374"
"5198","6343","6341","9","6350","34250","1393.03125","0.018109406249999998","7663166.915625081","99.62116990312374"
"5199","6350","6348","3","6351","34253","1393.2506250000001","0.018112258125","7664560.166250082","99.63928216124874"
"5200","6351","6345","1","6346","34254","1392.1537500000002","0.01809799875","7665952.320000081","99.65738015999874"
"5201","6346","6342","1","6343","34255","1391.4956250000002","0.018089443125000004","7667343.815625082","99.67546960312374"
"5202","6343","6336","2","6338","34257","1390.39875","0.01807518375","7668734.2143750815","99.69354478687374"
"5203","6338","6333","8","6341","34265","1391.056875","0.018083739374999998","7670125.271250081","99.71162852624875"
"5204","6341","6334","4","6338","34269","1390.39875","0.01807518375","7671515.670000081","99.72970370999874"
"5205","6338","6336","5","6341","34274","1391.056875","0.018083739374999998","7672906.726875081","99.74778744937375"
"5206","6341","6337","5","6342","34279","1391.27625","0.01808659125","7674298.003125081","99.76587404062374"
"5207","6342","6340","9","6349","34288","1392.8118749999999","0.018106554374999997","7675690.8150000805","99.78398059499874"
"5208","6349","6340","3","6343","34291","1391.4956250000002","0.018089443125000004","7677082.310625081","99.80207003812374"
"5209","6343","6334","8","6342","34299","1391.27625","0.01808659125","7678473.586875081","99.82015662937374"
"5210","6342","6338","1","6339","34300","1390.618125","0.018078035625","7679864.205000081","99.83823466499874"
"5211","6339","6333","9","6342","34309","1391.27625","0.01808659125","7681255.481250081","99.85632125624873"
"5212","6342","6341","9","6350","34318","1393.03125","0.018109406249999998","7682648.512500081","99.87443066249874"
"5213","6350","6346","4","6350","34322","1393.03125","0.018109406249999998","7684041.543750081","99.89254006874874"
"5214","6350","6341","6","6347","34328","1392.3731249999998","0.018100850624999998","7685433.916875081","99.91064091937375"
"5215","6347","6338","6","6344","34334","1391.715","0.018092294999999998","7686825.631875081","99.92873321437375"
"5216","6344","6335","1","6336","34335","1389.96","0.01806948","7688215.591875081","99.94680269437374"
"5217","6336","6327","7","6334","34342","1389.52125","0.01806377625","7689605.113125081","99.96486647062375"
"5218","6334","6328","1","6329","34343","1388.4243749999998","0.018049516874999998","7690993.537500082","99.98291598749874"
"5219","6329","6326","4","6330","34347","1388.64375","0.01805236875","7692382.181250081","100.00096835624875"
"5220","6330","6328","2","6330","34349","1388.64375","0.01805236875","7693770.825000081","100.01902072499875"
"5221","6330","6326","6","6332","34355","1389.0824999999998","0.018058072499999994","7695159.907500081","100.03707879749875"
"5222","6332","6325","9","6334","34364","1389.52125","0.01806377625","7696549.428750081","100.05514257374875"
"5223","6334","6329","5","6334","34369","1389.52125","0.01806377625","7697938.950000081","100.07320634999876"
"5224","6334","6330","3","6333","34372","1389.301875","0.018060924375","7699328.251875081","100.09126727437376"
"5225","6333","6332","5","6337","34377","1390.179375","0.018072331874999997","7700718.431250081","100.10933960624877"
"5226","6337","6332","5","6337","34382","1390.179375","0.018072331874999997","7702108.610625082","100.12741193812377"
"5227","6337","6330","5","6335","34387","1389.740625","0.018066628124999998","7703498.351250081","100.14547856624877"
"5228","6335","6326","5","6331","34392","1388.863125","0.018055220625","7704887.2143750815","100.16353378687377"
"5229","6331","6322","3","6325","34395","1387.546875","0.018038109375","7706274.7612500815","100.18157189624877"
"5230","6325","6318","3","6321","34398","1386.6693750000002","0.018026701875000002","7707661.430625081","100.19959859812377"
"5231","6321","6320","9","6329","34407","1388.4243749999998","0.018049516874999998","7709049.8550000815","100.21764811499877"
"5232","6329","6321","9","6330","34416","1388.64375","0.01805236875","7710438.498750081","100.23570048374877"
"5233","6330","6322","2","6324","34418","1387.3274999999999","0.0180352575","7711825.826250081","100.25373574124878"
"5234","6324","6316","9","6325","34427","1387.546875","0.018038109375","7713213.373125081","100.27177385062377"
"5235","6325","6317","8","6325","34435","1387.546875","0.018038109375","7714600.920000081","100.28981195999877"
"5236","6325","6322","6","6328","34441","1388.2050000000002","0.018046665","7715989.125000081","100.30785862499877"
"5237","6328","6327","2","6329","34443","1388.4243749999998","0.018049516874999998","7717377.549375081","100.32590814187377"
"5238","6329","6327","2","6329","34445","1388.4243749999998","0.018049516874999998","7718765.973750082","100.34395765874876"
"5239","6329","6324","2","6326","34447","1387.7662500000001","0.01804096125","7720153.740000082","100.36199861999876"
"5240","6326","6323","5","6328","34452","1388.2050000000002","0.018046665","7721541.945000082","100.38004528499876"
"5241","6328","6326","6","6332","34458","1389.0824999999998","0.018058072499999994","7722931.027500082","100.39810335749875"
"5242","6332","6331","3","6334","34461","1389.52125","0.01806377625","7724320.548750082","100.41616713374876"
"5243","6334","6332","8","6340","34469","1390.8375","0.0180808875","7725711.386250082","100.43424802124876"
"5244","6340","6334","6","6340","34475","1390.8375","0.0180808875","7727102.223750083","100.45232890874877"
"5245","6340","6334","8","6342","34483","1391.27625","0.01808659125","7728493.500000083","100.47041549999877"
"5246","6342","6333","1","6334","34484","1389.52125","0.01806377625","7729883.021250083","100.48847927624877"
"5247","6334","6333","2","6335","34486","1389.740625","0.018066628124999998","7731272.761875083","100.50654590437377"
"5248","6335","6331","4","6335","34490","1389.740625","0.018066628124999998","7732662.502500082","100.52461253249876"
"5249","6335","6333","8","6341","34498","1391.056875","0.018083739374999998","7734053.559375082","100.54269627187377"
"5250","6341","6336","5","6341","34503","1391.056875","0.018083739374999998","7735444.616250082","100.56078001124877"
"5251","6341","6332","2","6334","34505","1389.52125","0.01806377625","7736834.137500082","100.57884378749877"
"5252","6334","6332","4","6336","34509","1389.96","0.01806948","7738224.097500082","100.59691326749876"
"5253","6336","6330","3","6333","34512","1389.301875","0.018060924375","7739613.399375082","100.61497419187377"
"5254","6333","6331","4","6335","34516","1389.740625","0.018066628124999998","7741003.140000082","100.63304081999877"
"5255","6335","6333","6","6339","34522","1390.618125","0.018078035625","7742393.758125082","100.65111885562376"
"5256","6339","6336","2","6338","34524","1390.39875","0.01807518375","7743784.156875081","100.66919403937376"
"5257","6338","6334","3","6337","34527","1390.179375","0.018072331874999997","7745174.336250082","100.68726637124877"
"5258","6337","6333","1","6334","34528","1389.52125","0.01806377625","7746563.857500082","100.70533014749877"
"5259","6334","6326","9","6335","34537","1389.740625","0.018066628124999998","7747953.5981250815","100.72339677562377"
"5260","6335","6333","1","6334","34538","1389.52125","0.01806377625","7749343.119375082","100.74146055187377"
"5261","6334","6329","7","6336","34545","1389.96","0.01806948","7750733.079375082","100.75953003187377"
"5262","6336","6328","2","6330","34547","1388.64375","0.01805236875","7752121.7231250815","100.77758240062377"
"5263","6330","6324","8","6332","34555","1389.0824999999998","0.018058072499999994","7753510.805625081","100.79564047312377"
"5264","6332","6324","2","6326","34557","1387.7662500000001","0.01804096125","7754898.571875081","100.81368143437376"
"5265","6326","6322","6","6328","34563","1388.2050000000002","0.018046665","7756286.7768750815","100.83172809937376"
"5266","6328","6327","4","6331","34567","1388.863125","0.018055220625","7757675.640000082","100.84978331999876"
"5267","6331","6330","2","6332","34569","1389.0824999999998","0.018058072499999994","7759064.722500081","100.86784139249876"
"5268","6332","6325","7","6332","34576","1389.0824999999998","0.018058072499999994","7760453.805000081","100.88589946499876"
"5269","6332","6325","9","6334","34585","1389.52125","0.01806377625","7761843.326250081","100.90396324124876"
"5270","6334","6325","4","6329","34589","1388.4243749999998","0.018049516874999998","7763231.750625081","100.92201275812376"
"5271","6329","6326","8","6334","34597","1389.52125","0.01806377625","7764621.271875082","100.94007653437376"
"5272","6334","6328","7","6335","34604","1389.740625","0.018066628124999998","7766011.012500081","100.95814316249876"
"5273","6335","6328","7","6335","34611","1389.740625","0.018066628124999998","7767400.753125081","100.97620979062376"
"5274","6335","6333","3","6336","34614","1389.96","0.01806948","7768790.713125081","100.99427927062375"
"5275","6336","6330","7","6337","34621","1390.179375","0.018072331874999997","7770180.892500081","101.01235160249875"
"5276","6337","6333","4","6337","34625","1390.179375","0.018072331874999997","7771571.071875081","101.03042393437376"
"5277","6337","6336","7","6343","34632","1391.4956250000002","0.018089443125000004","7772962.567500082","101.04851337749876"
"5278","6343","6339","3","6342","34635","1391.27625","0.01808659125","7774353.843750082","101.06659996874876"
"5279","6342","6340","3","6343","34638","1391.4956250000002","0.018089443125000004","7775745.339375082","101.08468941187377"
"5280","6343","6341","6","6347","34644","1392.3731249999998","0.018100850624999998","7777137.712500082","101.10279026249877"
"5281","6347","6343","4","6347","34648","1392.3731249999998","0.018100850624999998","7778530.085625082","101.12089111312378"
"5282","6347","6345","8","6353","34656","1393.6893750000002","0.018117961875","7779923.775000082","101.13900907499878"
"5283","6353","6349","3","6352","34659","1393.4699999999998","0.018115109999999997","7781317.245000082","101.15712418499878"
"5284","6352","6343","5","6348","34664","1392.5925000000002","0.018103702500000003","7782709.837500082","101.17522788749878"
"5285","6348","6346","2","6348","34666","1392.5925000000002","0.018103702500000003","7784102.430000083","101.19333158999878"
"5286","6348","6345","1","6346","34667","1392.1537500000002","0.01809799875","7785494.583750082","101.21142958874877"
"5287","6346","6344","9","6353","34676","1393.6893750000002","0.018117961875","7786888.273125082","101.22954755062378"
"5288","6353","6347","6","6353","34682","1393.6893750000002","0.018117961875","7788281.962500082","101.24766551249878"
"5289","6353","6351","7","6358","34689","1394.78625","0.01813222125","7789676.748750082","101.26579773374878"
"5290","6358","6349","2","6351","34691","1393.2506250000001","0.018112258125","7791069.999375083","101.28390999187378"
"5291","6351","6350","7","6357","34698","1394.5668749999998","0.018129369374999996","7792464.566250082","101.30203936124879"
"5292","6357","6356","6","6362","34704","1395.66375","0.018143628749999998","7793860.230000082","101.32018298999878"
"5293","6362","6353","5","6358","34709","1394.78625","0.01813222125","7795255.016250082","101.33831521124878"
"5294","6358","6353","3","6356","34712","1394.3475","0.0181265175","7796649.363750082","101.35644172874878"
"5295","6356","6351","6","6357","34718","1394.5668749999998","0.018129369374999996","7798043.930625082","101.37457109812378"
"5296","6357","6356","2","6358","34720","1394.78625","0.01813222125","7799438.716875082","101.39270331937378"
"5297","6358","6350","1","6351","34721","1393.2506250000001","0.018112258125","7800831.967500082","101.41081557749878"
"5298","6351","6342","1","6343","34722","1391.4956250000002","0.018089443125000004","7802223.463125083","101.42890502062379"
"5299","6343","6340","5","6345","34727","1391.934375","0.018095146875","7803615.397500083","101.44700016749879"
"5300","6345","6339","7","6346","34734","1392.1537500000002","0.01809799875","7805007.551250082","101.46509816624878"
"5301","6346","6338","3","6341","34737","1391.056875","0.018083739374999998","7806398.608125082","101.48318190562378"
"5302","6341","6338","1","6339","34738","1390.618125","0.018078035625","7807789.226250082","101.50125994124878"
"5303","6339","6335","8","6343","34746","1391.4956250000002","0.018089443125000004","7809180.721875083","101.51934938437378"
"5304","6343","6337","8","6345","34754","1391.934375","0.018095146875","7810572.656250083","101.53744453124878"
"5305","6345","6342","7","6349","34761","1392.8118749999999","0.018106554374999997","7811965.468125083","101.55555108562378"
"5306","6349","6348","1","6349","34762","1392.8118749999999","0.018106554374999997","7813358.280000082","101.57365763999877"
"5307","6349","6347","4","6351","34766","1393.2506250000001","0.018112258125","7814751.530625083","101.59176989812377"
"5308","6351","6350","5","6355","34771","1394.128125","0.018123665624999997","7816145.658750082","101.60989356374877"
"5309","6355","6347","8","6355","34779","1394.128125","0.018123665624999997","7817539.786875082","101.62801722937377"
"5310","6355","6346","8","6354","34787","1393.9087499999998","0.018120813749999996","7818933.695625083","101.64613804312377"
"5311","6354","6346","8","6354","34795","1393.9087499999998","0.018120813749999996","7820327.604375083","101.66425885687377"
"5312","6354","6352","6","6358","34801","1394.78625","0.01813222125","7821722.390625083","101.68239107812377"
"5313","6358","6357","3","6360","34804","1395.225","0.018137925","7823117.6156250825","101.70052900312378"
"5314","6360","6355","8","6363","34812","1395.883125","0.018146480625","7824513.498750082","101.71867548374878"
"5315","6363","6357","3","6360","34815","1395.225","0.018137925","7825908.723750082","101.73681340874879"
"5316","6360","6353","7","6360","34822","1395.225","0.018137925","7827303.9487500815","101.75495133374879"
"5317","6360","6356","5","6361","34827","1395.444375","0.018140776875","7828699.393125081","101.7730921106238"
"5318","6361","6358","8","6366","34835","1396.54125","0.01815503625","7830095.934375081","101.79124714687379"
"5319","6366","6363","9","6372","34844","1397.8574999999998","0.018172147499999996","7831493.791875081","101.80941929437378"
"5320","6372","6369","8","6377","34852","1398.9543749999998","0.018186406874999995","7832892.746250081","101.82760570124879"
"5321","6377","6374","9","6383","34861","1400.270625","0.018203518125000002","7834293.016875081","101.84580921937379"
"5322","6383","6381","2","6383","34863","1400.270625","0.018203518125000002","7835693.287500081","101.8640127374988"
"5323","6383","6376","2","6378","34865","1399.1737500000002","0.01818925875","7837092.461250081","101.8822019962488"
"5324","6378","6373","3","6376","34868","1398.7350000000001","0.018183555","7838491.196250081","101.90038555124879"
"5325","6376","6370","3","6373","34871","1398.0768750000002","0.018174999375","7839889.273125081","101.9185605506238"
"5326","6373","6371","2","6373","34873","1398.0768750000002","0.018174999375","7841287.350000082","101.9367355499988"
"5327","6373","6365","7","6372","34880","1397.8574999999998","0.018172147499999996","7842685.2075000815","101.9549076974988"
"5328","6372","6368","1","6369","34881","1397.199375","0.018163591875","7844082.406875081","101.97307128937379"
"5329","6369","6363","2","6365","34883","1396.321875","0.018152184375","7845478.728750082","101.99122347374879"
"5330","6365","6356","7","6363","34890","1395.883125","0.018146480625","7846874.611875081","102.0093699543738"
"5331","6363","6357","1","6358","34891","1394.78625","0.01813222125","7848269.398125081","102.0275021756238"
"5332","6358","6349","8","6357","34899","1394.5668749999998","0.018129369374999996","7849663.965000081","102.0456315449988"
"5333","6357","6356","3","6359","34902","1395.005625","0.018135073124999998","7851058.970625081","102.0637666181238"
"5334","6359","6355","7","6362","34909","1395.66375","0.018143628749999998","7852454.634375081","102.08191024687379"
"5335","6362","6357","7","6364","34916","1396.1025","0.018149332499999997","7853850.736875081","102.10005957937379"
"5336","6364","6362","6","6368","34922","1396.9800000000002","0.01816074","7855247.716875082","102.11822031937379"
"5337","6368","6366","1","6367","34923","1396.760625","0.018157888124999997","7856644.477500082","102.1363782074988"
"5338","6367","6359","1","6360","34924","1395.225","0.018137925","7858039.702500082","102.1545161324988"
"5339","6360","6354","5","6359","34929","1395.005625","0.018135073124999998","7859434.708125082","102.1726512056238"
"5340","6359","6352","9","6361","34938","1395.444375","0.018140776875","7860830.152500082","102.1907919824988"
"5341","6361","6353","4","6357","34942","1394.5668749999998","0.018129369374999996","7862224.719375081","102.2089213518738"
"5342","6357","6350","6","6356","34948","1394.3475","0.0181265175","7863619.0668750815","102.22704786937379"
"5343","6356","6353","8","6361","34956","1395.444375","0.018140776875","7865014.5112500815","102.24518864624879"
"5344","6361","6355","1","6356","34957","1394.3475","0.0181265175","7866408.858750082","102.26331516374879"
"5345","6356","6353","5","6358","34962","1394.78625","0.01813222125","7867803.6450000815","102.28144738499878"
"5346","6358","6353","6","6359","34968","1395.005625","0.018135073124999998","7869198.650625082","102.29958245812378"
"5347","6359","6353","7","6360","34975","1395.225","0.018137925","7870593.875625081","102.31772038312378"
"5348","6360","6356","8","6364","34983","1396.1025","0.018149332499999997","7871989.978125081","102.33586971562379"
"5349","6364","6361","6","6367","34989","1396.760625","0.018157888124999997","7873386.7387500815","102.35402760374879"
"5350","6367","6360","2","6362","34991","1395.66375","0.018143628749999998","7874782.402500082","102.37217123249879"
"5351","6362","6359","3","6362","34994","1395.66375","0.018143628749999998","7876178.066250082","102.39031486124878"
"5352","6362","6354","3","6357","34997","1394.5668749999998","0.018129369374999996","7877572.633125082","102.40844423062379"
"5353","6357","6353","5","6358","35002","1394.78625","0.01813222125","7878967.419375082","102.42657645187379"
"5354","6358","6349","1","6350","35003","1393.03125","0.018109406249999998","7880360.450625082","102.44468585812379"
"5355","6350","6348","6","6354","35009","1393.9087499999998","0.018120813749999996","7881754.359375082","102.46280667187379"
"5356","6354","6346","4","6350","35013","1393.03125","0.018109406249999998","7883147.390625082","102.4809160781238"
"5357","6350","6341","1","6342","35014","1391.27625","0.01808659125","7884538.666875082","102.4990026693738"
"5358","6342","6334","2","6336","35016","1389.96","0.01806948","7885928.626875082","102.51707214937379"
"5359","6336","6332","2","6334","35018","1389.52125","0.01806377625","7887318.148125082","102.53513592562379"
"5360","6334","6325","9","6334","35027","1389.52125","0.01806377625","7888707.6693750825","102.5531997018738"
"5361","6334","6328","8","6336","35035","1389.96","0.01806948","7890097.629375082","102.57126918187379"
"5362","6336","6335","8","6343","35043","1391.4956250000002","0.018089443125000004","7891489.125000083","102.5893586249988"
"5363","6343","6334","6","6340","35049","1390.8375","0.0180808875","7892879.962500083","102.6074395124988"
"5364","6340","6332","5","6337","35054","1390.179375","0.018072331874999997","7894270.141875084","102.6255118443738"
"5365","6337","6336","2","6338","35056","1390.39875","0.01807518375","7895660.540625083","102.6435870281238"
"5366","6338","6333","5","6338","35061","1390.39875","0.01807518375","7897050.939375083","102.6616622118738"
"5367","6338","6332","5","6337","35066","1390.179375","0.018072331874999997","7898441.118750083","102.67973454374881"
"5368","6337","6336","5","6341","35071","1391.056875","0.018083739374999998","7899832.175625083","102.69781828312381"
"5369","6341","6337","6","6343","35077","1391.4956250000002","0.018089443125000004","7901223.6712500835","102.71590772624882"
"5370","6343","6341","5","6346","35082","1392.1537500000002","0.01809799875","7902615.825000083","102.73400572499881"
"5371","6346","6342","4","6346","35086","1392.1537500000002","0.01809799875","7904007.978750083","102.7521037237488"
"5372","6346","6345","9","6354","35095","1393.9087499999998","0.018120813749999996","7905401.887500083","102.7702245374988"
"5373","6354","6349","6","6355","35101","1394.128125","0.018123665624999997","7906796.015625083","102.7883482031238"
"5374","6355","6347","6","6353","35107","1393.6893750000002","0.018117961875","7908189.705000083","102.80646616499881"
"5375","6353","6350","8","6358","35115","1394.78625","0.01813222125","7909584.491250083","102.82459838624881"
"5376","6358","6354","4","6358","35119","1394.78625","0.01813222125","7910979.277500083","102.84273060749881"
"5377","6358","6354","5","6359","35124","1395.005625","0.018135073124999998","7912374.283125083","102.8608656806238"
"5378","6359","6356","1","6357","35125","1394.5668749999998","0.018129369374999996","7913768.8500000825","102.8789950499988"
"5379","6357","6352","5","6357","35130","1394.5668749999998","0.018129369374999996","7915163.416875082","102.89712441937381"
"5380","6357","6352","2","6354","35132","1393.9087499999998","0.018120813749999996","7916557.3256250825","102.91524523312381"
"5381","6354","6349","7","6356","35139","1394.3475","0.0181265175","7917951.673125083","102.9333717506238"
"5382","6356","6347","8","6355","35147","1394.128125","0.018123665624999997","7919345.801250082","102.9514954162488"
"5383","6355","6353","8","6361","35155","1395.444375","0.018140776875","7920741.245625082","102.9696361931238"
"5384","6361","6355","4","6359","35159","1395.005625","0.018135073124999998","7922136.251250083","102.9877712662488"
"5385","6359","6351","9","6360","35168","1395.225","0.018137925","7923531.476250082","103.0059091912488"
"5386","6360","6351","3","6354","35171","1393.9087499999998","0.018120813749999996","7924925.385000083","103.0240300049988"
"5387","6354","6345","4","6349","35175","1392.8118749999999","0.018106554374999997","7926318.196875082","103.0421365593738"
"5388","6349","6346","1","6347","35176","1392.3731249999998","0.018100850624999998","7927710.570000082","103.0602374099988"
"5389","6347","6338","9","6347","35185","1392.3731249999998","0.018100850624999998","7929102.943125082","103.07833826062381"
"5390","6347","6344","1","6345","35186","1391.934375","0.018095146875","7930494.877500082","103.09643340749881"
"5391","6345","6339","3","6342","35189","1391.27625","0.01808659125","7931886.1537500825","103.1145199987488"
"5392","6342","6341","5","6346","35194","1392.1537500000002","0.01809799875","7933278.307500082","103.1326179974988"
"5393","6346","6344","6","6350","35200","1393.03125","0.018109406249999998","7934671.338750082","103.1507274037488"
"5394","6350","6345","8","6353","35208","1393.6893750000002","0.018117961875","7936065.028125082","103.16884536562381"
"5395","6353","6348","8","6356","35216","1394.3475","0.0181265175","7937459.375625082","103.1869718831238"
"5396","6356","6355","1","6356","35217","1394.3475","0.0181265175","7938853.723125082","103.2050984006238"
"5397","6356","6351","8","6359","35225","1395.005625","0.018135073124999998","7940248.728750083","103.22323347374879"
"5398","6359","6353","5","6358","35230","1394.78625","0.01813222125","7941643.515000083","103.24136569499879"
"5399","6358","6352","2","6354","35232","1393.9087499999998","0.018120813749999996","7943037.423750083","103.2594865087488"
"5400","6354","6351","8","6359","35240","1395.005625","0.018135073124999998","7944432.429375083","103.27762158187379"
"5401","6359","6357","188","6545","35428","1435.809375","0.018665521875","7945868.238750083","103.29628710374878"
"5402","6545","6544","7","6551","35435","1437.1256250000001","0.018682633125","7947305.364375084","103.31496973687378"
"5403","6551","6543","8","6551","35443","1437.1256250000001","0.018682633125","7948742.490000084","103.33365236999877"
"5404","6551","6548","8","6556","35451","1438.2225","0.0186968925","7950180.712500084","103.35234926249878"
"5405","6556","6554","8","6562","35459","1439.53875","0.01871400375","7951620.2512500845","103.37106326624878"
"5406","6562","6559","4","6563","35463","1439.758125","0.018716855625","7953060.009375084","103.38978012187378"
"5407","6563","6556","5","6561","35468","1439.319375","0.018711151875","7954499.328750084","103.40849127374878"
"5408","6561","6556","4","6560","35472","1439.1","0.018708299999999997","7955938.428750084","103.42719957374878"
"5409","6560","6559","3","6562","35475","1439.53875","0.01871400375","7957377.967500084","103.44591357749879"
"5410","6562","6555","3","6558","35478","1438.66125","0.018702596250000002","7958816.628750084","103.46461617374878"
"5411","6558","6550","8","6558","35486","1438.66125","0.018702596250000002","7960255.290000084","103.48331876999877"
"5412","6558","6554","9","6563","35495","1439.758125","0.018716855625","7961695.048125084","103.50203562562378"
"5413","6563","6561","5","6566","35500","1440.41625","0.018725411249999997","7963135.464375083","103.52076103687378"
"5414","6566","6564","1","6565","35501","1440.196875","0.018722559375","7964575.661250084","103.53948359624877"
"5415","6565","6556","6","6562","35507","1439.53875","0.01871400375","7966015.200000084","103.55819759999878"
"5416","6562","6553","1","6554","35508","1437.7837499999998","0.018691188749999997","7967452.983750084","103.57688878874878"
"5417","6554","6546","8","6554","35516","1437.7837499999998","0.018691188749999997","7968890.767500085","103.59557997749877"
"5418","6554","6546","2","6548","35518","1436.4675000000002","0.0186740775","7970327.235000085","103.61425405499877"
"5419","6548","6547","8","6555","35526","1438.003125","0.018694040624999998","7971765.238125085","103.63294809562376"
"5420","6555","6546","6","6552","35532","1437.3449999999998","0.018685484999999995","7973202.583125085","103.65163358062377"
"5421","6552","6546","5","6551","35537","1437.1256250000001","0.018682633125","7974639.708750085","103.67031621374876"
"5422","6551","6543","9","6552","35546","1437.3449999999998","0.018685484999999995","7976077.053750085","103.68900169874877"
"5423","6552","6549","9","6558","35555","1438.66125","0.018702596250000002","7977515.715000085","103.70770429499876"
"5424","6558","6552","7","6559","35562","1438.880625","0.018705448125","7978954.595625085","103.72640974312377"
"5425","6559","6550","7","6557","35569","1438.4418749999998","0.018699744374999997","7980393.037500084","103.74510948749877"
"5426","6557","6553","7","6560","35576","1439.1","0.018708299999999997","7981832.137500084","103.76381778749877"
"5427","6560","6558","5","6563","35581","1439.758125","0.018716855625","7983271.895625084","103.78253464312377"
"5428","6563","6559","8","6567","35589","1440.635625","0.018728263125","7984712.531250084","103.80126290624877"
"5429","6567","6562","5","6567","35594","1440.635625","0.018728263125","7986153.166875084","103.81999116937376"
"5430","6567","6565","6","6571","35600","1441.5131250000002","0.018739670625","7987594.6800000835","103.83873083999876"
"5431","6571","6570","8","6578","35608","1443.0487500000002","0.01875963375","7989037.728750084","103.85749047374875"
"5432","6578","6570","1","6571","35609","1441.5131250000002","0.018739670625","7990479.241875083","103.87623014437375"
"5433","6571","6566","7","6573","35616","1441.9518750000002","0.018745374375000002","7991921.193750083","103.89497551874875"
"5434","6573","6565","7","6572","35623","1441.7324999999998","0.018742522499999997","7993362.926250083","103.91371804124876"
"5435","6572","6566","9","6575","35632","1442.390625","0.018751078124999997","7994805.316875083","103.93246911937376"
"5436","6575","6568","1","6569","35633","1441.074375","0.018733966874999997","7996246.391250083","103.95120308624877"
"5437","6569","6563","3","6566","35636","1440.41625","0.018725411249999997","7997686.807500083","103.96992849749877"
"5438","6566","6562","9","6571","35645","1441.5131250000002","0.018739670625","7999128.320625083","103.98866816812377"
"5439","6571","6568","8","6576","35653","1442.6100000000001","0.018753930000000002","8000570.930625083","104.00742209812377"
"5440","6576","6575","6","6581","35659","1443.706875","0.018768189375","8002014.637500083","104.02619028749876"
"5441","6581","6573","2","6575","35661","1442.390625","0.018751078124999997","8003457.028125083","104.04494136562377"
"5442","6575","6567","7","6574","35668","1442.1712499999999","0.018748226249999996","8004899.199375083","104.06368959187377"
"5443","6574","6567","5","6572","35673","1441.7324999999998","0.018742522499999997","8006340.931875083","104.08243211437377"
"5444","6572","6567","5","6572","35678","1441.7324999999998","0.018742522499999997","8007782.664375083","104.10117463687378"
"5445","6572","6563","7","6570","35685","1441.29375","0.01873681875","8009223.958125083","104.11991145562378"
"5446","6570","6561","5","6566","35690","1440.41625","0.018725411249999997","8010664.374375083","104.13863686687378"
"5447","6566","6560","1","6561","35691","1439.319375","0.018711151875","8012103.6937500825","104.15734801874878"
"5448","6561","6559","4","6563","35695","1439.758125","0.018716855625","8013543.451875082","104.17606487437378"
"5449","6563","6556","7","6563","35702","1439.758125","0.018716855625","8014983.210000082","104.19478172999878"
"5450","6563","6557","5","6562","35707","1439.53875","0.01871400375","8016422.748750082","104.21349573374879"
"5451","6562","6561","4","6565","35711","1440.196875","0.018722559375","8017862.945625083","104.23221829312378"
"5452","6565","6563","5","6568","35716","1440.8550000000002","0.018731115000000003","8019303.800625083","104.25094940812377"
"5453","6568","6561","9","6570","35725","1441.29375","0.01873681875","8020745.094375083","104.26968622687377"
"5454","6570","6569","6","6575","35731","1442.390625","0.018751078124999997","8022187.485000083","104.28843730499878"
"5455","6575","6567","9","6576","35740","1442.6100000000001","0.018753930000000002","8023630.095000084","104.30719123499878"
"5456","6576","6572","1","6573","35741","1441.9518750000002","0.018745374375000002","8025072.046875084","104.32593660937378"
"5457","6573","6564","7","6571","35748","1441.5131250000002","0.018739670625","8026513.560000083","104.34467627999878"
"5458","6571","6562","3","6565","35751","1440.196875","0.018722559375","8027953.756875084","104.36339883937377"
"5459","6565","6556","1","6557","35752","1438.4418749999998","0.018699744374999997","8029392.198750083","104.38209858374877"
"5460","6557","6549","1","6550","35753","1436.90625","0.01867978125","8030829.105000083","104.40077836499877"
"5461","6550","6547","280","6827","36033","1497.6731250000003","0.019469750625","8032326.778125083","104.42024811562378"
"5462","6827","6822","4","6826","36037","1497.4537500000001","0.01946689875","8033824.231875083","104.43971501437377"
"5463","6826","6825","9","6834","36046","1499.20875","0.01948971375","8035323.440625084","104.45920472812378"
"5464","6834","6829","4","6833","36050","1498.989375","0.019486861875","8036822.4300000835","104.47869158999877"
"5465","6833","6826","9","6835","36059","1499.428125","0.019492565624999996","8038321.858125083","104.49818415562378"
"5466","6835","6826","8","6834","36067","1499.20875","0.01948971375","8039821.066875083","104.51767386937378"
"5467","6834","6830","2","6832","36069","1498.77","0.01948401","8041319.836875083","104.53715787937378"
"5468","6832","6831","5","6836","36074","1499.6474999999998","0.019495417499999997","8042819.484375083","104.55665329687378"
"5469","6836","6828","3","6831","36077","1498.5506249999999","0.019481158125","8044318.035000083","104.57613445499878"
"5470","6831","6826","6","6832","36083","1498.77","0.01948401","8045816.805000083","104.59561846499878"
"5471","6832","6831","3","6834","36086","1499.20875","0.01948971375","8047316.013750083","104.61510817874878"
"5472","6834","6826","7","6833","36093","1498.989375","0.019486861875","8048815.003125083","104.63459504062378"
"5473","6833","6824","6","6830","36099","1498.33125","0.019478306249999997","8050313.3343750825","104.65407334687377"
"5474","6830","6822","8","6830","36107","1498.33125","0.019478306249999997","8051811.665625082","104.67355165312377"
"5475","6830","6827","3","6830","36110","1498.33125","0.019478306249999997","8053309.996875082","104.69302995937376"
"5476","6830","6827","4","6831","36114","1498.5506249999999","0.019481158125","8054808.547500082","104.71251111749876"
"5477","6831","6829","5","6834","36119","1499.20875","0.01948971375","8056307.7562500825","104.73200083124877"
"5478","6834","6829","3","6832","36122","1498.77","0.01948401","8057806.526250082","104.75148484124877"
"5479","6832","6829","1","6830","36123","1498.33125","0.019478306249999997","8059304.857500082","104.77096314749876"
"5480","6830","6828","8","6836","36131","1499.6474999999998","0.019495417499999997","8060804.505000082","104.79045856499876"
"5481","6836","6833","4","6837","36135","1499.8668750000002","0.019498269375000002","8062304.371875082","104.80995683437376"
"5482","6837","6829","7","6836","36142","1499.6474999999998","0.019495417499999997","8063804.019375082","104.82945225187376"
"5483","6836","6827","9","6836","36151","1499.6474999999998","0.019495417499999997","8065303.666875082","104.84894766937376"
"5484","6836","6827","9","6836","36160","1499.6474999999998","0.019495417499999997","8066803.314375082","104.86844308687375"
"5485","6836","6828","8","6836","36168","1499.6474999999998","0.019495417499999997","8068302.961875082","104.88793850437375"
"5486","6836","6828","5","6833","36173","1498.989375","0.019486861875","8069801.951250082","104.90742536624875"
"5487","6833","6827","3","6830","36176","1498.33125","0.019478306249999997","8071300.282500082","104.92690367249874"
"5488","6830","6829","1","6830","36177","1498.33125","0.019478306249999997","8072798.6137500815","104.94638197874873"
"5489","6830","6827","7","6834","36184","1499.20875","0.01948971375","8074297.822500082","104.96587169249874"
"5490","6834","6833","6","6839","36190","1500.305625","0.019503973124999997","8075798.128125082","104.98537566562374"
"5491","6839","6837","2","6839","36192","1500.305625","0.019503973124999997","8077298.433750082","105.00487963874873"
"5492","6839","6834","6","6840","36198","1500.525","0.019506825","8078798.958750082","105.02438646374873"
"5493","6840","6837","7","6844","36205","1501.4025","0.019518232499999996","8080300.361250082","105.04390469624873"
"5494","6844","6835","5","6840","36210","1500.525","0.019506825","8081800.886250082","105.06341152124872"
"5495","6840","6837","5","6842","36215","1500.96375","0.019512528749999997","8083301.8500000825","105.08292404999872"
"5496","6842","6839","6","6845","36221","1501.621875","0.019521084375","8084803.471875083","105.10244513437372"
"5497","6845","6844","6","6850","36227","1502.71875","0.01953534375","8086306.190625083","105.12198047812372"
"5498","6850","6843","2","6845","36229","1501.621875","0.019521084375","8087807.812500083","105.14150156249872"
"5499","6845","6841","7","6848","36236","1502.28","0.019529639999999997","8089310.092500083","105.16103120249872"
"5500","6848","6841","3","6844","36239","1501.4025","0.019518232499999996","8090811.495000083","105.18054943499872"
"5501","6844","6843","6","6849","36245","1502.4993749999999","0.019532491875","8092313.994375083","105.20008192687372"
"5502","6849","6843","2","6845","36247","1501.621875","0.019521084375","8093815.616250083","105.21960301124872"
"5503","6845","6843","9","6852","36256","1503.1575000000003","0.019541047500000002","8095318.773750083","105.23914405874872"
"5504","6852","6845","2","6847","36258","1502.060625","0.019526788125","8096820.8343750825","105.25867084687373"
"5505","6847","6838","6","6844","36264","1501.4025","0.019518232499999996","8098322.236875082","105.27818907937373"
"5506","6844","6836","4","6840","36268","1500.525","0.019506825","8099822.761875083","105.29769590437373"
"5507","6840","6832","4","6836","36272","1499.6474999999998","0.019495417499999997","8101322.409375083","105.31719132187372"
"5508","6836","6833","3","6836","36275","1499.6474999999998","0.019495417499999997","8102822.056875083","105.33668673937372"
"5509","6836","6829","9","6838","36284","1500.08625","0.01950112125","8104322.143125082","105.35618786062372"
"5510","6838","6831","7","6838","36291","1500.08625","0.01950112125","8105822.229375082","105.37568898187372"
"5511","6838","6835","1","6836","36292","1499.6474999999998","0.019495417499999997","8107321.876875082","105.39518439937372"
"5512","6836","6835","2","6837","36294","1499.8668750000002","0.019498269375000002","8108821.743750082","105.41468266874872"
"5513","6837","6834","2","6836","36296","1499.6474999999998","0.019495417499999997","8110321.391250082","105.43417808624872"
"5514","6836","6832","7","6839","36303","1500.305625","0.019503973124999997","8111821.696875082","105.45368205937372"
"5515","6839","6830","8","6838","36311","1500.08625","0.01950112125","8113321.783125082","105.47318318062372"
"5516","6838","6832","9","6841","36320","1500.7443749999995","0.019509676874999993","8114822.527500082","105.49269285749872"
"5517","6841","6833","2","6835","36322","1499.428125","0.019492565624999996","8116321.955625081","105.51218542312373"
"5518","6835","6830","1","6831","36323","1498.5506249999999","0.019481158125","8117820.506250082","105.53166658124873"
"5519","6831","6823","1","6824","36324","1497.0149999999999","0.019461194999999997","8119317.521250081","105.55112777624873"
"5520","6824","6823","8","6831","36332","1498.5506249999999","0.019481158125","8120816.071875081","105.57060893437374"
"5521","6831","6827","439","7266","36771","1593.9787499999995","0.020721723749999994","8122410.050625081","105.59133065812374"
"5522","7266","7258","5","7263","36776","1593.320625","0.020713168125","8124003.371250081","105.61204382624874"
"5523","7263","7257","1","7258","36777","1592.22375","0.02069890875","8125595.595000081","105.63274273499874"
"5524","7258","7257","5","7262","36782","1593.1012500000002","0.02071031625","8127188.696250081","105.65345305124875"
"5525","7262","7255","2","7257","36784","1592.004375","0.020696056874999997","8128780.700625081","105.67414910812374"
"5526","7257","7255","1","7256","36785","1591.7849999999999","0.020693204999999996","8130372.485625081","105.69484231312374"
"5527","7256","7254","5","7259","36790","1592.443125","0.020701760625","8131964.928750081","105.71554407374875"
"5528","7259","7258","6","7264","36796","1593.54","0.020716019999999998","8133558.468750081","105.73626009374874"
"5529","7264","7261","3","7264","36799","1593.54","0.020716019999999998","8135152.008750081","105.75697611374873"
"5530","7264","7258","6","7264","36805","1593.54","0.020716019999999998","8136745.548750081","105.77769213374873"
"5531","7264","7261","1","7262","36806","1593.1012500000002","0.02071031625","8138338.650000081","105.79840244999873"
"5532","7262","7259","9","7268","36815","1594.4175","0.0207274275","8139933.067500082","105.81912987749874"
"5533","7268","7263","8","7271","36823","1595.075625","0.020735983125","8141528.143125081","105.83986586062373"
"5534","7271","7264","6","7270","36829","1594.85625","0.020733131249999998","8143122.999375082","105.86059899187373"
"5535","7270","7268","4","7272","36833","1595.295","0.020738835","8144718.294375082","105.88133782687373"
"5536","7272","7264","8","7272","36841","1595.295","0.020738835","8146313.5893750815","105.90207666187374"
"5537","7272","7270","5","7275","36846","1595.953125","0.020747390624999997","8147909.5425000815","105.92282405249874"
"5538","7275","7270","9","7279","36855","1596.8306249999998","0.020758798124999995","8149506.373125082","105.94358285062374"
"5539","7279","7277","3","7280","36858","1597.05","0.02076165","8151103.423125082","105.96434450062374"
"5540","7280","7276","7","7283","36865","1597.708125","0.020770205625","8152701.131250082","105.98511470624874"
"5541","7283","7278","1","7279","36866","1596.8306249999998","0.020758798124999995","8154297.961875082","106.00587350437374"
"5542","7279","7271","3","7274","36869","1595.7337499999999","0.020744538749999996","8155893.695625082","106.02661804312373"
"5543","7274","7267","8","7275","36877","1595.953125","0.020747390624999997","8157489.648750082","106.04736543374874"
"5544","7275","7270","8","7278","36885","1596.6112500000002","0.02075594625","8159086.260000082","106.06812137999874"
"5545","7278","7276","5","7281","36890","1597.2693749999999","0.020764501874999997","8160683.529375082","106.08888588187374"
"5546","7281","7280","4","7284","36894","1597.9275","0.020773057499999997","8162281.456875082","106.10965893937373"
"5547","7284","7277","6","7283","36900","1597.708125","0.020770205625","8163879.165000082","106.13042914499873"
"5548","7283","7280","5","7285","36905","1598.146875","0.020775909375","8165477.311875082","106.15120505437373"
"5549","7285","7281","1","7282","36906","1597.48875","0.02076735375","8167074.800625081","106.17197240812374"
"5550","7282","7273","8","7281","36914","1597.2693749999999","0.020764501874999997","8168672.070000081","106.19273690999873"
"5551","7281","7274","4","7278","36918","1596.6112500000002","0.02075594625","8170268.681250081","106.21349285624873"
"5552","7278","7272","4","7276","36922","1596.1725","0.0207502425","8171864.853750082","106.23424309874873"
"5553","7276","7272","4","7276","36926","1596.1725","0.0207502425","8173461.026250082","106.25499334124873"
"5554","7276","7275","5","7280","36931","1597.05","0.02076165","8175058.076250082","106.27575499124873"
"5555","7280","7271","5","7276","36936","1596.1725","0.0207502425","8176654.248750082","106.29650523374873"
"5556","7276","7274","6","7280","36942","1597.05","0.02076165","8178251.298750082","106.31726688374873"
"5557","7280","7278","4","7282","36946","1597.48875","0.02076735375","8179848.787500082","106.33803423749873"
"5558","7282","7279","7","7286","36953","1598.3662499999998","0.020778761249999996","8181447.153750082","106.35881299874873"
"5559","7286","7285","4","7289","36957","1599.024375","0.020787316875","8183046.178125082","106.37960031562373"
"5560","7289","7280","3","7283","36960","1597.708125","0.020770205625","8184643.8862500815","106.40037052124873"
"5561","7283","7275","3","7278","36963","1596.6112500000002","0.02075594625","8186240.497500082","106.42112646749874"
"5562","7278","7277","2","7279","36965","1596.8306249999998","0.020758798124999995","8187837.328125082","106.44188526562374"
"5563","7279","7271","6","7277","36971","1596.3918750000003","0.020753094375000003","8189433.720000082","106.46263835999873"
"5564","7277","7272","6","7278","36977","1596.6112500000002","0.02075594625","8191030.331250082","106.48339430624874"
"5565","7278","7270","9","7279","36986","1596.8306249999998","0.020758798124999995","8192627.161875082","106.50415310437374"
"5566","7279","7278","6","7284","36992","1597.9275","0.020773057499999997","8194225.089375082","106.52492616187374"
"5567","7284","7282","5","7287","36997","1598.5856250000002","0.020781613125","8195823.675000083","106.54570777499873"
"5568","7287","7278","1","7279","36998","1596.8306249999998","0.020758798124999995","8197420.505625083","106.56646657312373"
"5569","7279","7274","7","7281","37005","1597.2693749999999","0.020764501874999997","8199017.775000083","106.58723107499873"
"5570","7281","7272","3","7275","37008","1595.953125","0.020747390624999997","8200613.728125083","106.60797846562373"
"5571","7275","7269","5","7274","37013","1595.7337499999999","0.020744538749999996","8202209.461875083","106.62872300437373"
"5572","7274","7270","7","7277","37020","1596.3918750000003","0.020753094375000003","8203805.853750083","106.64947609874872"
"5573","7277","7273","9","7282","37029","1597.48875","0.02076735375","8205403.342500082","106.67024345249872"
"5574","7282","7279","1","7280","37030","1597.05","0.02076165","8207000.392500082","106.69100510249872"
"5575","7280","7271","4","7275","37034","1595.953125","0.020747390624999997","8208596.345625082","106.71175249312373"
"5576","7275","7268","4","7272","37038","1595.295","0.020738835","8210191.640625082","106.73249132812373"
"5577","7272","7267","4","7271","37042","1595.075625","0.020735983125","8211786.716250082","106.75322731124872"
"5578","7271","7268","8","7276","37050","1596.1725","0.0207502425","8213382.888750082","106.77397755374872"
"5579","7276","7269","4","7273","37054","1595.514375","0.020741686875","8214978.403125082","106.79471924062372"
"5580","7273","7271","4","7275","37058","1595.953125","0.020747390624999997","8216574.356250082","106.81546663124873"
"5581","7275","7272","195","7467","37253","1638.073125","0.021294950624999996","8218212.429375082","106.83676158187373"
"5582","7467","7465","4","7469","37257","1638.511875","0.021300654375","8219850.941250082","106.85806223624873"
"5583","7469","7464","7","7471","37264","1638.950625","0.021306358124999997","8221489.891875082","106.87936859437373"
"5584","7471","7464","2","7466","37266","1637.8537499999995","0.02129209874999999","8223127.7456250815","106.90066069312373"
"5585","7466","7463","3","7466","37269","1637.8537499999995","0.02129209874999999","8224765.599375081","106.92195279187372"
"5586","7466","7461","7","7468","37276","1638.2925","0.021297802499999997","8226403.891875082","106.94325059437372"
"5587","7468","7467","9","7476","37285","1640.0475","0.021320617499999996","8228043.939375082","106.96457121187372"
"5588","7476","7471","2","7473","37287","1639.389375","0.021312061875","8229683.328750082","106.98588327374871"
"5589","7473","7471","9","7480","37296","1640.925","0.021332024999999998","8231324.253750082","107.00721529874872"
"5590","7480","7472","3","7475","37299","1639.828125","0.021317765625","8232964.081875082","107.02853306437372"
"5591","7475","7471","1","7472","37300","1639.17","0.02130921","8234603.251875082","107.04984227437372"
"5592","7472","7464","1","7465","37301","1637.634375","0.021289246875","8236240.886250082","107.07113152124872"
"5593","7465","7459","7","7466","37308","1637.8537499999995","0.02129209874999999","8237878.740000082","107.09242361999871"
"5594","7466","7457","2","7459","37310","1636.318125","0.021272135624999997","8239515.058125082","107.11369575562371"
"5595","7459","7452","2","7454","37312","1635.2212499999998","0.021257876249999995","8241150.279375083","107.13495363187371"
"5596","7454","7450","6","7456","37318","1635.6599999999999","0.021263579999999997","8242785.939375083","107.15621721187371"
"5597","7456","7449","3","7452","37321","1634.7825000000003","0.021252172500000003","8244420.721875083","107.17746938437371"
"5598","7452","7446","8","7454","37329","1635.2212499999998","0.021257876249999995","8246055.943125083","107.19872726062371"
"5599","7454","7448","7","7455","37336","1635.440625","0.021260728125","8247691.383750083","107.21998798874871"
"5600","7455","7451","3","7454","37339","1635.2212499999998","0.021257876249999995","8249326.605000083","107.24124586499872"
"5601","7454","7449","5","7454","37344","1635.2212499999998","0.021257876249999995","8250961.826250084","107.26250374124872"
"5602","7454","7446","2","7448","37346","1633.905","0.021240764999999998","8252595.731250084","107.28374450624872"
"5603","7448","7443","6","7449","37352","1634.1243749999999","0.021243616874999996","8254229.855625084","107.30498812312372"
"5604","7449","7446","9","7455","37361","1635.440625","0.021260728125","8255865.2962500835","107.32624885124872"
"5605","7455","7454","2","7456","37363","1635.6599999999999","0.021263579999999997","8257500.956250084","107.34751243124872"
"5606","7456","7453","5","7458","37368","1636.09875","0.02126928375","8259137.0550000835","107.36878171499872"
"5607","7458","7456","1","7457","37369","1635.879375","0.021266431875","8260772.934375083","107.39004814687372"
"5608","7457","7456","6","7462","37375","1636.9762500000002","0.02128069125","8262409.910625083","107.41132883812372"
"5609","7462","7453","9","7462","37384","1636.9762500000002","0.02128069125","8264046.886875084","107.43260952937372"
"5610","7462","7455","8","7463","37392","1637.195625","0.021283543125","8265684.082500083","107.45389307249872"
"5611","7463","7456","7","7463","37399","1637.195625","0.021283543125","8267321.278125083","107.47517661562371"
"5612","7463","7461","2","7463","37401","1637.195625","0.021283543125","8268958.473750083","107.4964601587487"
"5613","7463","7454","2","7456","37403","1635.6599999999999","0.021263579999999997","8270594.133750083","107.5177237387487"
"5614","7456","7448","1","7449","37404","1634.1243749999999","0.021243616874999996","8272228.258125083","107.5389673556237"
"5615","7449","7444","3","7447","37407","1633.685625","0.021237913125","8273861.9437500825","107.5602052687487"
"5616","7447","7442","2","7444","37409","1633.0275","0.021229357499999997","8275494.971250082","107.58143462624871"
"5617","7444","7438","6","7444","37415","1633.0275","0.021229357499999997","8277127.998750082","107.60266398374871"
"5618","7444","7438","1","7439","37416","1631.930625","0.021215098124999998","8278759.929375082","107.62387908187371"
"5619","7439","7432","1","7433","37417","1630.614375","0.021197986875","8280390.543750082","107.6450770687487"
"5620","7433","7426","8","7434","37425","1630.83375","0.02120083875","8282021.377500082","107.66627790749871"
"5621","7434","7432","3","7435","37428","1631.053125","0.021203690624999997","8283652.430625082","107.68748159812371"
"5622","7435","7430","3","7433","37431","1630.614375","0.021197986875","8285283.045000082","107.7086795849987"
"5623","7433","7425","2","7427","37433","1629.2981250000003","0.021180875625","8286912.343125082","107.72986046062371"
"5624","7427","7423","5","7428","37438","1629.5175000000002","0.0211837275","8288541.860625082","107.75104418812371"
"5625","7428","7427","5","7432","37443","1630.395","0.021195134999999997","8290172.255625081","107.77223932312371"
"5626","7432","7430","4","7434","37447","1630.83375","0.02120083875","8291803.0893750815","107.79344016187372"
"5627","7434","7426","2","7428","37449","1629.5175000000002","0.0211837275","8293432.606875082","107.81462388937372"
"5628","7428","7419","4","7423","37453","1628.420625","0.021169468124999997","8295061.027500082","107.83579335749872"
"5629","7423","7421","5","7426","37458","1629.07875","0.021178023749999997","8296690.106250082","107.85697138124871"
"5630","7426","7417","1","7418","37459","1627.32375","0.021155208749999998","8298317.430000083","107.87812658999871"
"5631","7418","7410","5","7415","37464","1626.665625","0.021146653125","8299944.095625083","107.89927324312372"
"5632","7415","7406","9","7415","37473","1626.665625","0.021146653125","8301570.761250083","107.92041989624872"
"5633","7415","7410","1","7411","37474","1625.7881249999998","0.021135245624999997","8303196.549375083","107.94155514187372"
"5634","7411","7407","1","7408","37475","1625.13","0.02112669","8304821.679375083","107.96268183187372"
"5635","7408","7406","7","7413","37482","1626.226875","0.021140949375","8306447.906250083","107.98382278124872"
"5636","7413","7410","9","7419","37491","1627.543125","0.021158060625","8308075.449375083","108.00498084187372"
"5637","7419","7417","7","7424","37498","1628.6399999999999","0.021172319999999998","8309704.089375082","108.02615316187372"
"5638","7424","7423","3","7426","37501","1629.07875","0.021178023749999997","8311333.168125083","108.04733118562372"
"5639","7426","7419","7","7426","37508","1629.07875","0.021178023749999997","8312962.246875083","108.06850920937372"
"5640","7426","7424","1","7425","37509","1628.859375","0.021175171875","8314591.106250083","108.08968438124872"
"5641","7425","7423","376","7799","37885","1710.9056249999999","0.022241773124999996","8316302.011875083","108.11192615437372"
"5642","7799","7796","6","7802","37891","1711.5637500000003","0.022250328750000003","8318013.5756250825","108.13417648312372"
"5643","7802","7797","8","7805","37899","1712.221875","0.022258884375","8319725.797500082","108.15643536749873"
"5644","7805","7798","7","7805","37906","1712.221875","0.022258884375","8321438.019375082","108.17869425187374"
"5645","7805","7799","8","7807","37914","1712.660625","0.022264588125","8323150.680000082","108.20095883999873"
"5646","7807","7806","5","7811","37919","1713.5381249999998","0.022275995624999996","8324864.218125082","108.22323483562373"
"5647","7811","7805","9","7814","37928","1714.19625","0.02228455125","8326578.414375082","108.24551938687372"
"5648","7814","7805","7","7812","37935","1713.7575000000002","0.0222788475","8328292.171875082","108.26779823437373"
"5649","7812","7809","7","7816","37942","1714.6349999999995","0.02229025499999999","8330006.806875082","108.29008848937373"
"5650","7816","7813","3","7816","37945","1714.6349999999995","0.02229025499999999","8331721.4418750815","108.31237874437373"
"5651","7816","7810","3","7813","37948","1713.976875","0.022281699375","8333435.418750081","108.33466044374873"
"5652","7813","7806","5","7811","37953","1713.5381249999998","0.022275995624999996","8335148.956875081","108.35693643937373"
"5653","7811","7808","7","7815","37960","1714.415625","0.022287403125","8336863.372500082","108.37922384249873"
"5654","7815","7812","5","7817","37965","1714.854375","0.022293106874999996","8338578.226875082","108.40151694937373"
"5655","7817","7816","4","7820","37969","1715.5125","0.0223016625","8340293.739375082","108.42381861187373"
"5656","7820","7811","5","7816","37974","1714.6349999999995","0.02229025499999999","8342008.374375082","108.44610886687373"
"5657","7816","7812","3","7815","37977","1714.415625","0.022287403125","8343722.790000082","108.46839626999873"
"5658","7815","7808","8","7816","37985","1714.6349999999995","0.02229025499999999","8345437.425000082","108.49068652499874"
"5659","7816","7807","9","7816","37994","1714.6349999999995","0.02229025499999999","8347152.060000082","108.51297677999874"
"5660","7816","7810","2","7812","37996","1713.7575000000002","0.0222788475","8348865.817500082","108.53525562749874"
"5661","7812","7805","7","7812","38003","1713.7575000000002","0.0222788475","8350579.575000082","108.55753447499875"
"5662","7812","7805","5","7810","38008","1713.31875","0.02227314375","8352292.893750082","108.57980761874875"
"5663","7810","7804","5","7809","38013","1713.099375","0.022270291874999997","8354005.993125082","108.60207791062375"
"5664","7809","7807","7","7814","38020","1714.19625","0.02228455125","8355720.189375082","108.62436246187374"
"5665","7814","7813","5","7818","38025","1715.07375","0.022295958749999997","8357435.2631250825","108.64665842062374"
"5666","7818","7809","8","7817","38033","1714.854375","0.022293106874999996","8359150.117500083","108.66895152749873"
"5667","7817","7813","3","7816","38036","1714.6349999999995","0.02229025499999999","8360864.752500082","108.69124178249874"
"5668","7816","7807","4","7811","38040","1713.5381249999998","0.022275995624999996","8362578.290625082","108.71351777812373"
"5669","7811","7804","7","7811","38047","1713.5381249999998","0.022275995624999996","8364291.828750082","108.73579377374872"
"5670","7811","7802","8","7810","38055","1713.31875","0.02227314375","8366005.147500082","108.75806691749872"
"5671","7810","7801","9","7810","38064","1713.31875","0.02227314375","8367718.466250082","108.78034006124872"
"5672","7810","7804","3","7807","38067","1712.660625","0.022264588125","8369431.126875081","108.80260464937372"
"5673","7807","7803","3","7806","38070","1712.4412499999999","0.022261736249999997","8371143.568125081","108.82486638562372"
"5674","7806","7799","8","7807","38078","1712.660625","0.022264588125","8372856.228750081","108.84713097374872"
"5675","7807","7803","3","7806","38081","1712.4412499999999","0.022261736249999997","8374568.670000081","108.86939270999872"
"5676","7806","7799","3","7802","38084","1711.5637500000003","0.022250328750000003","8376280.233750081","108.89164303874873"
"5677","7802","7793","4","7797","38088","1710.466875","0.022236069375","8377990.700625081","108.91387910812372"
"5678","7797","7795","7","7802","38095","1711.5637500000003","0.022250328750000003","8379702.26437508","108.93612943687373"
"5679","7802","7795","4","7799","38099","1710.9056249999999","0.022241773124999996","8381413.17000008","108.95837120999873"
"5680","7799","7794","5","7799","38104","1710.9056249999999","0.022241773124999996","8383124.07562508","108.98061298312373"
"5681","7799","7792","9","7801","38113","1711.344375","0.022247476874999998","8384835.42000008","109.00286045999873"
"5682","7801","7792","6","7798","38119","1710.68625","0.022238921249999998","8386546.10625008","109.02509938124872"
"5683","7798","7797","7","7804","38126","1712.0024999999998","0.022256032499999995","8388258.108750081","109.04735541374872"
"5684","7804","7795","7","7802","38133","1711.5637500000003","0.022250328750000003","8389969.672500081","109.06960574249872"
"5685","7802","7801","9","7810","38142","1713.31875","0.02227314375","8391682.991250081","109.09187888624872"
"5686","7810","7807","1","7808","38143","1712.88","0.02226744","8393395.871250082","109.11414632624872"
"5687","7808","7801","6","7807","38149","1712.660625","0.022264588125","8395108.531875081","109.13641091437371"
"5688","7807","7801","8","7809","38157","1713.099375","0.022270291874999997","8396821.631250082","109.15868120624872"
"5689","7809","7800","4","7804","38161","1712.0024999999998","0.022256032499999995","8398533.633750081","109.18093723874871"
"5690","7804","7801","9","7810","38170","1713.31875","0.02227314375","8400246.95250008","109.20321038249871"
"5691","7810","7808","6","7814","38176","1714.19625","0.02228455125","8401961.14875008","109.2254949337487"
"5692","7814","7812","6","7818","38182","1715.07375","0.022295958749999997","8403676.22250008","109.2477908924987"
"5693","7818","7814","2","7816","38184","1714.6349999999995","0.02229025499999999","8405390.85750008","109.2700811474987"
"5694","7816","7807","5","7812","38189","1713.7575000000002","0.0222788475","8407104.61500008","109.2923599949987"
"5695","7812","7805","6","7811","38195","1713.5381249999998","0.022275995624999996","8408818.153125081","109.3146359906237"
"5696","7811","7805","1","7806","38196","1712.4412499999999","0.022261736249999997","8410530.594375081","109.3368977268737"
"5697","7806","7800","2","7802","38198","1711.5637500000003","0.022250328750000003","8412242.158125082","109.3591480556237"
"5698","7802","7800","4","7804","38202","1712.0024999999998","0.022256032499999995","8413954.160625082","109.3814040881237"
"5699","7804","7801","7","7808","38209","1712.88","0.02226744","8415667.040625082","109.4036715281237"
"5700","7808","7800","7","7807","38216","1712.660625","0.022264588125","8417379.701250082","109.42593611624869"
"5701","7807","7805","318","8123","38534","1781.983125","0.023165780624999997","8419161.684375081","109.4491018968737"
"5702","8123","8116","8","8124","38542","1782.2024999999999","0.023168632499999998","8420943.886875082","109.4722705293737"
"5703","8124","8117","8","8125","38550","1782.421875","0.023171484375","8422726.308750082","109.4954420137487"
"5704","8125","8119","4","8123","38554","1781.983125","0.023165780624999997","8424508.291875081","109.51860779437371"
"5705","8123","8117","9","8126","38563","1782.64125","0.023174336249999997","8426290.93312508","109.5417821306237"
"5706","8126","8117","9","8126","38572","1782.64125","0.023174336249999997","8428073.57437508","109.5649564668737"
"5707","8126","8117","6","8123","38578","1781.983125","0.023165780624999997","8429855.55750008","109.5881222474987"
"5708","8123","8122","4","8126","38582","1782.64125","0.023174336249999997","8431638.198750079","109.6112965837487"
"5709","8126","8125","1","8126","38583","1782.64125","0.023174336249999997","8433420.840000078","109.63447091999869"
"5710","8126","8125","4","8129","38587","1783.2993749999998","0.023182891874999997","8435204.139375078","109.65765381187369"
"5711","8129","8122","8","8130","38595","1783.51875","0.023185743749999998","8436987.658125078","109.68083955562369"
"5712","8130","8127","9","8136","38604","1784.8349999999998","0.023202854999999994","8438772.49312508","109.70404241062369"
"5713","8136","8129","3","8132","38607","1783.9575","0.023191447499999997","8440556.450625079","109.72723385812368"
"5714","8132","8130","9","8139","38616","1785.493125","0.023211410624999998","8442341.943750078","109.75044526874868"
"5715","8139","8134","5","8139","38621","1785.493125","0.023211410624999998","8444127.436875077","109.77365667937367"
"5716","8139","8131","3","8134","38624","1784.39625","0.02319715125","8445911.833125077","109.79685383062368"
"5717","8134","8126","8","8134","38632","1784.39625","0.02319715125","8447696.229375077","109.82005098187368"
"5718","8134","8131","6","8137","38638","1785.0543750000002","0.023205706875","8449481.283750078","109.84325668874868"
"5719","8137","8136","1","8137","38639","1785.0543750000002","0.023205706875","8451266.338125078","109.86646239562369"
"5720","8137","8130","4","8134","38643","1784.39625","0.02319715125","8453050.734375078","109.88965954687369"
"5721","8134","8126","7","8133","38650","1784.176875","0.023194299375","8454834.911250079","109.9128538462487"
"5722","8133","8125","2","8127","38652","1782.8606250000003","0.023177188125","8456617.77187508","109.9360310343737"
"5723","8127","8119","4","8123","38656","1781.983125","0.023165780624999997","8458399.755000079","109.9591968149987"
"5724","8123","8117","6","8123","38662","1781.983125","0.023165780624999997","8460181.738125078","109.98236259562371"
"5725","8123","8117","8","8125","38670","1782.421875","0.023171484375","8461964.160000078","110.00553407999871"
"5726","8125","8124","1","8125","38671","1782.421875","0.023171484375","8463746.581875078","110.02870556437371"
"5727","8125","8119","3","8122","38674","1781.76375","0.02316292875","8465528.345625078","110.0518684931237"
"5728","8122","8120","9","8129","38683","1783.2993749999998","0.023182891874999997","8467311.645000078","110.0750513849987"
"5729","8129","8128","5","8133","38688","1784.176875","0.023194299375","8469095.821875079","110.09824568437371"
"5730","8133","8124","7","8131","38695","1783.7381249999999","0.023188595624999996","8470879.560000079","110.12143427999871"
"5731","8131","8127","2","8129","38697","1783.2993749999998","0.023182891874999997","8472662.859375078","110.1446171718737"
"5732","8129","8124","3","8127","38700","1782.8606250000003","0.023177188125","8474445.720000079","110.16779435999871"
"5733","8127","8121","6","8127","38706","1782.8606250000003","0.023177188125","8476228.58062508","110.19097154812371"
"5734","8127","8124","5","8129","38711","1783.2993749999998","0.023182891874999997","8478011.880000079","110.21415443999871"
"5735","8129","8125","9","8134","38720","1784.39625","0.02319715125","8479796.27625008","110.23735159124871"
"5736","8134","8125","3","8128","38723","1783.0800000000002","0.02318004","8481579.35625008","110.26053163124871"
"5737","8128","8125","5","8130","38728","1783.51875","0.023185743749999998","8483362.87500008","110.28371737499872"
"5738","8130","8123","6","8129","38734","1783.2993749999998","0.023182891874999997","8485146.17437508","110.30690026687371"
"5739","8129","8123","9","8132","38743","1783.9575","0.023191447499999997","8486930.13187508","110.33009171437371"
"5740","8132","8124","3","8127","38746","1782.8606250000003","0.023177188125","8488712.99250008","110.35326890249871"
"5741","8127","8126","3","8129","38749","1783.2993749999998","0.023182891874999997","8490496.29187508","110.37645179437371"
"5742","8129","8122","7","8129","38756","1783.2993749999998","0.023182891874999997","8492279.591250079","110.3996346862487"
"5743","8129","8123","8","8131","38764","1783.7381249999999","0.023188595624999996","8494063.329375079","110.4228232818737"
"5744","8131","8124","7","8131","38771","1783.7381249999999","0.023188595624999996","8495847.067500079","110.4460118774987"
"5745","8131","8124","8","8132","38779","1783.9575","0.023191447499999997","8497631.025000079","110.4692033249987"
"5746","8132","8128","2","8130","38781","1783.51875","0.023185743749999998","8499414.54375008","110.49238906874871"
"5747","8130","8121","1","8122","38782","1781.76375","0.02316292875","8501196.30750008","110.5155519974987"
"5748","8122","8120","7","8127","38789","1782.8606250000003","0.023177188125","8502979.16812508","110.53872918562371"
"5749","8127","8125","4","8129","38793","1783.2993749999998","0.023182891874999997","8504762.46750008","110.5619120774987"
"5750","8129","8128","6","8134","38799","1784.39625","0.02319715125","8506546.86375008","110.5851092287487"
"5751","8134","8133","3","8136","38802","1784.8349999999998","0.023202854999999994","8508331.69875008","110.6083120837487"
"5752","8136","8133","7","8140","38809","1785.7125","0.0232142625","8510117.41125008","110.6315263462487"
"5753","8140","8131","9","8140","38818","1785.7125","0.0232142625","8511903.123750081","110.65474060874871"
"5754","8140","8134","8","8142","38826","1786.15125","0.023219966249999998","8513689.27500008","110.6779605749987"
"5755","8142","8136","9","8145","38835","1786.809375","0.023228521874999998","8515476.08437508","110.7011890968737"
"5756","8145","8138","6","8144","38841","1786.59","0.023225669999999997","8517262.67437508","110.7244147668737"
"5757","8144","8143","9","8152","38850","1788.3450000000003","0.023248485000000003","8519051.01937508","110.7476632518737"
"5758","8152","8144","7","8151","38857","1788.125625","0.023245633124999998","8520839.14500008","110.7709088849987"
"5759","8151","8144","3","8147","38860","1787.248125","0.023234225625","8522626.39312508","110.79414311062371"
"5760","8147","8143","5","8148","38865","1787.4675","0.023237077499999998","8524413.860625079","110.8173801881237"
"5761","8148","8147","325","8472","39190","1858.545","0.024161085","8526272.405625079","110.84154127312371"
"5762","8472","8468","1","8469","39191","1857.886875","0.024152529375","8528130.292500079","110.86569380249871"
"5763","8469","8460","5","8465","39196","1857.009375","0.024141121875","8529987.301875079","110.88983492437372"
"5764","8465","8464","7","8471","39203","1858.325625","0.024158233124999998","8531845.62750008","110.91399315749871"
"5765","8471","8465","9","8474","39212","1858.9837499999999","0.024166788749999998","8533704.61125008","110.9381599462487"
"5766","8474","8470","6","8476","39218","1859.4225","0.024172492499999997","8535564.03375008","110.9623324387487"
"5767","8476","8472","6","8478","39224","1859.8612500000002","0.02417819625","8537423.89500008","110.98651063499871"
"5768","8478","8476","9","8485","39233","1861.396875","0.024198159374999997","8539285.29187508","111.01070879437371"
"5769","8485","8480","3","8483","39236","1860.958125","0.024192455625","8541146.25000008","111.03490124999871"
"5770","8483","8474","2","8476","39238","1859.4225","0.024172492499999997","8543005.67250008","111.05907374249871"
"5771","8476","8471","3","8474","39241","1858.9837499999999","0.024166788749999998","8544864.65625008","111.0832405312487"
"5772","8474","8472","8","8480","39249","1860.3","0.024183899999999998","8546724.95625008","111.1074244312487"
"5773","8480","8476","8","8484","39257","1861.1775","0.0241953075","8548586.133750081","111.1316197387487"
"5774","8484","8482","7","8489","39264","1862.274375","0.024209566874999998","8550448.40812508","111.1558293056237"
"5775","8489","8485","3","8488","39267","1862.055","0.024206715","8552310.46312508","111.1800360206237"
"5776","8488","8482","9","8491","39276","1862.7131249999995","0.024215270624999993","8554173.17625008","111.20425129124871"
"5777","8491","8483","3","8486","39279","1861.6162499999998","0.024201011249999994","8556034.79250008","111.22845230249871"
"5778","8486","8484","6","8490","39285","1862.49375","0.02421241875","8557897.28625008","111.2526647212487"
"5779","8490","8481","4","8485","39289","1861.396875","0.024198159374999997","8559758.68312508","111.27686288062371"
"5780","8485","8480","4","8484","39293","1861.1775","0.0241953075","8561619.86062508","111.3010581881237"
"5781","8484","8478","6","8484","39299","1861.1775","0.0241953075","8563481.038125081","111.3252534956237"
"5782","8484","8479","6","8485","39305","1861.396875","0.024198159374999997","8565342.43500008","111.3494516549987"
"5783","8485","8482","2","8484","39307","1861.1775","0.0241953075","8567203.61250008","111.3736469624987"
"5784","8484","8483","2","8485","39309","1861.396875","0.024198159374999997","8569065.00937508","111.3978451218737"
"5785","8485","8481","3","8484","39312","1861.1775","0.0241953075","8570926.18687508","111.4220404293737"
"5786","8484","8482","3","8485","39315","1861.396875","0.024198159374999997","8572787.58375008","111.4462385887487"
"5787","8485","8480","6","8486","39321","1861.6162499999998","0.024201011249999994","8574649.200000081","111.4704395999987"
"5788","8486","8479","5","8484","39326","1861.1775","0.0241953075","8576510.377500081","111.49463490749869"
"5789","8484","8477","3","8480","39329","1860.3","0.024183899999999998","8578370.677500082","111.51881880749869"
"5790","8480","8473","8","8481","39337","1860.5193749999999","0.024186751874999995","8580231.196875082","111.5430055593737"
"5791","8481","8474","6","8480","39343","1860.3","0.024183899999999998","8582091.496875083","111.5671894593737"
"5792","8480","8474","8","8482","39351","1860.73875","0.024189603749999997","8583952.235625083","111.5913790631237"
"5793","8482","8480","5","8485","39356","1861.396875","0.024198159374999997","8585813.632500082","111.6155772224987"
"5794","8485","8482","5","8487","39361","1861.8356250000002","0.024203863125","8587675.468125083","111.6397810856237"
"5795","8487","8482","9","8491","39370","1862.7131249999995","0.024215270624999993","8589538.181250082","111.6639963562487"
"5796","8491","8482","8","8490","39378","1862.49375","0.02421241875","8591400.675000083","111.6882087749987"
"5797","8490","8487","2","8489","39380","1862.274375","0.024209566874999998","8593262.949375082","111.7124183418737"
"5798","8489","8481","6","8487","39386","1861.8356250000002","0.024203863125","8595124.785000082","111.7366222049987"
"5799","8487","8485","2","8487","39388","1861.8356250000002","0.024203863125","8596986.620625082","111.76082606812369"
"5800","8487","8481","7","8488","39395","1862.055","0.024206715","8598848.675625082","111.7850327831237"
"5801","8488","8486","4","8490","39399","1862.49375","0.02421241875","8600711.169375082","111.8092452018737"
"5802","8490","8481","4","8485","39403","1861.396875","0.024198159374999997","8602572.566250082","111.8334433612487"
"5803","8485","8480","3","8483","39406","1860.958125","0.024192455625","8604433.524375083","111.8576358168737"
"5804","8483","8480","9","8489","39415","1862.274375","0.024209566874999998","8606295.798750082","111.8818453837487"
"5805","8489","8485","1","8486","39416","1861.6162499999998","0.024201011249999994","8608157.415000083","111.9060463949987"
"5806","8486","8479","2","8481","39418","1860.5193749999999","0.024186751874999995","8610017.934375083","111.9302331468737"
"5807","8481","8479","5","8484","39423","1861.1775","0.0241953075","8611879.111875083","111.9544284543737"
"5808","8484","8483","4","8487","39427","1861.8356250000002","0.024203863125","8613740.947500084","111.9786323174987"
"5809","8487","8486","1","8487","39428","1861.8356250000002","0.024203863125","8615602.783125084","112.00283618062369"
"5810","8487","8478","5","8483","39433","1860.958125","0.024192455625","8617463.741250085","112.02702863624869"
"5811","8483","8474","9","8483","39442","1860.958125","0.024192455625","8619324.699375086","112.05122109187369"
"5812","8483","8477","1","8478","39443","1859.8612500000002","0.02417819625","8621184.560625086","112.07539928812369"
"5813","8478","8476","4","8480","39447","1860.3","0.024183899999999998","8623044.860625086","112.09958318812369"
"5814","8480","8473","3","8476","39450","1859.4225","0.024172492499999997","8624904.283125086","112.12375568062369"
"5815","8476","8469","6","8475","39456","1859.203125","0.024169640625","8626763.486250086","112.14792532124869"
"5816","8475","8470","4","8474","39460","1858.9837499999999","0.024166788749999998","8628622.470000086","112.17209210999869"
"5817","8474","8467","9","8476","39469","1859.4225","0.024172492499999997","8630481.892500086","112.19626460249869"
"5818","8476","8471","2","8473","39471","1858.764375","0.024163936874999997","8632340.656875085","112.22042853937369"
"5819","8473","8469","1","8470","39472","1858.10625","0.02415538125","8634198.763125084","112.24458392062368"
"5820","8470","8465","8","8473","39480","1858.764375","0.024163936874999997","8636057.527500084","112.26874785749868"
"5821","8473","8471","281","8752","39761","1919.9700000000003","0.02495961","8637977.497500084","112.29370746749868"
"5822","8752","8744","1","8745","39762","1918.434375","0.024939646875","8639895.931875084","112.31864711437368"
"5823","8745","8739","6","8745","39768","1918.434375","0.024939646875","8641814.366250083","112.34358676124867"
"5824","8745","8737","3","8740","39771","1917.3375","0.0249253875","8643731.703750083","112.36851214874868"
"5825","8740","8736","5","8741","39776","1917.556875","0.024928239374999998","8645649.260625083","112.39344038812368"
"5826","8741","8739","2","8741","39778","1917.556875","0.024928239374999998","8647566.817500083","112.41836862749868"
"5827","8741","8736","5","8741","39783","1917.556875","0.024928239374999998","8649484.374375083","112.44329686687368"
"5828","8741","8739","5","8744","39788","1918.215","0.024936794999999998","8651402.589375082","112.46823366187368"
"5829","8744","8736","1","8737","39789","1916.6793750000002","0.024916831875","8653319.268750083","112.49315049374869"
"5830","8737","8731","4","8735","39793","1916.240625","0.024911128124999998","8655235.509375082","112.51806162187368"
"5831","8735","8732","8","8740","39801","1917.3375","0.0249253875","8657152.846875083","112.54298700937369"
"5832","8740","8731","5","8736","39806","1916.4599999999998","0.024913979999999995","8659069.306875084","112.56790098937368"
"5833","8736","8735","4","8739","39810","1917.118125","0.024922535625","8660986.425000083","112.59282352499868"
"5834","8739","8733","7","8740","39817","1917.3375","0.0249253875","8662903.762500083","112.61774891249868"
"5835","8740","8732","6","8738","39823","1916.89875","0.024919683749999998","8664820.661250083","112.64266859624868"
"5836","8738","8733","4","8737","39827","1916.6793750000002","0.024916831875","8666737.340625083","112.66758542812369"
"5837","8737","8734","2","8736","39829","1916.4599999999998","0.024913979999999995","8668653.800625084","112.69249940812368"
"5838","8736","8731","6","8737","39835","1916.6793750000002","0.024916831875","8670570.480000084","112.71741623999868"
"5839","8737","8734","7","8741","39842","1917.556875","0.024928239374999998","8672488.036875084","112.74234447937368"
"5840","8741","8735","8","8743","39850","1917.995625","0.024933943125","8674406.032500084","112.76727842249869"
"5841","8743","8741","6","8747","39856","1918.873125","0.024945350624999998","8676324.905625084","112.7922237731237"
"5842","8747","8739","1","8740","39857","1917.3375","0.0249253875","8678242.243125085","112.8171491606237"
"5843","8740","8737","7","8744","39864","1918.215","0.024936794999999998","8680160.458125085","112.8420859556237"
"5844","8744","8735","6","8741","39870","1917.556875","0.024928239374999998","8682078.015000084","112.8670141949987"
"5845","8741","8733","5","8738","39875","1916.89875","0.024919683749999998","8683994.913750084","112.8919338787487"
"5846","8738","8733","7","8740","39882","1917.3375","0.0249253875","8685912.251250084","112.91685926624871"
"5847","8740","8734","3","8737","39885","1916.6793750000002","0.024916831875","8687828.930625085","112.94177609812371"
"5848","8737","8730","6","8736","39891","1916.4599999999998","0.024913979999999995","8689745.390625086","112.9666900781237"
"5849","8736","8735","2","8737","39893","1916.6793750000002","0.024916831875","8691662.070000086","112.99160690999871"
"5850","8737","8731","2","8733","39895","1915.801875","0.024905424375","8693577.871875087","113.01651233437372"
"5851","8733","8725","3","8728","39898","1914.7050000000002","0.024891165","8695492.576875087","113.04140349937371"
"5852","8728","8725","3","8728","39901","1914.7050000000002","0.024891165","8697407.281875087","113.06629466437371"
"5853","8728","8720","1","8721","39902","1913.169375","0.024871201875","8699320.451250087","113.09116586624872"
"5854","8721","8712","9","8721","39911","1913.169375","0.024871201875","8701233.620625088","113.11603706812372"
"5855","8721","8719","6","8725","39917","1914.046875","0.024882609375","8703147.667500088","113.14091967749872"
"5856","8725","8724","5","8729","39922","1914.9243749999998","0.024894016874999998","8705062.591875087","113.16581369437371"
"5857","8729","8721","5","8726","39927","1914.26625","0.024885461249999997","8706976.858125087","113.1906991556237"
"5858","8726","8720","6","8726","39933","1914.26625","0.024885461249999997","8708891.124375086","113.2155846168737"
"5859","8726","8720","9","8729","39942","1914.9243749999998","0.024894016874999998","8710806.048750086","113.2404786337487"
"5860","8729","8722","7","8729","39949","1914.9243749999998","0.024894016874999998","8712720.973125085","113.26537265062369"
"5861","8729","8720","9","8729","39958","1914.9243749999998","0.024894016874999998","8714635.897500085","113.29026666749868"
"5862","8729","8721","8","8729","39966","1914.9243749999998","0.024894016874999998","8716550.821875084","113.31516068437368"
"5863","8729","8723","3","8726","39969","1914.26625","0.024885461249999997","8718465.088125084","113.34004614562367"
"5864","8726","8719","6","8725","39975","1914.046875","0.024882609375","8720379.135000084","113.36492875499867"
"5865","8725","8724","6","8730","39981","1915.14375","0.02489686875","8722294.278750084","113.38982562374868"
"5866","8730","8723","6","8729","39987","1914.9243749999998","0.024894016874999998","8724209.203125084","113.41471964062367"
"5867","8729","8725","9","8734","39996","1916.02125","0.02490827625","8726125.224375084","113.43962791687368"
"5868","8734","8729","8","8737","40004","1916.6793750000002","0.024916831875","8728041.903750084","113.46454474874868"
"5869","8737","8730","1","8731","40005","1915.3631249999999","0.024899720624999996","8729957.266875084","113.48944446937368"
"5870","8731","8727","8","8735","40013","1916.240625","0.024911128124999998","8731873.507500084","113.51435559749868"
"5871","8735","8732","9","8741","40022","1917.556875","0.024928239374999998","8733791.064375084","113.53928383687368"
"5872","8741","8736","5","8741","40027","1917.556875","0.024928239374999998","8735708.621250084","113.56421207624868"
"5873","8741","8734","1","8735","40028","1916.240625","0.024911128124999998","8737624.861875083","113.58912320437368"
"5874","8735","8732","2","8734","40030","1916.02125","0.02490827625","8739540.883125084","113.61403148062368"
"5875","8734","8730","6","8736","40036","1916.4599999999998","0.024913979999999995","8741457.343125084","113.63894546062367"
"5876","8736","8731","2","8733","40038","1915.801875","0.024905424375","8743373.145000085","113.66385088499868"
"5877","8733","8731","4","8735","40042","1916.240625","0.024911128124999998","8745289.385625085","113.68876201312368"
"5878","8735","8730","7","8737","40049","1916.6793750000002","0.024916831875","8747206.065000085","113.71367884499868"
"5879","8737","8735","2","8737","40051","1916.6793750000002","0.024916831875","8749122.744375085","113.73859567687369"
"5880","8737","8728","4","8732","40055","1915.5825","0.024902572499999998","8751038.326875085","113.76349824937368"
"5881","8732","8731","205","8936","40260","1960.3349999999998","0.025484354999999997","8752998.661875086","113.78898260437369"
"5882","8936","8934","3","8937","40263","1960.5543750000002","0.025487206875","8754959.216250086","113.81446981124869"
"5883","8937","8933","6","8939","40269","1960.993125","0.025492910624999997","8756920.209375085","113.83996272187369"
"5884","8939","8935","9","8944","40278","1962.09","0.025507169999999996","8758882.299375085","113.86546989187369"
"5885","8944","8938","3","8941","40281","1961.431875","0.025498614375","8760843.731250085","113.89096850624868"
"5886","8941","8940","3","8943","40284","1961.870625","0.025504318124999998","8762805.601875085","113.91647282437368"
"5887","8943","8936","8","8944","40292","1962.09","0.025507169999999996","8764767.691875085","113.94197999437368"
"5888","8944","8937","1","8938","40293","1960.77375","0.02549005875","8766728.465625085","113.96747005312368"
"5889","8938","8934","7","8941","40300","1961.431875","0.025498614375","8768689.897500085","113.99296866749867"
"5890","8941","8932","6","8938","40306","1960.77375","0.02549005875","8770650.671250084","114.01845872624867"
"5891","8938","8932","7","8939","40313","1960.993125","0.025492910624999997","8772611.664375084","114.04395163687367"
"5892","8939","8936","2","8938","40315","1960.77375","0.02549005875","8774572.438125083","114.06944169562367"
"5893","8938","8932","3","8935","40318","1960.115625","0.025481503124999996","8776532.553750083","114.09492319874866"
"5894","8935","8928","1","8929","40319","1958.7993749999998","0.025464391874999995","8778491.353125082","114.12038759062366"
"5895","8929","8926","5","8931","40324","1959.2381249999999","0.025470095624999998","8780450.591250082","114.14585768624866"
"5896","8931","8928","9","8937","40333","1960.5543750000002","0.025487206875","8782411.145625083","114.17134489312366"
"5897","8937","8934","6","8940","40339","1961.2125","0.025495762499999998","8784372.358125083","114.19684065562366"
"5898","8940","8931","2","8933","40341","1959.676875","0.025475799375","8786332.035000084","114.22231645499866"
"5899","8933","8930","2","8932","40343","1959.4575","0.0254729475","8788291.492500084","114.24778940249867"
"5900","8932","8928","3","8931","40346","1959.2381249999999","0.025470095624999998","8790250.730625084","114.27325949812366"
"5901","8931","8926","7","8933","40353","1959.676875","0.025475799375","8792210.407500084","114.29873529749867"
"5902","8933","8931","1","8932","40354","1959.4575","0.0254729475","8794169.865000084","114.32420824499867"
"5903","8932","8930","1","8931","40355","1959.2381249999999","0.025470095624999998","8796129.103125084","114.34967834062367"
"5904","8931","8925","4","8929","40359","1958.7993749999998","0.025464391874999995","8798087.902500084","114.37514273249867"
"5905","8929","8928","4","8932","40363","1959.4575","0.0254729475","8800047.360000083","114.40061567999868"
"5906","8932","8926","7","8933","40370","1959.676875","0.025475799375","8802007.036875084","114.42609147937368"
"5907","8933","8926","6","8932","40376","1959.4575","0.0254729475","8803966.494375084","114.45156442687369"
"5908","8932","8928","4","8932","40380","1959.4575","0.0254729475","8805925.951875083","114.4770373743737"
"5909","8932","8926","6","8932","40386","1959.4575","0.0254729475","8807885.409375083","114.5025103218737"
"5910","8932","8925","6","8931","40392","1959.2381249999999","0.025470095624999998","8809844.647500083","114.5279804174987"
"5911","8931","8924","2","8926","40394","1958.14125","0.025455836249999995","8811802.788750082","114.5534362537487"
"5912","8926","8922","7","8929","40401","1958.7993749999998","0.025464391874999995","8813761.588125082","114.5789006456237"
"5913","8929","8924","6","8930","40407","1959.01875","0.025467243749999997","8815720.606875082","114.6043678893737"
"5914","8930","8925","8","8933","40415","1959.676875","0.025475799375","8817680.283750083","114.62984368874871"
"5915","8933","8930","5","8935","40420","1960.115625","0.025481503124999996","8819640.399375083","114.6553251918737"
"5916","8935","8933","2","8935","40422","1960.115625","0.025481503124999996","8821600.515000083","114.6808066949987"
"5917","8935","8926","3","8929","40425","1958.7993749999998","0.025464391874999995","8823559.314375082","114.7062710868737"
"5918","8929","8928","1","8929","40426","1958.7993749999998","0.025464391874999995","8825518.113750082","114.7317354787487"
"5919","8929","8928","1","8929","40427","1958.7993749999998","0.025464391874999995","8827476.913125081","114.75719987062371"
"5920","8929","8921","8","8929","40435","1958.7993749999998","0.025464391874999995","8829435.71250008","114.78266426249871"
"5921","8929","8922","6","8928","40441","1958.5800000000002","0.02546154","8831394.29250008","114.80812580249871"
"5922","8928","8920","9","8929","40450","1958.7993749999998","0.025464391874999995","8833353.09187508","114.83359019437371"
"5923","8929","8922","5","8927","40455","1958.3606250000003","0.025458688125","8835311.45250008","114.85904888249871"
"5924","8927","8925","4","8929","40459","1958.7993749999998","0.025464391874999995","8837270.25187508","114.88451327437372"
"5925","8929","8923","7","8930","40466","1959.01875","0.025467243749999997","8839229.27062508","114.90998051812372"
"5926","8930","8922","6","8928","40472","1958.5800000000002","0.02546154","8841187.850625081","114.93544205812371"
"5927","8928","8920","6","8926","40478","1958.14125","0.025455836249999995","8843145.99187508","114.96089789437372"
"5928","8926","8921","1","8922","40479","1957.26375","0.025444428749999998","8845103.25562508","114.98634232312372"
"5929","8922","8914","5","8919","40484","1956.605625","0.025435873124999998","8847059.86125008","115.01177819624873"
"5930","8919","8914","6","8920","40490","1956.825","0.025438725","8849016.68625008","115.03721692124873"
"5931","8920","8916","2","8918","40492","1956.38625","0.02543302125","8850973.07250008","115.06264994249872"
"5932","8918","8910","6","8916","40498","1955.9475","0.025427317499999998","8852929.02000008","115.08807725999873"
"5933","8916","8907","1","8908","40499","1954.1925","0.0254045025","8854883.21250008","115.11348176249872"
"5934","8908","8905","2","8907","40501","1953.973125","0.025401650624999998","8856837.18562508","115.13888341312372"
"5935","8907","8898","2","8900","40503","1952.4375","0.0253816875","8858789.62312508","115.16426510062372"
"5936","8900","8898","6","8904","40509","1953.3149999999998","0.025393094999999997","8860742.93812508","115.18965819562372"
"5937","8904","8900","9","8909","40518","1954.411875","0.025407354375","8862697.35000008","115.21506554999873"
"5938","8909","8906","2","8908","40520","1954.1925","0.0254045025","8864651.54250008","115.24047005249872"
"5939","8908","8904","4","8908","40524","1954.1925","0.0254045025","8866605.735000081","115.26587455499872"
"5940","8908","8902","8","8910","40532","1954.63125","0.025410206249999998","8868560.366250081","115.29128476124872"
"5941","8910","8907","480","9387","41012","2059.273125","0.026770550625","8870619.639375081","115.31805531187372"
"5942","9387","9384","4","9388","41016","2059.4925","0.026773402499999994","8872679.131875081","115.34482871437372"
"5943","9388","9385","5","9390","41021","2059.93125","0.02677910625","8874739.063125081","115.37160782062372"
"5944","9390","9385","1","9386","41022","2059.05375","0.02676769875","8876798.116875082","115.39837551937373"
"5945","9386","9381","9","9390","41031","2059.93125","0.02677910625","8878858.048125083","115.42515462562373"
"5946","9390","9381","7","9388","41038","2059.4925","0.026773402499999994","8880917.540625082","115.45192802812373"
"5947","9388","9380","8","9388","41046","2059.4925","0.026773402499999994","8882977.033125082","115.47870143062373"
"5948","9388","9386","9","9395","41055","2061.028125","0.026793365624999996","8885038.061250081","115.50549479624873"
"5949","9395","9392","8","9400","41063","2062.125","0.026807624999999998","8887100.186250081","115.53230242124873"
"5950","9400","9395","2","9397","41065","2061.466875","0.026799069374999998","8889161.653125081","115.55910149062373"
"5951","9397","9391","3","9394","41068","2060.8087499999997","0.026790513749999995","8891222.461875081","115.58589200437373"
"5952","9394","9388","5","9393","41073","2060.589375","0.026787661874999997","8893283.051250082","115.61267966624874"
"5953","9393","9389","6","9395","41079","2061.028125","0.026793365624999996","8895344.07937508","115.63947303187373"
"5954","9395","9391","4","9395","41083","2061.028125","0.026793365624999996","8897405.10750008","115.66626639749873"
"5955","9395","9393","8","9401","41091","2062.344375","0.026810476875","8899467.45187508","115.69307687437373"
"5956","9401","9397","6","9403","41097","2062.783125","0.026816180624999998","8901530.23500008","115.71989305499874"
"5957","9403","9401","7","9408","41104","2063.88","0.02683044","8903594.11500008","115.74672349499873"
"5958","9408","9399","2","9401","41106","2062.344375","0.026810476875","8905656.45937508","115.77353397187373"
"5959","9401","9395","5","9400","41111","2062.125","0.026807624999999998","8907718.58437508","115.80034159687374"
"5960","9400","9394","5","9399","41116","2061.905625","0.026804773124999997","8909780.49000008","115.82714636999873"
"5961","9399","9397","6","9403","41122","2062.783125","0.026816180624999998","8911843.27312508","115.85396255062373"
"5962","9403","9397","1","9398","41123","2061.6862499999997","0.026801921249999996","8913904.95937508","115.88076447187373"
"5963","9398","9397","3","9400","41126","2062.125","0.026807624999999998","8915967.08437508","115.90757209687374"
"5964","9400","9391","7","9398","41133","2061.6862499999997","0.026801921249999996","8918028.770625079","115.93437401812373"
"5965","9398","9394","1","9395","41134","2061.028125","0.026793365624999996","8920089.798750078","115.96116738374873"
"5966","9395","9386","4","9390","41138","2059.93125","0.02677910625","8922149.730000079","115.98794648999873"
"5967","9390","9382","4","9386","41142","2059.05375","0.02676769875","8924208.78375008","116.01471418874874"
"5968","9386","9384","3","9387","41145","2059.273125","0.026770550625","8926268.05687508","116.04148473937374"
"5969","9387","9386","5","9391","41150","2060.1506249999998","0.026781958124999995","8928328.20750008","116.06826669749874"
"5970","9391","9388","6","9394","41156","2060.8087499999997","0.026790513749999995","8930389.01625008","116.09505721124874"
"5971","9394","9393","3","9396","41159","2061.2475","0.026796217499999997","8932450.26375008","116.12185342874875"
"5972","9396","9389","9","9398","41168","2061.6862499999997","0.026801921249999996","8934511.95000008","116.14865534999875"
"5973","9398","9396","4","9400","41172","2062.125","0.026807624999999998","8936574.07500008","116.17546297499875"
"5974","9400","9399","8","9407","41180","2063.660625","0.026827588125","8938637.735625079","116.20229056312375"
"5975","9407","9402","7","9409","41187","2064.099375","0.026833291874999995","8940701.83500008","116.22912385499875"
"5976","9409","9407","5","9412","41192","2064.7575","0.026841847500000002","8942766.59250008","116.25596570249874"
"5977","9412","9410","1","9411","41193","2064.538125","0.026838995624999997","8944831.13062508","116.28280469812374"
"5978","9411","9409","9","9418","41202","2066.07375","0.02685895875","8946897.20437508","116.30966365687374"
"5979","9418","9410","2","9412","41204","2064.7575","0.026841847500000002","8948961.961875081","116.33650550437373"
"5980","9412","9403","7","9410","41211","2064.31875","0.026836143749999996","8951026.28062508","116.36334164812374"
"5981","9410","9403","4","9407","41215","2063.660625","0.026827588125","8953089.94125008","116.39016923624874"
"5982","9407","9402","1","9403","41216","2062.783125","0.026816180624999998","8955152.72437508","116.41698541687374"
"5983","9403","9396","7","9403","41223","2062.783125","0.026816180624999998","8957215.50750008","116.44380159749875"
"5984","9403","9401","5","9406","41228","2063.44125","0.026824736249999995","8959278.94875008","116.47062633374875"
"5985","9406","9404","1","9405","41229","2063.221875","0.026821884375","8961342.170625081","116.49744821812375"
"5986","9405","9402","6","9408","41235","2063.88","0.02683044","8963406.050625082","116.52427865812375"
"5987","9408","9399","4","9403","41239","2062.783125","0.026816180624999998","8965468.833750082","116.55109483874875"
"5988","9403","9394","2","9396","41241","2061.2475","0.026796217499999997","8967530.081250083","116.57789105624876"
"5989","9396","9387","6","9393","41247","2060.589375","0.026787661874999997","8969590.670625083","116.60467871812376"
"5990","9393","9387","3","9390","41250","2059.93125","0.02677910625","8971650.601875084","116.63145782437377"
"5991","9390","9387","8","9395","41258","2061.028125","0.026793365624999996","8973711.630000083","116.65825118999877"
"5992","9395","9387","7","9394","41265","2060.8087499999997","0.026790513749999995","8975772.438750083","116.68504170374877"
"5993","9394","9385","3","9388","41268","2059.4925","0.026773402499999994","8977831.931250082","116.71181510624876"
"5994","9388","9385","8","9393","41276","2060.589375","0.026787661874999997","8979892.520625083","116.73860276812377"
"5995","9393","9386","1","9387","41277","2059.273125","0.026770550625","8981951.793750083","116.76537331874877"
"5996","9387","9381","1","9382","41278","2058.17625","0.026756291249999998","8984009.970000083","116.79212960999877"
"5997","9382","9380","7","9387","41285","2059.273125","0.026770550625","8986069.243125083","116.81890016062377"
"5998","9387","9385","6","9391","41291","2060.1506249999998","0.026781958124999995","8988129.393750083","116.84568211874877"
"5999","9391","9386","8","9394","41299","2060.8087499999997","0.026790513749999995","8990190.202500083","116.87247263249877"
"6000","9394","9391","8","9399","41307","2061.905625","0.026804773124999997","8992252.108125083","116.89927740562376"
"6001","9399","9396","130","9526","41437","2089.76625","0.02716696125","8994341.874375083","116.92644436687377"
"6002","9526","9520","8","9528","41445","2090.205","0.027172665","8996432.079375083","116.95361703187376"
"6003","9528","9519","9","9528","41454","2090.205","0.027172665","8998522.284375083","116.98078969687376"
"6004","9528","9524","6","9530","41460","2090.64375","0.02717836875","9000612.928125083","117.00796806562376"
"6005","9530","9521","3","9524","41463","2089.3275","0.027161257499999997","9002702.255625084","117.03512932312375"
"6006","9524","9518","4","9522","41467","2088.88875","0.02715555375","9004791.144375084","117.06228487687376"
"6007","9522","9518","4","9522","41471","2088.88875","0.02715555375","9006880.033125084","117.08944043062377"
"6008","9522","9514","7","9521","41478","2088.669375","0.027152701874999997","9008968.702500084","117.11659313249876"
"6009","9521","9517","3","9520","41481","2088.45","0.027149849999999996","9011057.152500084","117.14374298249876"
"6010","9520","9519","6","9525","41487","2089.546875","0.027164109375","9013146.699375084","117.17090709187376"
"6011","9525","9518","6","9524","41493","2089.3275","0.027161257499999997","9015236.026875084","117.19806834937376"
"6012","9524","9517","3","9520","41496","2088.45","0.027149849999999996","9017324.476875084","117.22521819937376"
"6013","9520","9515","4","9519","41500","2088.2306249999997","0.027146998124999995","9019412.707500083","117.25236519749876"
"6014","9519","9516","1","9517","41501","2087.791875","0.027141294374999996","9021500.499375083","117.27950649187376"
"6015","9517","9514","6","9520","41507","2088.45","0.027149849999999996","9023588.949375082","117.30665634187376"
"6016","9520","9517","3","9520","41510","2088.45","0.027149849999999996","9025677.399375081","117.33380619187376"
"6017","9520","9518","2","9520","41512","2088.45","0.027149849999999996","9027765.84937508","117.36095604187376"
"6018","9520","9514","1","9515","41513","2087.353125","0.027135590625","9029853.20250008","117.38809163249876"
"6019","9515","9514","2","9516","41515","2087.5724999999998","0.027138442499999995","9031940.77500008","117.41523007499876"
"6020","9516","9511","5","9516","41520","2087.5724999999998","0.027138442499999995","9034028.34750008","117.44236851749876"
"6021","9516","9512","5","9517","41525","2087.791875","0.027141294374999996","9036116.13937508","117.46950981187376"
"6022","9517","9511","1","9512","41526","2086.695","0.027127035","9038202.83437508","117.49663684687377"
"6023","9512","9503","1","9504","41527","2084.9399999999996","0.027104219999999995","9040287.77437508","117.52374106687377"
"6024","9504","9496","7","9503","41534","2084.720625","0.027101368124999997","9042372.49500008","117.55084243499877"
"6025","9503","9496","2","9498","41536","2083.6237499999997","0.027087108749999995","9044456.118750079","117.57792954374877"
"6026","9498","9497","9","9506","41545","2085.37875","0.027109923749999997","9046541.497500079","117.60503946749877"
"6027","9506","9501","1","9502","41546","2084.5012500000003","0.027098516250000003","9048625.99875008","117.63213798374878"
"6028","9502","9500","8","9508","41554","2085.8175","0.0271156275","9050711.81625008","117.65925361124877"
"6029","9508","9503","5","9508","41559","2085.8175","0.0271156275","9052797.633750081","117.68636923874877"
"6030","9508","9505","4","9509","41563","2086.036875","0.027118479374999997","9054883.670625081","117.71348771812377"
"6031","9509","9506","9","9515","41572","2087.353125","0.027135590625","9056971.023750082","117.74062330874877"
"6032","9515","9510","8","9518","41580","2088.01125","0.027144146249999997","9059059.035000082","117.76776745499876"
"6033","9518","9515","2","9517","41582","2087.791875","0.027141294374999996","9061146.826875081","117.79490874937376"
"6034","9517","9512","1","9513","41583","2086.914375","0.027129886874999995","9063233.741250081","117.82203863624876"
"6035","9513","9507","1","9508","41584","2085.8175","0.0271156275","9065319.558750082","117.84915426374876"
"6036","9508","9505","2","9507","41586","2085.598125","0.027112775625","9067405.156875081","117.87626703937376"
"6037","9507","9502","3","9505","41589","2085.159375","0.027107071875","9069490.316250082","117.90337411124875"
"6038","9505","9501","5","9506","41594","2085.37875","0.027109923749999997","9071575.695000082","117.93048403499876"
"6039","9506","9499","8","9507","41602","2085.598125","0.027112775625","9073661.293125082","117.95759681062376"
"6040","9507","9506","7","9513","41609","2086.914375","0.027129886874999995","9075748.207500082","117.98472669749876"
"6041","9513","9504","1","9505","41610","2085.159375","0.027107071875","9077833.366875082","118.01183376937375"
"6042","9505","9504","1","9505","41611","2085.159375","0.027107071875","9079918.526250083","118.03894084124875"
"6043","9505","9498","6","9504","41617","2084.9399999999996","0.027104219999999995","9082003.466250082","118.06604506124874"
"6044","9504","9499","3","9502","41620","2084.5012500000003","0.027098516250000003","9084087.967500083","118.09314357749875"
"6045","9502","9496","4","9500","41624","2084.0625","0.027092812499999997","9086172.030000083","118.12023638999875"
"6046","9500","9491","3","9494","41627","2082.7462499999997","0.027075701249999994","9088254.776250083","118.14731209124875"
"6047","9494","9486","3","9489","41630","2081.649375","0.027061441874999998","9090336.425625082","118.17437353312376"
"6048","9489","9482","4","9486","41634","2080.99125","0.027052886249999998","9092417.416875083","118.20142641937376"
"6049","9486","9482","7","9489","41641","2081.649375","0.027061441874999998","9094499.066250082","118.22848786124877"
"6050","9489","9487","2","9489","41643","2081.649375","0.027061441874999998","9096580.715625081","118.25554930312377"
"6051","9489","9480","8","9488","41651","2081.43","0.027058589999999997","9098662.14562508","118.28260789312377"
"6052","9488","9482","4","9486","41655","2080.99125","0.027052886249999998","9100743.136875082","118.30966077937377"
"6053","9486","9479","1","9480","41656","2079.675","0.027035775","9102822.811875083","118.33669655437377"
"6054","9480","9476","2","9478","41658","2079.23625","0.027030071249999996","9104902.048125083","118.36372662562377"
"6055","9478","9477","9","9486","41667","2080.99125","0.027052886249999998","9106983.039375084","118.39077951187377"
"6056","9486","9479","4","9483","41671","2080.333125","0.027044330624999998","9109063.372500084","118.41782384249878"
"6057","9483","9481","6","9487","41677","2081.210625","0.027055738125","9111144.583125085","118.44487958062378"
"6058","9487","9479","9","9488","41686","2081.43","0.027058589999999997","9113226.013125084","118.47193817062377"
"6059","9488","9481","9","9490","41695","2081.86875","0.02706429375","9115307.881875085","118.49900246437377"
"6060","9490","9482","7","9489","41702","2081.649375","0.027061441874999998","9117389.531250084","118.52606390624878"
"6061","9489","9486","214","9700","41916","2127.9375","0.0276631875","9119517.468750084","118.55372709374878"
"6062","9700","9693","9","9702","41925","2128.3762500000003","0.02766889125","9121645.845000084","118.58139598499878"
"6063","9702","9700","2","9702","41927","2128.3762500000003","0.02766889125","9123774.221250085","118.60906487624878"
"6064","9702","9699","4","9703","41931","2128.595625","0.027671743125","9125902.816875085","118.63673661937378"
"6065","9703","9702","6","9708","41937","2129.6925","0.0276860025","9128032.509375086","118.66442262187378"
"6066","9708","9706","2","9708","41939","2129.6925","0.0276860025","9130162.201875087","118.69210862437379"
"6067","9708","9702","1","9703","41940","2128.595625","0.027671743125","9132290.797500087","118.71978036749879"
"6068","9703","9699","8","9707","41948","2129.473125","0.027683150625","9134420.270625087","118.74746351812378"
"6069","9707","9705","8","9713","41956","2130.789375","0.027700261874999996","9136551.060000086","118.77516377999878"
"6070","9713","9704","1","9705","41957","2129.034375","0.027677446875","9138680.094375087","118.80284122687378"
"6071","9705","9701","7","9708","41964","2129.6925","0.0276860025","9140809.786875088","118.83052722937379"
"6072","9708","9706","4","9710","41968","2130.13125","0.027691706249999996","9142939.918125087","118.85821893562378"
"6073","9710","9706","6","9712","41974","2130.57","0.02769741","9145070.488125088","118.88591634562378"
"6074","9712","9705","5","9710","41979","2130.13125","0.027691706249999996","9147200.619375087","118.91360805187378"
"6075","9710","9704","7","9711","41986","2130.350625","0.027694558124999998","9149330.970000088","118.94130260999879"
"6076","9711","9706","4","9710","41990","2130.13125","0.027691706249999996","9151461.101250088","118.96899431624878"
"6077","9710","9703","1","9704","41991","2128.8149999999996","0.027674594999999993","9153589.916250087","118.99666891124878"
"6078","9704","9701","9","9710","42000","2130.13125","0.027691706249999996","9155720.047500087","119.02436061749877"
"6079","9710","9703","5","9708","42005","2129.6925","0.0276860025","9157849.740000088","119.05204661999878"
"6080","9708","9703","6","9709","42011","2129.911875","0.027688854374999995","9159979.651875088","119.07973547437378"
"6081","9709","9705","7","9712","42018","2130.57","0.02769741","9162110.221875088","119.10743288437378"
"6082","9712","9706","6","9712","42024","2130.57","0.02769741","9164240.791875089","119.13513029437378"
"6083","9712","9705","9","9714","42033","2131.00875","0.027703113749999998","9166371.800625088","119.16283340812377"
"6084","9714","9707","9","9716","42042","2131.4474999999998","0.027708817499999996","9168503.248125087","119.19054222562377"
"6085","9716","9710","6","9716","42048","2131.4474999999998","0.027708817499999996","9170634.695625087","119.21825104312377"
"6086","9716","9709","8","9717","42056","2131.666875","0.027711669374999998","9172766.362500086","119.24596271249877"
"6087","9717","9713","9","9722","42065","2132.76375","0.02772592875","9174899.126250086","119.27368864124877"
"6088","9722","9716","9","9725","42074","2133.421875","0.027734484375","9177032.548125086","119.30142312562377"
"6089","9725","9718","6","9724","42080","2133.2025","0.027731632499999995","9179165.750625087","119.32915475812376"
"6090","9724","9721","9","9730","42089","2134.51875","0.02774874375","9181300.269375088","119.35690350187376"
"6091","9730","9729","1","9730","42090","2134.51875","0.02774874375","9183434.788125088","119.38465224562376"
"6092","9730","9722","6","9728","42096","2134.08","0.027743039999999997","9185568.868125089","119.41239528562376"
"6093","9728","9721","7","9728","42103","2134.08","0.027743039999999997","9187702.948125089","119.44013832562376"
"6094","9728","9726","9","9735","42112","2135.615625","0.027763003124999998","9189838.563750088","119.46790132874877"
"6095","9735","9732","6","9738","42118","2136.27375","0.027771558749999998","9191974.837500088","119.49567288749877"
"6096","9738","9735","6","9741","42124","2136.9318749999998","0.027780114374999994","9194111.769375088","119.52345300187378"
"6097","9741","9734","3","9737","42127","2136.054375","0.027768706875","9196247.823750088","119.55122170874877"
"6098","9737","9731","4","9735","42131","2135.615625","0.027763003124999998","9198383.439375088","119.57898471187377"
"6099","9735","9733","3","9736","42134","2135.835","0.027765855","9200519.274375089","119.60675056687377"
"6100","9736","9730","4","9734","42138","2135.39625","0.027760151249999997","9202654.670625089","119.63451071812378"
"6101","9734","9733","5","9738","42143","2136.27375","0.027771558749999998","9204790.944375088","119.66228227687378"
"6102","9738","9737","2","9739","42145","2136.493125","0.027774410625","9206927.437500088","119.69005668749878"
"6103","9739","9734","1","9735","42146","2135.615625","0.027763003124999998","9209063.053125087","119.71781969062378"
"6104","9735","9728","5","9733","42151","2135.176875","0.027757299375","9211198.230000088","119.74557698999878"
"6105","9733","9730","2","9732","42153","2134.9575","0.027754447499999998","9213333.187500088","119.77333143749878"
"6106","9732","9723","1","9724","42154","2133.2025","0.027731632499999995","9215466.390000088","119.80106306999878"
"6107","9724","9721","6","9727","42160","2133.8606250000003","0.027740188125000002","9217600.250625089","119.82880325812377"
"6108","9727","9722","7","9729","42167","2134.2993749999996","0.027745891874999994","9219734.550000088","119.85654914999877"
"6109","9729","9721","5","9726","42172","2133.64125","0.02773733625","9221868.191250088","119.88428648624877"
"6110","9726","9724","6","9730","42178","2134.51875","0.02774874375","9224002.710000088","119.91203522999876"
"6111","9730","9727","3","9730","42181","2134.51875","0.02774874375","9226137.22875009","119.93978397374876"
"6112","9730","9726","7","9733","42188","2135.176875","0.027757299375","9228272.40562509","119.96754127312376"
"6113","9733","9730","3","9733","42191","2135.176875","0.027757299375","9230407.58250009","119.99529857249875"
"6114","9733","9725","9","9734","42200","2135.39625","0.027760151249999997","9232542.978750091","120.02305872374876"
"6115","9734","9731","8","9739","42208","2136.493125","0.027774410625","9234679.47187509","120.05083313437376"
"6116","9739","9735","9","9744","42217","2137.5899999999997","0.027788669999999994","9236817.06187509","120.07862180437377"
"6117","9744","9741","6","9747","42223","2138.248125","0.027797225624999998","9238955.31000009","120.10641902999876"
"6118","9747","9745","1","9746","42224","2138.02875","0.027794373749999997","9241093.33875009","120.13421340374876"
"6119","9746","9742","1","9743","42225","2137.370625","0.027785818125","9243230.70937509","120.16199922187376"
"6120","9743","9742","9","9751","42234","2139.125625","0.027808633125","9245369.83500009","120.18980785499876"
"6121","9751","9747","458","10205","42692","2238.721875","0.029103384375","9247608.556875091","120.21891123937377"
"6122","10205","10203","4","10207","42696","2239.160625","0.029109088124999998","9249847.71750009","120.24802032749876"
"6123","10207","10198","2","10200","42698","2237.625","0.029089124999999997","9252085.34250009","120.27710945249876"
"6124","10200","10193","5","10198","42703","2237.1862499999997","0.029083421249999995","9254322.52875009","120.30619287374876"
"6125","10198","10195","7","10202","42710","2238.0637500000003","0.029094828750000003","9256560.59250009","120.33528770249876"
"6126","10202","10193","2","10195","42712","2236.528125","0.029074865624999995","9258797.12062509","120.36436256812377"
"6127","10195","10193","2","10195","42714","2236.528125","0.029074865624999995","9261033.64875009","120.39343743374877"
"6128","10195","10192","1","10193","42715","2236.089375","0.029069161875","9263269.73812509","120.42250659562377"
"6129","10193","10191","1","10192","42716","2235.87","0.029066309999999998","9265505.608125089","120.45157290562378"
"6130","10192","10191","3","10194","42719","2236.3087499999997","0.029072013749999993","9267741.916875089","120.48064491937377"
"6131","10194","10189","5","10194","42724","2236.3087499999997","0.029072013749999993","9269978.225625088","120.50971693312377"
"6132","10194","10186","7","10193","42731","2236.089375","0.029069161875","9272214.315000089","120.53878609499877"
"6133","10193","10184","8","10192","42739","2235.87","0.029066309999999998","9274450.185000088","120.56785240499877"
"6134","10192","10190","7","10197","42746","2236.966875","0.029080569375","9276687.151875088","120.59693297437377"
"6135","10197","10191","8","10199","42754","2237.405625","0.029086273124999996","9278924.557500089","120.62601924749877"
"6136","10199","10190","5","10195","42759","2236.528125","0.029074865624999995","9281161.085625088","120.65509411312378"
"6137","10195","10190","4","10194","42763","2236.3087499999997","0.029072013749999993","9283397.394375088","120.68416612687378"
"6138","10194","10190","7","10197","42770","2236.966875","0.029080569375","9285634.361250088","120.71324669624877"
"6139","10197","10189","5","10194","42775","2236.3087499999997","0.029072013749999993","9287870.670000087","120.74231870999877"
"6140","10194","10192","2","10194","42777","2236.3087499999997","0.029072013749999993","9290106.978750087","120.77139072374877"
"6141","10194","10189","4","10193","42781","2236.089375","0.029069161875","9292343.068125088","120.80045988562377"
"6142","10193","10185","7","10192","42788","2235.87","0.029066309999999998","9294578.938125087","120.82952619562377"
"6143","10192","10189","1","10190","42789","2235.43125","0.02906060625","9296814.369375087","120.85858680187377"
"6144","10190","10181","4","10185","42793","2234.334375","0.029046346874999997","9299048.703750087","120.88763314874878"
"6145","10185","10178","8","10186","42801","2234.55375","0.029049198749999998","9301283.257500088","120.91668234749878"
"6146","10186","10185","4","10189","42805","2235.211875","0.029057754374999998","9303518.469375087","120.94574010187378"
"6147","10189","10180","8","10188","42813","2234.9925","0.029054902499999997","9305753.461875087","120.97479500437377"
"6148","10188","10183","9","10192","42822","2235.87","0.029066309999999998","9307989.331875086","121.00386131437378"
"6149","10192","10191","3","10194","42825","2236.3087499999997","0.029072013749999993","9310225.640625086","121.03293332812378"
"6150","10194","10185","8","10193","42833","2236.089375","0.029069161875","9312461.730000086","121.06200248999878"
"6151","10193","10187","6","10193","42839","2236.089375","0.029069161875","9314697.819375087","121.09107165187378"
"6152","10193","10192","7","10199","42846","2237.405625","0.029086273124999996","9316935.225000087","121.12015792499878"
"6153","10199","10195","6","10201","42852","2237.844375","0.029091976875","9319173.069375087","121.14924990187377"
"6154","10201","10192","2","10194","42854","2236.3087499999997","0.029072013749999993","9321409.378125086","121.17832191562377"
"6155","10194","10193","1","10194","42855","2236.3087499999997","0.029072013749999993","9323645.686875086","121.20739392937377"
"6156","10194","10190","3","10193","42858","2236.089375","0.029069161875","9325881.776250087","121.23646309124877"
"6157","10193","10186","6","10192","42864","2235.87","0.029066309999999998","9328117.646250086","121.26552940124877"
"6158","10192","10183","9","10192","42873","2235.87","0.029066309999999998","9330353.516250085","121.29459571124877"
"6159","10192","10188","6","10194","42879","2236.3087499999997","0.029072013749999993","9332589.825000085","121.32366772499877"
"6160","10194","10191","7","10198","42886","2237.1862499999997","0.029083421249999995","9334827.011250084","121.35275114624876"
"6161","10198","10193","1","10194","42887","2236.3087499999997","0.029072013749999993","9337063.320000084","121.38182315999876"
"6162","10194","10191","4","10195","42891","2236.528125","0.029074865624999995","9339299.848125083","121.41089802562377"
"6163","10195","10194","5","10199","42896","2237.405625","0.029086273124999996","9341537.253750084","121.43998429874877"
"6164","10199","10193","8","10201","42904","2237.844375","0.029091976875","9343775.098125083","121.46907627562376"
"6165","10201","10200","4","10204","42908","2238.5024999999996","0.029100532499999995","9346013.600625083","121.49817680812376"
"6166","10204","10198","5","10203","42913","2238.283125","0.029097680624999997","9348251.883750083","121.52727448874876"
"6167","10203","10195","5","10200","42918","2237.625","0.029089124999999997","9350489.508750083","121.55636361374876"
"6168","10200","10199","5","10204","42923","2238.5024999999996","0.029100532499999995","9352728.011250082","121.58546414624875"
"6169","10204","10199","3","10202","42926","2238.0637500000003","0.029094828750000003","9354966.075000083","121.61455897499876"
"6170","10202","10200","2","10202","42928","2238.0637500000003","0.029094828750000003","9357204.138750084","121.64365380374876"
"6171","10202","10199","8","10207","42936","2239.160625","0.029109088124999998","9359443.299375083","121.67276289187376"
"6172","10207","10200","6","10206","42942","2238.94125","0.029106236249999997","9361682.240625083","121.70186912812376"
"6173","10206","10198","7","10205","42949","2238.721875","0.029103384375","9363920.962500084","121.73097251249877"
"6174","10205","10204","7","10211","42956","2240.038125","0.029120495625","9366161.000625085","121.76009300812376"
"6175","10211","10205","1","10206","42957","2238.94125","0.029106236249999997","9368399.941875085","121.78919924437376"
"6176","10206","10198","6","10204","42963","2238.5024999999996","0.029100532499999995","9370638.444375085","121.81829977687376"
"6177","10204","10203","7","10210","42970","2239.81875","0.029117643749999998","9372878.263125084","121.84741742062376"
"6178","10210","10206","3","10209","42973","2239.599375","0.029114791874999997","9375117.862500085","121.87653221249876"
"6179","10209","10206","5","10211","42978","2240.038125","0.029120495625","9377357.900625085","121.90565270812375"
"6180","10211","10207","1","10208","42979","2239.38","0.02911194","9379597.280625086","121.93476464812376"
"6181","10208","10207","190","10397","43169","2280.841875","0.029650944375","9381878.122500086","121.96441559249877"
"6182","10397","10395","9","10404","43178","2282.3774999999996","0.029670907499999993","9384160.500000086","121.99408649999877"
"6183","10404","10399","2","10401","43180","2281.719375","0.029662351875","9386442.219375085","122.02374885187378"
"6184","10401","10392","1","10393","43181","2279.964375","0.029639536874999997","9388722.183750086","122.05338838874877"
"6185","10393","10387","2","10389","43183","2279.086875","0.029628129375","9391001.270625085","122.08301651812377"
"6186","10389","10385","4","10389","43187","2279.086875","0.029628129375","9393280.357500084","122.11264464749877"
"6187","10389","10385","3","10388","43190","2278.8675","0.029625277499999995","9395559.225000083","122.14226992499877"
"6188","10388","10381","2","10383","43192","2277.770625","0.029611018125","9397836.995625084","122.17188094312377"
"6189","10383","10375","4","10379","43196","2276.8931249999996","0.029599610624999995","9400113.888750084","122.20148055374877"
"6190","10379","10377","6","10383","43202","2277.770625","0.029611018125","9402391.659375085","122.23109157187376"
"6191","10383","10379","2","10381","43204","2277.331875","0.029605314374999997","9404668.991250085","122.26069688624877"
"6192","10381","10372","9","10381","43213","2277.331875","0.029605314374999997","9406946.323125085","122.29030220062377"
"6193","10381","10375","5","10380","43218","2277.1125","0.0296024625","9409223.435625086","122.31990466312376"
"6194","10380","10374","3","10377","43221","2276.4543750000003","0.029593906875000003","9411499.890000086","122.34949856999876"
"6195","10377","10370","5","10375","43226","2276.015625","0.029588203124999997","9413775.905625086","122.37908677312376"
"6196","10375","10374","7","10381","43233","2277.331875","0.029605314374999997","9416053.237500086","122.40869208749876"
"6197","10381","10373","9","10382","43242","2277.55125","0.029608166249999998","9418330.788750086","122.43830025374876"
"6198","10382","10376","6","10382","43248","2277.55125","0.029608166249999998","9420608.340000086","122.46790841999876"
"6199","10382","10373","2","10375","43250","2276.015625","0.029588203124999997","9422884.355625086","122.49749662312377"
"6200","10375","10374","6","10380","43256","2277.1125","0.0296024625","9425161.468125086","122.52709908562376"
"6201","10380","10373","1","10374","43257","2275.79625","0.029585351249999996","9427437.264375087","122.55668443687377"
"6202","10374","10368","7","10375","43264","2276.015625","0.029588203124999997","9429713.280000087","122.58627263999877"
"6203","10375","10373","1","10374","43265","2275.79625","0.029585351249999996","9431989.076250087","122.61585799124877"
"6204","10374","10372","2","10374","43267","2275.79625","0.029585351249999996","9434264.872500088","122.64544334249878"
"6205","10374","10368","4","10372","43271","2275.3575","0.0295796475","9436540.230000088","122.67502298999878"
"6206","10372","10364","3","10367","43274","2274.260625","0.029565388124999998","9438814.490625087","122.70458837812377"
"6207","10367","10359","1","10360","43275","2272.725","0.029545424999999997","9441087.215625087","122.73413380312377"
"6208","10360","10356","8","10364","43283","2273.6025","0.029556832499999998","9443360.818125086","122.76369063562377"
"6209","10364","10363","5","10368","43288","2274.48","0.02956824","9445635.298125086","122.79325887562378"
"6210","10368","10361","8","10369","43296","2274.6993749999997","0.029571091874999993","9447909.997500086","122.82282996749878"
"6211","10369","10362","6","10368","43302","2274.48","0.02956824","9450184.477500087","122.85239820749878"
"6212","10368","10359","7","10366","43309","2274.0412499999998","0.029562536249999997","9452458.518750086","122.88196074374878"
"6213","10366","10363","8","10371","43317","2275.138125","0.029576795625","9454733.656875087","122.91153753937378"
"6214","10371","10365","7","10372","43324","2275.3575","0.0295796475","9457009.014375087","122.94111718687378"
"6215","10372","10367","1","10368","43325","2274.48","0.02956824","9459283.494375087","122.97068542687379"
"6216","10368","10362","5","10367","43330","2274.260625","0.029565388124999998","9461557.755000087","123.00025081499878"
"6217","10367","10363","2","10365","43332","2273.821875","0.029559684375","9463831.576875087","123.02981049937378"
"6218","10365","10359","9","10368","43341","2274.48","0.02956824","9466106.056875087","123.05937873937378"
"6219","10368","10361","9","10370","43350","2274.91875","0.029573943749999995","9468380.975625087","123.08895268312378"
"6220","10370","10369","3","10372","43353","2275.3575","0.0295796475","9470656.333125087","123.11853233062378"
"6221","10372","10366","2","10368","43355","2274.48","0.02956824","9472930.813125087","123.14810057062378"
"6222","10368","10364","2","10366","43357","2274.0412499999998","0.029562536249999997","9475204.854375087","123.17766310687378"
"6223","10366","10360","6","10366","43363","2274.0412499999998","0.029562536249999997","9477478.895625087","123.20722564312378"
"6224","10366","10365","5","10370","43368","2274.91875","0.029573943749999995","9479753.814375086","123.23679958687377"
"6225","10370","10362","5","10367","43373","2274.260625","0.029565388124999998","9482028.075000085","123.26636497499877"
"6226","10367","10364","3","10367","43376","2274.260625","0.029565388124999998","9484302.335625084","123.29593036312376"
"6227","10367","10366","3","10369","43379","2274.6993749999997","0.029571091874999993","9486577.035000084","123.32550145499876"
"6228","10369","10363","7","10370","43386","2274.91875","0.029573943749999995","9488851.953750083","123.35507539874875"
"6229","10370","10365","6","10371","43392","2275.138125","0.029576795625","9491127.091875084","123.38465219437376"
"6230","10371","10367","7","10374","43399","2275.79625","0.029585351249999996","9493402.888125084","123.41423754562376"
"6231","10374","10369","6","10375","43405","2276.015625","0.029588203124999997","9495678.903750084","123.44382574874876"
"6232","10375","10367","6","10373","43411","2275.5768749999997","0.029582499374999995","9497954.480625084","123.47340824812376"
"6233","10373","10372","1","10373","43412","2275.5768749999997","0.029582499374999995","9500230.057500083","123.50299074749876"
"6234","10373","10372","6","10378","43418","2276.67375","0.029596758749999997","9502506.731250083","123.53258750624876"
"6235","10378","10376","4","10380","43422","2277.1125","0.0296024625","9504783.843750084","123.56218996874875"
"6236","10380","10372","5","10377","43427","2276.4543750000003","0.029593906875000003","9507060.298125084","123.59178387562375"
"6237","10377","10374","7","10381","43434","2277.331875","0.029605314374999997","9509337.630000085","123.62138918999875"
"6238","10381","10378","3","10381","43437","2277.331875","0.029605314374999997","9511614.961875085","123.65099450437376"
"6239","10381","10378","4","10382","43441","2277.55125","0.029608166249999998","9513892.513125084","123.68060267062376"
"6240","10382","10373","7","10380","43448","2277.1125","0.0296024625","9516169.625625085","123.71020513312375"
"6241","10380","10379","455","10834","43903","2376.70875","0.030897213749999996","9518546.334375085","123.74110234687375"
"6242","10834","10831","7","10838","43910","2377.58625","0.030908621249999997","9520923.920625085","123.77201096812375"
"6243","10838","10833","5","10838","43915","2377.58625","0.030908621249999997","9523301.506875085","123.80291958937376"
"6244","10838","10835","8","10843","43923","2378.683125","0.030922880625","9525680.190000085","123.83384246999876"
"6245","10843","10835","8","10843","43931","2378.683125","0.030922880625","9528058.873125086","123.86476535062376"
"6246","10843","10842","5","10847","43936","2379.560625","0.030934288125","9530438.433750086","123.89569963874875"
"6247","10847","10843","8","10851","43944","2380.438125","0.030945695625","9532818.871875085","123.92664533437375"
"6248","10851","10850","7","10857","43951","2381.754375","0.030962806875","9535200.626250084","123.95760814124874"
"6249","10857","10852","3","10855","43954","2381.315625","0.030957103125","9537581.941875085","123.98856524437375"
"6250","10855","10852","8","10860","43962","2382.4125","0.0309713625","9539964.354375085","124.01953660687374"
"6251","10860","10855","3","10858","43965","2381.97375","0.03096565875","9542346.328125086","124.05050226562375"
"6252","10858","10852","7","10859","43972","2382.193125","0.030968510624999994","9544728.521250086","124.08147077624875"
"6253","10859","10856","6","10862","43978","2382.85125","0.03097706625","9547111.372500086","124.11244784249875"
"6254","10862","10859","5","10864","43983","2383.29","0.030982769999999996","9549494.662500085","124.14343061249875"
"6255","10864","10860","3","10863","43986","2383.070625","0.030979918124999995","9551877.733125085","124.17441053062375"
"6256","10863","10854","9","10863","43995","2383.070625","0.030979918124999995","9554260.803750085","124.20539044874874"
"6257","10863","10856","2","10858","43997","2381.97375","0.03096565875","9556642.777500086","124.23635610749875"
"6258","10858","10857","1","10858","43998","2381.97375","0.03096565875","9559024.751250086","124.26732176624876"
"6259","10858","10853","1","10854","43999","2381.0962499999996","0.03095425124999999","9561405.847500086","124.29827601749875"
"6260","10854","10850","1","10851","44000","2380.438125","0.030945695625","9563786.285625085","124.32922171312374"
"6261","10851","10848","8","10856","44008","2381.535","0.030959954999999997","9566167.820625085","124.36018166812374"
"6262","10856","10847","8","10855","44016","2381.315625","0.030957103125","9568549.136250086","124.39113877124875"
"6263","10855","10851","3","10854","44019","2381.0962499999996","0.03095425124999999","9570930.232500086","124.42209302249874"
"6264","10854","10847","2","10849","44021","2379.999375","0.030939991874999996","9573310.231875086","124.45303301437374"
"6265","10849","10847","4","10851","44025","2380.438125","0.030945695625","9575690.670000086","124.48397870999874"
"6266","10851","10847","8","10855","44033","2381.315625","0.030957103125","9578071.985625086","124.51493581312374"
"6267","10855","10848","8","10856","44041","2381.535","0.030959954999999997","9580453.520625087","124.54589576812374"
"6268","10856","10854","6","10860","44047","2382.4125","0.0309713625","9582835.933125086","124.57686713062374"
"6269","10860","10859","2","10861","44049","2382.631875","0.030974214375","9585218.565000087","124.60784134499873"
"6270","10861","10855","2","10857","44051","2381.754375","0.030962806875","9587600.319375087","124.63880415187373"
"6271","10857","10849","6","10855","44057","2381.315625","0.030957103125","9589981.635000087","124.66976125499873"
"6272","10855","10849","4","10853","44061","2380.876875","0.030951399374999997","9592362.511875087","124.70071265437373"
"6273","10853","10846","6","10852","44067","2380.6575000000003","0.030948547500000003","9594743.169375088","124.73166120187373"
"6274","10852","10848","9","10857","44076","2381.754375","0.030962806875","9597124.923750088","124.76262400874873"
"6275","10857","10856","5","10861","44081","2382.631875","0.030974214375","9599507.555625089","124.79359822312372"
"6276","10861","10857","6","10863","44087","2383.070625","0.030979918124999995","9601890.626250088","124.82457814124872"
"6277","10863","10858","6","10864","44093","2383.29","0.030982769999999996","9604273.916250087","124.85556091124872"
"6278","10864","10862","6","10868","44099","2384.1675","0.030994177499999997","9606658.083750088","124.88655508874872"
"6279","10868","10866","4","10870","44103","2384.60625","0.030999881249999996","9609042.690000087","124.91755496999872"
"6280","10870","10861","7","10868","44110","2384.1675","0.030994177499999997","9611426.857500087","124.94854914749872"
"6281","10868","10864","6","10870","44116","2384.60625","0.030999881249999996","9613811.463750087","124.97954902874872"
"6282","10870","10866","1","10867","44117","2383.948125","0.030991325624999996","9616195.411875086","125.01054035437372"
"6283","10867","10866","4","10870","44121","2384.60625","0.030999881249999996","9618580.018125085","125.04154023562371"
"6284","10870","10868","8","10876","44129","2385.9225","0.0310169925","9620965.940625085","125.07255722812371"
"6285","10876","10870","1","10871","44130","2384.825625","0.031002733124999998","9623350.766250085","125.10355996124872"
"6286","10871","10869","5","10874","44135","2385.48375","0.031011288749999998","9625736.250000086","125.13457124999871"
"6287","10874","10867","1","10868","44136","2384.1675","0.030994177499999997","9628120.417500086","125.16556542749872"
"6288","10868","10864","4","10868","44140","2384.1675","0.030994177499999997","9630504.585000087","125.19655960499873"
"6289","10868","10866","7","10873","44147","2385.2643749999997","0.031008436874999996","9632889.849375086","125.22756804187372"
"6290","10873","10869","5","10874","44152","2385.48375","0.031011288749999998","9635275.333125087","125.25857933062372"
"6291","10874","10868","1","10869","44153","2384.3868749999997","0.030997029374999995","9637659.720000086","125.28957635999872"
"6292","10869","10865","5","10870","44158","2384.60625","0.030999881249999996","9640044.326250086","125.32057624124872"
"6293","10870","10865","2","10867","44160","2383.948125","0.030991325624999996","9642428.274375085","125.35156756687371"
"6294","10867","10866","9","10875","44169","2385.703125","0.031014140625","9644813.977500085","125.38258170749872"
"6295","10875","10870","5","10875","44174","2385.703125","0.031014140625","9647199.680625085","125.41359584812372"
"6296","10875","10870","2","10872","44176","2385.045","0.031005585","9649584.725625085","125.44460143312372"
"6297","10872","10868","2","10870","44178","2384.60625","0.030999881249999996","9651969.331875084","125.47560131437372"
"6298","10870","10863","9","10872","44187","2385.045","0.031005585","9654354.376875084","125.50660689937372"
"6299","10872","10865","2","10867","44189","2383.948125","0.030991325624999996","9656738.325000083","125.53759822499872"
"6300","10867","10866","5","10871","44194","2384.825625","0.031002733124999998","9659123.150625084","125.56860095812372"
"6301","10871","10868","124","10992","44318","2411.37","0.03134781","9661534.520625083","125.59994876812372"
"6302","10992","10984","1","10985","44319","2409.834375","0.031327846874999996","9663944.355000082","125.63127661499873"
"6303","10985","10978","5","10983","44324","2409.395625","0.031322143125","9666353.750625083","125.66259875812372"
"6304","10983","10982","1","10983","44325","2409.395625","0.031322143125","9668763.146250084","125.69392090124872"
"6305","10983","10976","9","10985","44334","2409.834375","0.031327846874999996","9671172.980625084","125.72524874812372"
"6306","10985","10981","3","10984","44337","2409.615","0.031324994999999994","9673582.595625084","125.75657374312372"
"6307","10984","10977","1","10978","44338","2408.29875","0.031307883749999994","9675990.894375084","125.78788162687373"
"6308","10978","10970","9","10979","44347","2408.5181249999996","0.031310735624999995","9678399.412500083","125.81919236249873"
"6309","10979","10978","5","10983","44352","2409.395625","0.031322143125","9680808.808125084","125.85051450562372"
"6310","10983","10979","5","10984","44357","2409.615","0.031324994999999994","9683218.423125084","125.88183950062373"
"6311","10984","10980","5","10985","44362","2409.834375","0.031327846874999996","9685628.257500084","125.91316734749873"
"6312","10985","10977","5","10982","44367","2409.17625","0.03131929125","9688037.433750084","125.94448663874873"
"6313","10982","10977","9","10986","44376","2410.05375","0.03133069875","9690447.487500085","125.97581733749873"
"6314","10986","10984","6","10990","44382","2410.93125","0.03134210625","9692858.418750085","126.00715944374872"
"6315","10990","10987","1","10988","44383","2410.4925","0.0313364025","9695268.911250085","126.03849584624872"
"6316","10988","10982","7","10989","44390","2410.711875","0.031339254375","9697679.623125084","126.06983510062372"
"6317","10989","10982","4","10986","44394","2410.05375","0.03133069875","9700089.676875085","126.10116579937372"
"6318","10986","10978","7","10985","44401","2409.834375","0.031327846874999996","9702499.511250084","126.13249364624872"
"6319","10985","10982","7","10989","44408","2410.711875","0.031339254375","9704910.223125083","126.16383290062372"
"6320","10989","10984","3","10987","44411","2410.273125","0.031333550625","9707320.496250084","126.19516645124872"
"6321","10987","10985","3","10988","44414","2410.4925","0.0313364025","9709730.988750083","126.22650285374873"
"6322","10988","10985","3","10988","44417","2410.4925","0.0313364025","9712141.481250083","126.25783925624873"
"6323","10988","10987","6","10993","44423","2411.589375","0.031350661875","9714553.070625084","126.28918991812372"
"6324","10993","10992","1","10993","44424","2411.589375","0.031350661875","9716964.660000084","126.32054057999872"
"6325","10993","10992","7","10999","44431","2412.905625","0.031367773125","9719377.565625085","126.35190835312372"
"6326","10999","10991","2","10993","44433","2411.589375","0.031350661875","9721789.155000085","126.38325901499871"
"6327","10993","10991","9","11000","44442","2413.125","0.031370625","9724202.280000085","126.41462963999871"
"6328","11000","10998","7","11005","44449","2414.221875","0.031384884375","9726616.501875086","126.44601452437371"
"6329","11005","10998","7","11005","44456","2414.221875","0.031384884375","9729030.723750087","126.47739940874871"
"6330","11005","11004","7","11011","44463","2415.538125","0.031401995625","9731446.261875087","126.50880140437371"
"6331","11011","11008","8","11016","44471","2416.635","0.031416255000000004","9733862.896875087","126.54021765937371"
"6332","11016","11010","2","11012","44473","2415.7575","0.0314048475","9736278.654375087","126.57162250687371"
"6333","11012","11011","4","11015","44477","2416.415625","0.031413403124999996","9738695.070000088","126.60303590999871"
"6334","11015","11007","3","11010","44480","2415.31875","0.03139914375","9741110.388750087","126.6344350537487"
"6335","11010","11003","8","11011","44488","2415.538125","0.031401995625","9743525.926875088","126.6658370493737"
"6336","11011","11003","9","11012","44497","2415.7575","0.0314048475","9745941.684375089","126.6972418968737"
"6337","11012","11005","7","11012","44504","2415.7575","0.0314048475","9748357.441875089","126.7286467443737"
"6338","11012","11011","5","11016","44509","2416.635","0.031416255000000004","9750774.076875089","126.7600629993737"
"6339","11016","11008","5","11013","44514","2415.976875","0.031407699374999994","9753190.053750088","126.7914706987487"
"6340","11013","11005","2","11007","44516","2414.660625","0.031390588125","9755604.714375088","126.8228612868737"
"6341","11007","11003","1","11004","44517","2414.0024999999996","0.03138203249999999","9758018.716875087","126.85424331937371"
"6342","11004","10996","2","10998","44519","2412.6862499999997","0.03136492125","9760431.403125087","126.88560824062371"
"6343","10998","10995","9","11004","44528","2414.0024999999996","0.03138203249999999","9762845.405625086","126.91699027312372"
"6344","11004","10996","8","11004","44536","2414.0024999999996","0.03138203249999999","9765259.408125086","126.94837230562372"
"6345","11004","11003","2","11005","44538","2414.221875","0.031384884375","9767673.630000087","126.97975718999872"
"6346","11005","10998","9","11007","44547","2414.660625","0.031390588125","9770088.290625086","127.01114777812373"
"6347","11007","10999","5","11004","44552","2414.0024999999996","0.03138203249999999","9772502.293125086","127.04252981062373"
"6348","11004","10996","5","11001","44557","2413.344375","0.031373476875","9774915.637500085","127.07390328749874"
"6349","11001","10993","4","10997","44561","2412.466875","0.031362069374999996","9777328.104375085","127.10526535687374"
"6350","10997","10993","7","11000","44568","2413.125","0.031370625","9779741.229375085","127.13663598187374"
"6351","11000","10991","9","11000","44577","2413.125","0.031370625","9782154.354375085","127.16800660687373"
"6352","11000","10994","3","10997","44580","2412.466875","0.031362069374999996","9784566.821250085","127.19936867624874"
"6353","10997","10993","3","10996","44583","2412.2475000000004","0.0313592175","9786979.068750085","127.23072789374874"
"6354","10996","10993","6","10999","44589","2412.905625","0.031367773125","9789391.974375086","127.26209566687373"
"6355","10999","10990","9","10999","44598","2412.905625","0.031367773125","9791804.880000087","127.29346343999873"
"6356","10999","10990","5","10995","44603","2412.028125","0.03135636562499999","9794216.908125086","127.32481980562373"
"6357","10995","10988","3","10991","44606","2411.150625","0.031344958125","9796628.058750086","127.35616476374874"
"6358","10991","10984","7","10991","44613","2411.150625","0.031344958125","9799039.209375085","127.38750972187374"
"6359","10991","10987","4","10991","44617","2411.150625","0.031344958125","9801450.360000085","127.41885467999874"
"6360","10991","10986","6","10992","44623","2411.37","0.03134781","9803861.730000084","127.45020248999874"
"6361","10992","10988","157","11145","44780","2444.934375","0.031784146874999995","9806306.664375084","127.48198663687374"
"6362","11145","11139","7","11146","44787","2445.1537500000004","0.03178699875","9808751.818125084","127.51377363562374"
"6363","11146","11142","3","11145","44790","2444.934375","0.031784146874999995","9811196.752500083","127.54555778249873"
"6364","11145","11138","1","11139","44791","2443.618125","0.031767035624999995","9813640.370625082","127.57732481812373"
"6365","11139","11133","6","11139","44797","2443.618125","0.031767035624999995","9816083.988750082","127.60909185374872"
"6366","11139","11130","6","11136","44803","2442.96","0.03175848","9818526.948750082","127.64085033374872"
"6367","11136","11134","6","11140","44809","2443.8375","0.031769887499999996","9820970.786250083","127.67262022124872"
"6368","11140","11131","8","11139","44817","2443.618125","0.031767035624999995","9823414.404375082","127.70438725687372"
"6369","11139","11132","2","11134","44819","2442.52125","0.031752776249999996","9825856.925625082","127.73614003312372"
"6370","11134","11130","4","11134","44823","2442.52125","0.031752776249999996","9828299.446875082","127.76789280937372"
"6371","11134","11125","7","11132","44830","2442.0825","0.0317470725","9830741.529375082","127.79963988187372"
"6372","11132","11128","9","11137","44839","2443.179375","0.031761331875","9833184.708750082","127.83140121374872"
"6373","11137","11128","9","11137","44848","2443.179375","0.031761331875","9835627.888125082","127.86316254562372"
"6374","11137","11132","5","11137","44853","2443.179375","0.031761331875","9838071.067500083","127.89492387749873"
"6375","11137","11130","7","11137","44860","2443.179375","0.031761331875","9840514.246875083","127.92668520937373"
"6376","11137","11129","8","11137","44868","2443.179375","0.031761331875","9842957.426250083","127.95844654124873"
"6377","11137","11136","6","11142","44874","2444.27625","0.03177559125","9845401.702500083","127.99022213249873"
"6378","11142","11136","2","11138","44876","2443.39875","0.031764183749999994","9847845.101250082","128.02198631624873"
"6379","11138","11132","6","11138","44882","2443.39875","0.031764183749999994","9850288.500000082","128.05375049999873"
"6380","11138","11131","5","11136","44887","2442.96","0.03175848","9852731.460000083","128.08550897999874"
"6381","11136","11129","3","11132","44890","2442.0825","0.0317470725","9855173.542500082","128.11725605249873"
"6382","11132","11130","6","11136","44896","2442.96","0.03175848","9857616.502500083","128.14901453249874"
"6383","11136","11131","8","11139","44904","2443.618125","0.031767035624999995","9860060.120625082","128.18078156812373"
"6384","11139","11136","3","11139","44907","2443.618125","0.031767035624999995","9862503.738750082","128.21254860374873"
"6385","11139","11137","9","11146","44916","2445.1537500000004","0.03178699875","9864948.892500082","128.24433560249872"
"6386","11146","11144","5","11149","44921","2445.811875","0.03179555437499999","9867394.704375083","128.27613115687373"
"6387","11149","11147","8","11155","44929","2447.128125","0.031812665625","9869841.832500083","128.30794382249874"
"6388","11155","11146","1","11147","44930","2445.373125","0.031789850625","9872287.205625083","128.33973367312373"
"6389","11147","11140","1","11141","44931","2444.056875","0.031772739375","9874731.262500083","128.37150641249872"
"6390","11141","11136","3","11139","44934","2443.618125","0.031767035624999995","9877174.880625082","128.4032734481237"
"6391","11139","11130","5","11135","44939","2442.740625","0.031755628125","9879617.621250082","128.43502907624872"
"6392","11135","11131","9","11140","44948","2443.8375","0.031769887499999996","9882061.458750082","128.46679896374872"
"6393","11140","11134","4","11138","44952","2443.39875","0.031764183749999994","9884504.857500082","128.49856314749871"
"6394","11138","11131","2","11133","44954","2442.301875","0.031749924375","9886947.159375083","128.5303130718737"
"6395","11133","11127","2","11129","44956","2441.4243749999996","0.03173851687499999","9889388.583750082","128.56205158874872"
"6396","11129","11125","5","11130","44961","2441.64375","0.03174136875","9891830.227500083","128.59379295749872"
"6397","11130","11124","5","11129","44966","2441.4243749999996","0.03173851687499999","9894271.651875082","128.62553147437373"
"6398","11129","11126","9","11135","44975","2442.740625","0.031755628125","9896714.392500082","128.65728710249874"
"6399","11135","11133","8","11141","44983","2444.056875","0.031772739375","9899158.449375082","128.68905984187373"
"6400","11141","11135","1","11136","44984","2442.96","0.03175848","9901601.409375083","128.72081832187374"
"6401","11136","11133","9","11142","44993","2444.27625","0.03177559125","9904045.685625082","128.75259391312375"
"6402","11142","11133","7","11140","45000","2443.8375","0.031769887499999996","9906489.523125082","128.78436380062374"
"6403","11140","11133","8","11141","45008","2444.056875","0.031772739375","9908933.580000082","128.81613653999872"
"6404","11141","11133","6","11139","45014","2443.618125","0.031767035624999995","9911377.198125081","128.84790357562372"
"6405","11139","11130","2","11132","45016","2442.0825","0.0317470725","9913819.28062508","128.87965064812371"
"6406","11132","11125","2","11127","45018","2440.9856250000003","0.031732813125","9916260.266250081","128.9113834612487"
"6407","11127","11126","9","11135","45027","2442.740625","0.031755628125","9918703.006875081","128.94313908937372"
"6408","11135","11127","9","11136","45036","2442.96","0.03175848","9921145.966875082","128.97489756937372"
"6409","11136","11128","4","11132","45040","2442.0825","0.0317470725","9923588.049375081","129.00664464187372"
"6410","11132","11125","8","11133","45048","2442.301875","0.031749924375","9926030.351250082","129.0383945662487"
"6411","11133","11125","7","11132","45055","2442.0825","0.0317470725","9928472.433750082","129.0701416387487"
"6412","11132","11123","3","11126","45058","2440.76625","0.03172996125","9930913.200000081","129.1018715999987"
"6413","11126","11117","6","11123","45064","2440.1081249999997","0.031721405625","9933353.30812508","129.1335930056237"
"6414","11123","11114","3","11117","45067","2438.791875","0.031704294375","9935792.10000008","129.1652972999987"
"6415","11117","11115","9","11124","45076","2440.3275","0.0317242575","9938232.42750008","129.19702155749872"
"6416","11124","11116","9","11125","45085","2440.546875","0.031727109375","9940672.97437508","129.2287486668737"
"6417","11125","11121","5","11126","45090","2440.76625","0.03172996125","9943113.74062508","129.2604786281237"
"6418","11126","11120","1","11121","45091","2439.6693750000004","0.031715701875","9945553.41000008","129.2921943299987"
"6419","11121","11118","7","11125","45098","2440.546875","0.031727109375","9947993.95687508","129.3239214393737"
"6420","11125","11123","9","11132","45107","2442.0825","0.0317470725","9950436.03937508","129.3556685118737"
"6421","11132","11129","301","11430","45408","2507.45625","0.03259693125","9952943.49562508","129.3882654431237"
"6422","11430","11421","5","11426","45413","2506.57875","0.03258552375","9955450.07437508","129.42085096687367"
"6423","11426","11418","4","11422","45417","2505.70125","0.03257411625","9957955.77562508","129.45342508312368"
"6424","11422","11418","2","11420","45419","2505.2625","0.0325684125","9960461.03812508","129.4859934956237"
"6425","11420","11416","7","11423","45426","2505.9206249999997","0.032576968124999994","9962966.958750078","129.5185704637487"
"6426","11423","11421","2","11423","45428","2505.9206249999997","0.032576968124999994","9965472.879375078","129.5511474318737"
"6427","11423","11417","7","11424","45435","2506.14","0.032579819999999995","9967979.019375078","129.58372725187368"
"6428","11424","11415","2","11417","45437","2504.604375","0.032559856874999994","9970483.623750078","129.61628710874868"
"6429","11417","11416","4","11420","45441","2505.2625","0.0325684125","9972988.886250077","129.6488555212487"
"6430","11420","11419","9","11428","45450","2507.0175","0.0325912275","9975495.903750077","129.6814467487487"
"6431","11428","11426","3","11429","45453","2507.2368749999996","0.032594079374999994","9978003.140625076","129.7140408281237"
"6432","11429","11428","1","11429","45454","2507.2368749999996","0.032594079374999994","9980510.377500076","129.7466349074987"
"6433","11429","11426","1","11427","45455","2506.7981250000003","0.032588375625","9983017.175625077","129.7792232831237"
"6434","11427","11421","7","11428","45462","2507.0175","0.0325912275","9985524.193125077","129.81181451062372"
"6435","11428","11426","3","11429","45465","2507.2368749999996","0.032594079374999994","9988031.430000076","129.84440858999872"
"6436","11429","11427","6","11433","45471","2508.114375","0.032605486875","9990539.544375077","129.87701407687373"
"6437","11433","11428","7","11435","45478","2508.553125","0.032611190624999994","9993048.097500077","129.90962526749874"
"6438","11435","11432","9","11441","45487","2509.869375","0.032628301875","9995557.966875076","129.94225356937375"
"6439","11441","11440","7","11447","45494","2511.185625","0.032645413125","9998069.152500076","129.97489898249876"
"6440","11447","11440","3","11443","45497","2510.308125","0.032634005625","1.0000579460625077E7","130.00753298812376"
"6441","11443","11438","8","11446","45505","2510.9662500000004","0.03264256125","1.0003090426875077E7","130.04017554937374"
"6442","11446","11444","6","11450","45511","2511.84375","0.03265396875","1.0005602270625077E7","130.07282951812374"
"6443","11450","11449","7","11456","45518","2513.1600000000003","0.032671080000000005","1.0008115430625077E7","130.10550059812374"
"6444","11456","11453","3","11456","45521","2513.1600000000003","0.032671080000000005","1.0010628590625077E7","130.13817167812374"
"6445","11456","11448","4","11452","45525","2512.2825000000003","0.0326596725","1.0013140873125078E7","130.17083135062373"
"6446","11452","11448","8","11456","45533","2513.1600000000003","0.032671080000000005","1.0015654033125078E7","130.20350243062373"
"6447","11456","11453","7","11460","45540","2514.0375","0.032682487499999996","1.0018168070625078E7","130.23618491812374"
"6448","11460","11459","6","11465","45546","2515.134375","0.032696746875","1.0020683205000078E7","130.26888166499873"
"6449","11465","11456","3","11459","45549","2513.818125","0.032679635624999995","1.0023197023125079E7","130.30156130062372"
"6450","11459","11453","7","11460","45556","2514.0375","0.032682487499999996","1.0025711060625078E7","130.33424378812373"
"6451","11460","11451","2","11453","45558","2512.501875","0.032662524374999995","1.0028223562500078E7","130.36690631249874"
"6452","11453","11446","8","11454","45566","2512.7212499999996","0.032665376249999996","1.0030736283750078E7","130.39957168874875"
"6453","11454","11447","8","11455","45574","2512.940625","0.032668228125","1.0033249224375078E7","130.43223991687375"
"6454","11455","11447","9","11456","45583","2513.1600000000003","0.032671080000000005","1.0035762384375079E7","130.46491099687375"
"6455","11456","11447","5","11452","45588","2512.2825000000003","0.0326596725","1.003827466687508E7","130.49757066937374"
"6456","11452","11451","7","11458","45595","2513.59875","0.03267678375","1.004078826562508E7","130.53024745312374"
"6457","11458","11455","4","11459","45599","2513.818125","0.032679635624999995","1.004330208375008E7","130.56292708874872"
"6458","11459","11453","2","11455","45601","2512.940625","0.032668228125","1.0045815024375081E7","130.59559531687373"
"6459","11455","11450","6","11456","45607","2513.1600000000003","0.032671080000000005","1.0048328184375081E7","130.62826639687373"
"6460","11456","11449","2","11451","45609","2512.063125","0.032656820625","1.005084024750008E7","130.66092321749872"
"6461","11451","11442","3","11445","45612","2510.746875","0.03263970937499999","1.005335099437508E7","130.6935629268737"
"6462","11445","11440","7","11447","45619","2511.185625","0.032645413125","1.005586218000008E7","130.72620833999872"
"6463","11447","11445","6","11451","45625","2512.063125","0.032656820625","1.005837424312508E7","130.7588651606237"
"6464","11451","11448","7","11455","45632","2512.940625","0.032668228125","1.006088718375008E7","130.79153338874872"
"6465","11455","11450","1","11451","45633","2512.063125","0.032656820625","1.006339924687508E7","130.8241902093737"
"6466","11451","11447","5","11452","45638","2512.2825000000003","0.0326596725","1.006591152937508E7","130.8568498818737"
"6467","11452","11446","9","11455","45647","2512.940625","0.032668228125","1.006842447000008E7","130.8895181099987"
"6468","11455","11447","6","11453","45653","2512.501875","0.032662524374999995","1.007093697187508E7","130.92218063437372"
"6469","11453","11451","8","11459","45661","2513.818125","0.032679635624999995","1.0073450790000081E7","130.9548602699987"
"6470","11459","11454","4","11458","45665","2513.59875","0.03267678375","1.0075964388750082E7","130.9875370537487"
"6471","11458","11450","9","11459","45674","2513.818125","0.032679635624999995","1.0078478206875082E7","131.02021668937368"
"6472","11459","11452","7","11459","45681","2513.818125","0.032679635624999995","1.0080992025000082E7","131.05289632499867"
"6473","11459","11458","5","11463","45686","2514.695625","0.03269104312499999","1.0083506720625082E7","131.08558736812367"
"6474","11463","11458","4","11462","45690","2514.47625","0.03268819125","1.0086021196875082E7","131.11827555937367"
"6475","11462","11461","5","11466","45695","2515.35375","0.03269959875","1.0088536550625082E7","131.15097515812369"
"6476","11466","11458","2","11460","45697","2514.0375","0.032682487499999996","1.0091050588125082E7","131.1836576456237"
"6477","11460","11453","9","11462","45706","2514.47625","0.03268819125","1.0093565064375082E7","131.2163458368737"
"6478","11462","11454","2","11456","45708","2513.1600000000003","0.032671080000000005","1.0096078224375082E7","131.2490169168737"
"6479","11456","11453","6","11459","45714","2513.818125","0.032679635624999995","1.0098592042500082E7","131.2816965524987"
"6480","11459","11458","3","11461","45717","2514.256875","0.032685339375","1.0101106299375083E7","131.3143818918737"
"6481","11461","11459","232","11691","45949","2564.713125","0.033341270625","1.0103671012500083E7","131.34772316249868"
"6482","11691","11684","5","11689","45954","2564.2743749999995","0.03333556687499999","1.0106235286875082E7","131.38105872937368"
"6483","11689","11684","5","11689","45959","2564.2743749999995","0.03333556687499999","1.0108799561250081E7","131.41439429624867"
"6484","11689","11684","5","11689","45964","2564.2743749999995","0.03333556687499999","1.011136383562508E7","131.44772986312367"
"6485","11689","11687","8","11695","45972","2565.590625","0.03335267812499999","1.011392942625008E7","131.48108254124867"
"6486","11695","11689","2","11691","45974","2564.713125","0.033341270625","1.011649413937508E7","131.51442381187366"
"6487","11691","11687","1","11688","45975","2564.055","0.033332715","1.011905819437508E7","131.54775652687366"
"6488","11688","11682","9","11691","45984","2564.713125","0.033341270625","1.0121622907500079E7","131.58109779749864"
"6489","11691","11690","8","11698","45992","2566.2487499999997","0.03336123375","1.0124189156250078E7","131.61445903124866"
"6490","11698","11691","4","11695","45996","2565.590625","0.03335267812499999","1.0126754746875077E7","131.64781170937366"
"6491","11695","11691","3","11694","45999","2565.3712499999997","0.03334982624999999","1.0129320118125077E7","131.68116153562366"
"6492","11694","11686","1","11687","46000","2563.835625","0.033329863125","1.0131883953750078E7","131.71449139874866"
"6493","11687","11678","6","11684","46006","2563.1775","0.033321307499999994","1.0134447131250078E7","131.74781270624865"
"6494","11684","11683","7","11690","46013","2564.49375","0.03333841875","1.0137011625000078E7","131.78115112499864"
"6495","11690","11681","1","11682","46014","2562.73875","0.03331560375","1.0139574363750078E7","131.81446672874864"
"6496","11682","11681","2","11683","46016","2562.9581249999997","0.03331845562499999","1.0142137321875079E7","131.84778518437363"
"6497","11683","11680","3","11683","46019","2562.9581249999997","0.03331845562499999","1.014470028000008E7","131.88110363999863"
"6498","11683","11679","8","11687","46027","2563.835625","0.033329863125","1.014726411562508E7","131.91443350312363"
"6499","11687","11682","3","11685","46030","2563.396875","0.033324159374999995","1.014982751250008E7","131.94775766249865"
"6500","11685","11683","3","11686","46033","2563.6162500000005","0.033327011250000003","1.015239112875008E7","131.98108467374865"
"6501","11686","11684","2","11686","46035","2563.6162500000005","0.033327011250000003","1.0154954745000081E7","132.01441168499866"
"6502","11686","11682","8","11690","46043","2564.49375","0.03333841875","1.0157519238750082E7","132.04775010374865"
"6503","11690","11682","1","11683","46044","2562.9581249999997","0.03331845562499999","1.0160082196875082E7","132.08106855937365"
"6504","11683","11678","1","11679","46045","2562.0806249999996","0.033307048124999995","1.0162644277500082E7","132.11437560749866"
"6505","11679","11674","7","11681","46052","2562.5193750000003","0.033312751875000005","1.0165206796875082E7","132.14768835937366"
"6506","11681","11680","4","11684","46056","2563.1775","0.033321307499999994","1.0167769974375082E7","132.18100966687365"
"6507","11684","11676","8","11684","46064","2563.1775","0.033321307499999994","1.0170333151875082E7","132.21433097437364"
"6508","11684","11676","7","11683","46071","2562.9581249999997","0.03331845562499999","1.0172896110000083E7","132.24764942999863"
"6509","11683","11676","5","11681","46076","2562.5193750000003","0.033312751875000005","1.0175458629375083E7","132.28096218187363"
"6510","11681","11680","6","11686","46082","2563.6162500000005","0.033327011250000003","1.0178022245625084E7","132.31428919312364"
"6511","11686","11684","1","11685","46083","2563.396875","0.033324159374999995","1.0180585642500084E7","132.34761335249866"
"6512","11685","11679","1","11680","46084","2562.3","0.0333099","1.0183147942500085E7","132.38092325249866"
"6513","11680","11677","7","11684","46091","2563.1775","0.033321307499999994","1.0185711120000085E7","132.41424455999865"
"6514","11684","11675","4","11679","46095","2562.0806249999996","0.033307048124999995","1.0188273200625084E7","132.44755160812366"
"6515","11679","11671","2","11673","46097","2560.7643749999997","0.033289936874999995","1.0190833965000084E7","132.48084154499867"
"6516","11673","11666","6","11672","46103","2560.545","0.033287085","1.0193394510000084E7","132.51412862999868"
"6517","11672","11663","1","11664","46104","2558.7899999999995","0.03326426999999999","1.0195953300000083E7","132.54739289999867"
"6518","11664","11663","4","11667","46108","2559.4481250000003","0.033272825625","1.0198512748125082E7","132.58066572562367"
"6519","11667","11663","7","11670","46115","2560.10625","0.03328138125","1.0201072854375081E7","132.61394710687367"
"6520","11670","11669","4","11673","46119","2560.7643749999997","0.033289936874999995","1.020363361875008E7","132.64723704374867"
"6521","11673","11672","1","11673","46120","2560.7643749999997","0.033289936874999995","1.020619438312508E7","132.68052698062368"
"6522","11673","11671","4","11675","46124","2561.203125","0.033295640625","1.020875558625008E7","132.71382262124868"
"6523","11675","11669","7","11676","46131","2561.4225","0.0332984925","1.021131700875008E7","132.74712111374868"
"6524","11676","11671","5","11676","46136","2561.4225","0.0332984925","1.0213878431250079E7","132.78041960624867"
"6525","11676","11674","2","11676","46138","2561.4225","0.0332984925","1.0216439853750078E7","132.81371809874867"
"6526","11676","11669","5","11674","46143","2560.98375","0.033292788749999996","1.0219000837500079E7","132.84701088749867"
"6527","11674","11670","7","11677","46150","2561.6418750000003","0.033301344375","1.022156247937508E7","132.88031223187366"
"6528","11677","11668","1","11669","46151","2559.8868749999997","0.03327852937499999","1.022412236625008E7","132.91359076124866"
"6529","11669","11662","1","11663","46152","2558.570625","0.033261418125","1.0226680936875079E7","132.94685217937365"
"6530","11663","11655","2","11657","46154","2557.254375","0.033244306875","1.0229238191250078E7","132.98009648624864"
"6531","11657","11650","1","11651","46155","2555.938125","0.033227195625","1.0231794129375078E7","133.01332368187363"
"6532","11651","11646","7","11653","46162","2556.376875","0.033232899375","1.0234350506250078E7","133.04655658124864"
"6533","11653","11647","1","11648","46163","2555.2799999999997","0.033218639999999994","1.0236905786250077E7","133.07977522124864"
"6534","11648","11639","4","11643","46167","2554.183125","0.033204380624999995","1.0239459969375078E7","133.11297960187363"
"6535","11643","11636","8","11644","46175","2554.4024999999997","0.033207232499999996","1.0242014371875077E7","133.14618683437362"
"6536","11644","11638","1","11639","46176","2553.3056249999995","0.03319297312499999","1.0244567677500077E7","133.17937980749863"
"6537","11639","11637","2","11639","46178","2553.3056249999995","0.03319297312499999","1.0247120983125076E7","133.21257278062365"
"6538","11639","11637","8","11645","46186","2554.621875","0.033210084375","1.0249675605000075E7","133.24578286499866"
"6539","11645","11643","1","11644","46187","2554.4024999999997","0.033207232499999996","1.0252230007500075E7","133.27899009749865"
"6540","11644","11637","3","11640","46190","2553.525","0.033195825","1.0254783532500075E7","133.31218592249866"
"6541","11640","11639","292","11931","46482","2617.3631250000003","0.034025720625","1.0257400895625075E7","133.34621164312367"
"6542","11931","11928","8","11936","46490","2618.4600000000005","0.034039980000000004","1.0260019355625076E7","133.38025162312366"
"6543","11936","11932","5","11937","46495","2618.679375","0.034042831875","1.0262638035000077E7","133.41429445499867"
"6544","11937","11934","2","11936","46497","2618.4600000000005","0.034039980000000004","1.0265256495000077E7","133.44833443499866"
"6545","11936","11933","1","11934","46498","2618.02125","0.034034276249999995","1.0267874516250078E7","133.48236871124865"
"6546","11934","11931","1","11932","46499","2617.5825","0.0340285725","1.0270492098750077E7","133.51639728374866"
"6547","11932","11923","3","11926","46502","2616.26625","0.03401146125","1.0273108365000077E7","133.55040874499866"
"6548","11926","11918","2","11920","46504","2614.95","0.03399434999999999","1.0275723315000076E7","133.58440309499866"
"6549","11920","11916","5","11921","46509","2615.1693750000004","0.033997201875","1.0278338484375076E7","133.61840029687366"
"6550","11921","11918","2","11920","46511","2614.95","0.03399434999999999","1.0280953434375076E7","133.65239464687366"
"6551","11920","11916","4","11920","46515","2614.95","0.03399434999999999","1.0283568384375075E7","133.68638899687366"
"6552","11920","11911","9","11920","46524","2614.95","0.03399434999999999","1.0286183334375074E7","133.72038334687366"
"6553","11920","11916","8","11924","46532","2615.8275","0.0340057575","1.0288799161875075E7","133.75438910437367"
"6554","11924","11918","1","11919","46533","2614.7306249999997","0.03399149812499999","1.0291413892500075E7","133.78838060249868"
"6555","11919","11913","6","11919","46539","2614.7306249999997","0.03399149812499999","1.0294028623125074E7","133.82237210062368"
"6556","11919","11913","2","11915","46541","2613.853125","0.033980090625","1.0296642476250075E7","133.85635219124867"
"6557","11915","11908","3","11911","46544","2612.9756250000005","0.033968683125","1.0299255451875076E7","133.89032087437369"
"6558","11911","11906","7","11913","46551","2613.414375","0.033974386875","1.0301868866250075E7","133.9242952612487"
"6559","11913","11910","5","11915","46556","2613.853125","0.033980090625","1.0304482719375076E7","133.95827535187368"
"6560","11915","11909","4","11913","46560","2613.414375","0.033974386875","1.0307096133750075E7","133.99224973874868"
"6561","11913","11909","3","11912","46563","2613.195","0.033971535","1.0309709328750076E7","134.0262212737487"
"6562","11912","11910","9","11919","46572","2614.7306249999997","0.03399149812499999","1.0312324059375076E7","134.0602127718737"
"6563","11919","11915","3","11918","46575","2614.51125","0.03398864625","1.0314938570625076E7","134.0942014181237"
"6564","11918","11911","3","11914","46578","2613.6337499999995","0.03397723874999999","1.0317552204375075E7","134.1281786568737"
"6565","11914","11913","5","11918","46583","2614.51125","0.03398864625","1.0320166715625076E7","134.1621673031237"
"6566","11918","11912","7","11919","46590","2614.7306249999997","0.03399149812499999","1.0322781446250075E7","134.1961588012487"
"6567","11919","11911","5","11916","46595","2614.0725","0.0339829425","1.0325395518750075E7","134.2301417437487"
"6568","11916","11914","4","11918","46599","2614.51125","0.03398864625","1.0328010030000076E7","134.2641303899987"
"6569","11918","11917","1","11918","46600","2614.51125","0.03398864625","1.0330624541250076E7","134.29811903624872"
"6570","11918","11915","6","11921","46606","2615.1693750000004","0.033997201875","1.0333239710625077E7","134.33211623812372"
"6571","11921","11915","1","11916","46607","2614.0725","0.0339829425","1.0335853783125076E7","134.3660991806237"
"6572","11916","11909","4","11913","46611","2613.414375","0.033974386875","1.0338467197500076E7","134.4000735674987"
"6573","11913","11905","2","11907","46613","2612.098125","0.033957275625","1.0341079295625076E7","134.4340308431237"
"6574","11907","11901","6","11907","46619","2612.098125","0.033957275625","1.0343691393750075E7","134.4679881187487"
"6575","11907","11901","7","11908","46626","2612.3174999999997","0.03396012749999999","1.0346303711250076E7","134.5019482462487"
"6576","11908","11906","4","11910","46630","2612.75625","0.033965831249999995","1.0348916467500076E7","134.5359140774987"
"6577","11910","11903","7","11910","46637","2612.75625","0.033965831249999995","1.0351529223750075E7","134.56987990874867"
"6578","11910","11907","2","11909","46639","2612.536875","0.033962979374999994","1.0354141760625076E7","134.60384288812367"
"6579","11909","11906","3","11909","46642","2612.536875","0.033962979374999994","1.0356754297500076E7","134.63780586749866"
"6580","11909","11901","3","11904","46645","2611.4399999999996","0.033948719999999995","1.0359365737500075E7","134.67175458749867"
"6581","11904","11902","3","11905","46648","2611.659375","0.033951571875","1.0361977396875076E7","134.70570615937368"
"6582","11905","11896","2","11898","46650","2610.1237499999997","0.033931608749999995","1.0364587520625075E7","134.73963776812369"
"6583","11898","11895","5","11900","46655","2610.5625","0.0339373125","1.0367198083125075E7","134.7735750806237"
"6584","11900","11897","1","11898","46656","2610.1237499999997","0.033931608749999995","1.0369808206875075E7","134.8075066893737"
"6585","11898","11895","8","11903","46664","2611.220625","0.033945868124999994","1.0372419427500075E7","134.84145255749868"
"6586","11903","11902","1","11903","46665","2611.220625","0.033945868124999994","1.0375030648125075E7","134.87539842562367"
"6587","11903","11901","9","11910","46674","2612.75625","0.033965831249999995","1.0377643404375074E7","134.90936425687366"
"6588","11910","11907","2","11909","46676","2612.536875","0.033962979374999994","1.0380255941250075E7","134.94332723624865"
"6589","11909","11907","3","11910","46679","2612.75625","0.033965831249999995","1.0382868697500074E7","134.97729306749864"
"6590","11910","11903","2","11905","46681","2611.659375","0.033951571875","1.0385480356875075E7","135.01124463937364"
"6591","11905","11901","5","11906","46686","2611.8787500000003","0.033954423750000004","1.0388092235625075E7","135.04519906312365"
"6592","11906","11903","7","11910","46693","2612.75625","0.033965831249999995","1.0390704991875075E7","135.07916489437363"
"6593","11910","11904","1","11905","46694","2611.659375","0.033951571875","1.0393316651250076E7","135.11311646624864"
"6594","11905","11897","3","11900","46697","2610.5625","0.0339373125","1.0395927213750076E7","135.14705377874864"
"6595","11900","11893","8","11901","46705","2610.781875","0.033940164375","1.0398537995625075E7","135.18099394312364"
"6596","11901","11895","4","11899","46709","2610.343125","0.033934460624999996","1.0401148338750076E7","135.21492840374864"
"6597","11899","11891","7","11898","46716","2610.1237499999997","0.033931608749999995","1.0403758462500075E7","135.24886001249865"
"6598","11898","11893","3","11896","46719","2609.6850000000004","0.033925905000000006","1.0406368147500075E7","135.28278591749864"
"6599","11896","11894","3","11897","46722","2609.904375","0.033928756875","1.0408978051875075E7","135.31671467437366"
"6600","11897","11890","7","11897","46729","2609.904375","0.033928756875","1.0411587956250075E7","135.35064343124867"
"6601","11897","11897","50000","61897","96729","13578.654375","0.17652250687499998","1.0425166610625075E7","135.52716593812366"
"6602","61897","61891","3","61894","96732","13577.99625","0.17651395125","1.0438744606875075E7","135.70367988937366"
"6603","61894","61893","3","61896","96735","13578.435000000001","0.176519655","1.0452323041875076E7","135.88019954437365"
"6604","61896","61891","9","61900","96744","13579.3125","0.1765310625","1.0465902354375076E7","136.05673060687366"
"6605","61900","61893","2","61895","96746","13578.215625","0.176516803125","1.0479480570000075E7","136.23324740999865"
"6606","61895","61893","9","61902","96755","13579.75125","0.17653676624999998","1.0493060321250075E7","136.40978417624865"
"6607","61902","61895","2","61897","96757","13578.654375","0.17652250687499998","1.0506638975625075E7","136.58630668312364"
"6608","61897","61894","6","61900","96763","13579.3125","0.1765310625","1.0520218288125075E7","136.76283774562364"
"6609","61900","61899","9","61908","96772","13581.0675","0.17655387749999998","1.0533799355625076E7","136.93939162312364"
"6610","61908","61899","6","61905","96778","13580.409375","0.17654532187499997","1.0547379765000077E7","137.11593694499865"
"6611","61905","61900","9","61909","96787","13581.286875","0.176556729375","1.0560961051875077E7","137.29249367437365"
"6612","61909","61901","8","61909","96795","13581.286875","0.176556729375","1.0574542338750077E7","137.46905040374864"
"6613","61909","61903","9","61912","96804","13581.945","0.176565285","1.0588124283750078E7","137.64561568874865"
"6614","61912","61910","8","61918","96812","13583.26125","0.17658239625","1.0601707545000078E7","137.82219808499866"
"6615","61918","61913","9","61922","96821","13584.13875","0.17659380375","1.0615291683750078E7","137.99879188874866"
"6616","61922","61918","6","61924","96827","13584.577500000001","0.1765995075","1.0628876261250079E7","138.17539139624864"
"6617","61924","61922","5","61927","96832","13585.235625","0.176608063125","1.064246149687508E7","138.35199945937364"
"6618","61927","61923","2","61925","96834","13584.796875","0.176602359375","1.065604629375008E7","138.52860181874865"
"6619","61925","61919","9","61928","96843","13585.454999999996","0.17661091499999995","1.066963174875008E7","138.70521273374865"
"6620","61928","61923","3","61926","96846","13585.01625","0.17660521125","1.0683216765000079E7","138.88181794499866"
"6621","61926","61918","2","61920","96848","13583.7","0.1765881","1.0696800465000078E7","139.05840604499866"
"6622","61920","61918","5","61923","96853","13584.358124999999","0.176596655625","1.0710384823125077E7","139.23500270062365"
"6623","61923","61921","9","61930","96862","13585.89375","0.17661661874999998","1.0723970716875078E7","139.41161931937364"
"6624","61930","61923","5","61928","96867","13585.454999999996","0.17661091499999995","1.0737556171875078E7","139.58823023437364"
"6625","61928","61919","1","61920","96868","13583.7","0.1765881","1.0751139871875077E7","139.76481833437364"
"6626","61920","61918","3","61921","96871","13583.919375000001","0.176590951875","1.0764723791250078E7","139.94140928624864"
"6627","61921","61914","7","61921","96878","13583.919375000001","0.176590951875","1.0778307710625079E7","140.11800023812364"
"6628","61921","61912","2","61914","96880","13582.38375","0.17657098875","1.0791890094375078E7","140.29457122687364"
"6629","61914","61911","6","61917","96886","13583.041874999999","0.17657954437499998","1.0805473136250077E7","140.47115077124863"
"6630","61917","61910","8","61918","96894","13583.26125","0.17658239625","1.0819056397500077E7","140.64773316749864"
"6631","61918","61911","3","61914","96897","13582.38375","0.17657098875","1.0832638781250076E7","140.82430415624864"
"6632","61914","61910","4","61914","96901","13582.38375","0.17657098875","1.0846221165000075E7","141.00087514499864"
"6633","61914","61909","8","61917","96909","13583.041874999999","0.17657954437499998","1.0859804206875075E7","141.17745468937363"
"6634","61917","61911","1","61912","96910","13581.945","0.176565285","1.0873386151875075E7","141.35401997437364"
"6635","61912","61909","6","61915","96916","13582.603125","0.17657384062499998","1.0886968755000075E7","141.53059381499864"
"6636","61915","61907","8","61915","96924","13582.603125","0.17657384062499998","1.0900551358125076E7","141.70716765562364"
"6637","61915","61907","5","61912","96929","13581.945","0.176565285","1.0914133303125076E7","141.88373294062364"
"6638","61912","61903","7","61910","96936","13581.50625","0.17655958125","1.0927714809375076E7","142.06029252187363"
"6639","61910","61904","5","61909","96941","13581.286875","0.176556729375","1.0941296096250076E7","142.23684925124863"
"6640","61909","61908","8","61916","96949","13582.822500000002","0.17657669250000002","1.0954878918750076E7","142.41342594374862"
"6641","61916","61913","2","61915","96951","13582.603125","0.17657384062499998","1.0968461521875076E7","142.58999978437362"
"6642","61915","61911","8","61919","96959","13583.480625","0.17658524812499998","1.0982045002500076E7","142.76658503249863"
"6643","61919","61917","8","61925","96967","13584.796875","0.176602359375","1.0995629799375076E7","142.94318739187364"
"6644","61925","61917","8","61925","96975","13584.796875","0.176602359375","1.1009214596250076E7","143.11978975124865"
"6645","61925","61922","6","61928","96981","13585.454999999996","0.17661091499999995","1.1022800051250076E7","143.29640066624864"
"6646","61928","61920","5","61925","96986","13584.796875","0.176602359375","1.1036384848125076E7","143.47300302562365"
"6647","61925","61920","4","61924","96990","13584.577500000001","0.1765995075","1.1049969425625077E7","143.64960253312364"
"6648","61924","61918","3","61921","96993","13583.919375000001","0.176590951875","1.1063553345000077E7","143.82619348499864"
"6649","61921","61918","9","61927","97002","13585.235625","0.176608063125","1.1077138580625078E7","144.00280154812364"
"6650","61927","61919","8","61927","97010","13585.235625","0.176608063125","1.1090723816250078E7","144.17940961124864"
"6651","61927","61926","7","61933","97017","13586.551875","0.17662517437499997","1.110431036812508E7","144.35603478562365"
"6652","61933","61929","9","61938","97026","13587.648749999998","0.17663943374999996","1.1117898016875079E7","144.53267421937366"
"6653","61938","61937","3","61940","97029","13588.0875","0.1766451375","1.113148610437508E7","144.70931935687366"
"6654","61940","61936","5","61941","97034","13588.306875000002","0.176647989375","1.1145074411250079E7","144.88596734624866"
"6655","61941","61940","3","61943","97037","13588.745625","0.17665369312499998","1.115866315687508E7","145.06262103937365"
"6656","61943","61938","1","61939","97038","13587.868125","0.176642285625","1.1172251025000079E7","145.23926332499866"
"6657","61939","61930","1","61931","97039","13586.113125","0.176619470625","1.1185837138125079E7","145.41588279562367"
"6658","61931","61930","6","61936","97045","13587.21","0.17663373","1.119942434812508E7","145.59251652562367"
"6659","61936","61934","7","61941","97052","13588.306875000002","0.176647989375","1.121301265500008E7","145.76916451499866"
"6660","61941","61937","1","61938","97053","13587.648749999998","0.17663943374999996","1.122660030375008E7","145.94580394874868"
"6661","61938","61936","409","62345","97462","13676.934375","0.177800146875","1.1240277238125078E7","146.12360409562368"
"6662","62345","62338","6","62344","97468","13676.715","0.177797295","1.1253953953125078E7","146.30140139062368"
"6663","62344","62342","7","62349","97475","13677.811875000001","0.177811554375","1.1267631765000079E7","146.4792129449987"
"6664","62349","62342","5","62347","97480","13677.373125","0.17780585062499998","1.1281309138125079E7","146.65701879562369"
"6665","62347","62339","5","62344","97485","13676.715","0.177797295","1.1294985853125079E7","146.8348160906237"
"6666","62344","62343","6","62349","97491","13677.811875000001","0.177811554375","1.130866366500008E7","147.0126276449987"
"6667","62349","62343","8","62351","97499","13678.250625","0.177817258125","1.1322341915625079E7","147.1904449031237"
"6668","62351","62348","6","62354","97505","13678.90875","0.17782581375","1.1336020824375078E7","147.3682707168737"
"6669","62354","62351","2","62353","97507","13678.689374999996","0.17782296187499994","1.1349699513750078E7","147.5460936787487"
"6670","62353","62344","6","62350","97513","13678.03125","0.17781440625","1.1363377545000078E7","147.7239080849987"
"6671","62350","62348","1","62349","97514","13677.811875000001","0.177811554375","1.1377055356875079E7","147.9017196393737"
"6672","62349","62347","8","62355","97522","13679.128125","0.177828665625","1.139073448500008E7","148.0795483049987"
"6673","62355","62347","6","62353","97528","13678.689374999996","0.17782296187499994","1.140441317437508E7","148.2573712668737"
"6674","62353","62350","2","62352","97530","13678.47","0.17782010999999998","1.141809164437508E7","148.4351913768737"
"6675","62352","62343","6","62349","97536","13677.811875000001","0.177811554375","1.143176945625008E7","148.6130029312487"
"6676","62349","62342","6","62348","97542","13677.592499999999","0.17780870249999997","1.144544704875008E7","148.7908116337487"
"6677","62348","62340","9","62349","97551","13677.811875000001","0.177811554375","1.145912486062508E7","148.9686231881237"
"6678","62349","62347","7","62354","97558","13678.90875","0.17782581375","1.147280376937508E7","149.1464490018737"
"6679","62354","62348","1","62349","97559","13677.811875000001","0.177811554375","1.148648158125008E7","149.3242605562487"
"6680","62349","62340","7","62347","97566","13677.373125","0.17780585062499998","1.150015895437508E7","149.5020664068737"
"6681","62347","62344","1","62345","97567","13676.934375","0.177800146875","1.151383588875008E7","149.6798665537487"
"6682","62345","62343","5","62348","97572","13677.592499999999","0.17780870249999997","1.152751348125008E7","149.85767525624868"
"6683","62348","62342","1","62343","97573","13676.495625","0.17779444312499998","1.154118997687508E7","150.0354696993737"
"6684","62343","62338","4","62342","97577","13676.276249999999","0.17779159124999996","1.1554866253125079E7","150.2132612906237"
"6685","62342","62340","7","62347","97584","13677.373125","0.17780585062499998","1.1568543626250079E7","150.3910671412487"
"6686","62347","62345","7","62352","97591","13678.47","0.17782010999999998","1.158222209625008E7","150.5688872512487"
"6687","62352","62349","5","62354","97596","13678.90875","0.17782581375","1.1595901005000079E7","150.7467130649987"
"6688","62354","62352","2","62354","97598","13678.90875","0.17782581375","1.1609579913750079E7","150.92453887874868"
"6689","62354","62347","8","62355","97606","13679.128125","0.177828665625","1.162325904187508E7","151.10236754437366"
"6690","62355","62354","6","62360","97612","13680.225","0.17784292499999999","1.1636939266875079E7","151.28021046937366"
"6691","62360","62351","7","62358","97619","13679.78625","0.17783722124999998","1.165061905312508E7","151.45804769062366"
"6692","62358","62349","4","62353","97623","13678.689374999996","0.17782296187499994","1.166429774250008E7","151.63587065249865"
"6693","62353","62344","5","62349","97628","13677.811875000001","0.177811554375","1.167797555437508E7","151.81368220687366"
"6694","62349","62345","4","62349","97632","13677.811875000001","0.177811554375","1.1691653366250081E7","151.99149376124868"
"6695","62349","62342","9","62351","97641","13678.250625","0.177817258125","1.170533161687508E7","152.16931101937368"
"6696","62351","62348","5","62353","97646","13678.689374999996","0.17782296187499994","1.171901030625008E7","152.34713398124867"
"6697","62353","62347","6","62353","97652","13678.689374999996","0.17782296187499994","1.173268899562508E7","152.52495694312367"
"6698","62353","62346","8","62354","97660","13678.90875","0.17782581375","1.174636790437508E7","152.70278275687366"
"6699","62354","62350","1","62351","97661","13678.250625","0.177817258125","1.176004615500008E7","152.88060001499866"
"6700","62351","62348","6","62354","97667","13678.90875","0.17782581375","1.1773725063750079E7","153.05842582874865"
"6701","62354","62347","4","62351","97671","13678.250625","0.177817258125","1.1787403314375078E7","153.23624308687366"
"6702","62351","62350","6","62356","97677","13679.3475","0.17783151749999998","1.1801082661875078E7","153.41407460437367"
"6703","62356","62354","3","62357","97680","13679.566874999999","0.17783436937499997","1.1814762228750078E7","153.59190897374867"
"6704","62357","62355","7","62362","97687","13680.66375","0.17784862875","1.1828442892500078E7","153.7697576024987"
"6705","62362","62355","7","62362","97694","13680.66375","0.17784862875","1.1842123556250079E7","153.9476062312487"
"6706","62362","62353","6","62359","97700","13680.005625","0.177840073125","1.1855803561875079E7","154.1254463043737"
"6707","62359","62354","3","62357","97703","13679.566874999999","0.17783436937499997","1.1869483128750078E7","154.3032806737487"
"6708","62357","62356","2","62358","97705","13679.78625","0.17783722124999998","1.188316291500008E7","154.4811178949987"
"6709","62358","62349","9","62358","97714","13679.78625","0.17783722124999998","1.189684270125008E7","154.6589551162487"
"6710","62358","62353","2","62355","97716","13679.128125","0.177828665625","1.191052182937508E7","154.8367837818737"
"6711","62355","62350","6","62356","97722","13679.3475","0.17783151749999998","1.192420117687508E7","155.0146152993737"
"6712","62356","62354","7","62361","97729","13680.444375","0.17784577687499997","1.1937881621250082E7","155.1924610762487"
"6713","62361","62352","9","62361","97738","13680.444375","0.17784577687499997","1.1951562065625083E7","155.37030685312368"
"6714","62361","62360","2","62362","97740","13680.66375","0.17784862875","1.1965242729375083E7","155.5481554818737"
"6715","62362","62356","2","62358","97742","13679.78625","0.17783722124999998","1.1978922515625084E7","155.7259927031237"
"6716","62358","62351","1","62352","97743","13678.47","0.17782010999999998","1.1992600985625084E7","155.9038128131237"
"6717","62352","62348","2","62350","97745","13678.03125","0.17781440625","1.2006279016875084E7","156.0816272193737"
"6718","62350","62347","2","62349","97747","13677.811875000001","0.177811554375","1.2019956828750085E7","156.2594387737487"
"6719","62349","62344","7","62351","97754","13678.250625","0.177817258125","1.2033635079375084E7","156.43725603187372"
"6720","62351","62343","3","62346","97757","13677.153750000001","0.17780299875","1.2047312233125085E7","156.6150590306237"
"6721","62346","62344","131","62475","97888","13705.453125","0.178170890625","1.2061017686250085E7","156.79322992124872"
"6722","62475","62472","5","62477","97893","13705.891875","0.17817659437499997","1.2074723578125086E7","156.97140651562373"
"6723","62477","62471","9","62480","97902","13706.55","0.17818515","1.2088430128125086E7","157.14959166562372"
"6724","62480","62478","8","62486","97910","13707.86625","0.17820226124999997","1.2102137994375087E7","157.3277939268737"
"6725","62486","62484","5","62489","97915","13708.524375","0.178210816875","1.2115846518750086E7","157.50600474374872"
"6726","62489","62482","2","62484","97917","13707.4275","0.1781965575","1.2129553946250087E7","157.68420130124872"
"6727","62484","62479","2","62481","97919","13706.769375","0.17818800187499997","1.2143260715625087E7","157.8623893031237"
"6728","62481","62476","1","62477","97920","13705.891875","0.17817659437499997","1.2156966607500087E7","158.0405658974987"
"6729","62477","62469","7","62476","97927","13705.6725","0.1781737425","1.2170672280000087E7","158.21873963999872"
"6730","62476","62468","9","62477","97936","13705.891875","0.17817659437499997","1.2184378171875088E7","158.39691623437372"
"6731","62477","62475","4","62479","97940","13706.330625","0.178182298125","1.2198084502500087E7","158.5750985324987"
"6732","62479","62478","9","62487","97949","13708.085625","0.17820511312499998","1.2211792588125087E7","158.7533036456237"
"6733","62487","62480","3","62483","97952","13707.208125","0.17819370562499998","1.2225499796250088E7","158.9314973512487"
"6734","62483","62475","7","62482","97959","13706.988749999999","0.17819085374999996","1.2239206785000088E7","159.10968820499872"
"6735","62482","62475","9","62484","97968","13707.4275","0.1781965575","1.2252914212500088E7","159.28788476249872"
"6736","62484","62482","9","62491","97977","13708.963125000002","0.178216520625","1.2266623175625088E7","159.46610128312372"
"6737","62491","62485","5","62490","97982","13708.74375","0.17821366874999997","1.2280331919375088E7","159.64431495187372"
"6738","62490","62485","6","62491","97988","13708.963125000002","0.178216520625","1.2294040882500088E7","159.82253147249872"
"6739","62491","62489","9","62498","97997","13710.498749999999","0.17823648374999998","1.2307751381250087E7","160.00076795624872"
"6740","62498","62491","8","62499","98005","13710.718125000001","0.178239335625","1.2321462099375088E7","160.17900729187372"
"6741","62499","62491","2","62493","98007","13709.401875","0.178222224375","1.2335171501250088E7","160.3572295162487"
"6742","62493","62487","8","62495","98015","13709.840625","0.178227928125","1.2348881341875087E7","160.53545744437372"
"6743","62495","62492","8","62500","98023","13710.9375","0.17824218749999998","1.2362592279375087E7","160.7136996318737"
"6744","62500","62492","1","62493","98024","13709.401875","0.178222224375","1.2376301681250088E7","160.8919218562487"
"6745","62493","62484","2","62486","98026","13707.86625","0.17820226124999997","1.2390009547500089E7","161.0701241174987"
"6746","62486","62483","4","62487","98030","13708.085625","0.17820511312499998","1.240371763312509E7","161.24832923062368"
"6747","62487","62484","2","62486","98032","13707.86625","0.17820226124999997","1.241742549937509E7","161.42653149187367"
"6748","62486","62479","5","62484","98037","13707.4275","0.1781965575","1.243113292687509E7","161.60472804937368"
"6749","62484","62478","1","62479","98038","13706.330625","0.178182298125","1.244483925750009E7","161.78291034749867"
"6750","62479","62475","2","62477","98040","13705.891875","0.17817659437499997","1.245854514937509E7","161.96108694187367"
"6751","62477","62472","2","62474","98042","13705.233750000001","0.17816803875","1.2472250383125091E7","162.13925498062366"
"6752","62474","62468","5","62473","98047","13705.014374999999","0.17816518687499996","1.248595539750009E7","162.31742016749865"
"6753","62473","62466","5","62471","98052","13704.575625000001","0.17815948312500002","1.249965997312509E7","162.49557965062365"
"6754","62471","62462","1","62463","98053","13702.820624999998","0.17813666812499998","1.251336279375009E7","162.67371631874866"
"6755","62463","62462","6","62468","98059","13703.9175","0.17815092749999997","1.2527066711250091E7","162.85186724624867"
"6756","62468","62462","6","62468","98065","13703.9175","0.17815092749999997","1.2540770628750091E7","163.0300181737487"
"6757","62468","62467","3","62470","98068","13704.35625","0.17815663125","1.255447498500009E7","163.2081748049987"
"6758","62470","62463","7","62470","98075","13704.35625","0.17815663125","1.256817934125009E7","163.3863314362487"
"6759","62470","62461","8","62469","98083","13704.136875","0.178153779375","1.258188347812509E7","163.5644852156237"
"6760","62469","62462","2","62464","98085","13703.04","0.17813952","1.2595586518125089E7","163.7426247356237"
"6761","62464","62458","3","62461","98088","13702.381875","0.17813096437499998","1.260928890000009E7","163.9207556999987"
"6762","62461","62452","7","62459","98095","13701.943125","0.17812526062499998","1.262299084312509E7","164.0988809606237"
"6763","62459","62457","7","62464","98102","13703.04","0.17813952","1.263669388312509E7","164.2770204806237"
"6764","62464","62461","1","62462","98103","13702.60125","0.17813381625","1.265039648437509E7","164.4551542968737"
"6765","62462","62458","3","62461","98106","13702.381875","0.17813096437499998","1.266409886625009E7","164.6332852612487"
"6766","62461","62458","9","62467","98115","13703.698124999999","0.17814807562499999","1.267780256437509E7","164.81143333687368"
"6767","62467","62459","6","62465","98121","13703.259375","0.17814237187499998","1.269150582375009E7","164.98957570874867"
"6768","62465","62460","1","62461","98122","13702.381875","0.17813096437499998","1.270520820562509E7","165.16770667312366"
"6769","62461","62459","5","62464","98127","13703.04","0.17813952","1.271891124562509E7","165.34584619312366"
"6770","62464","62458","7","62465","98134","13703.259375","0.17814237187499998","1.273261450500009E7","165.52398856499866"
"6771","62465","62459","2","62461","98136","13702.381875","0.17813096437499998","1.2746316886875091E7","165.70211952937365"
"6772","62461","62452","1","62453","98137","13700.626874999996","0.17810814937499994","1.2760017513750091E7","165.88022767874864"
"6773","62453","62449","4","62453","98141","13700.626874999996","0.17810814937499994","1.2773718140625091E7","166.05833582812363"
"6774","62453","62445","3","62448","98144","13699.529999999999","0.17809388999999998","1.278741767062509E7","166.23642971812365"
"6775","62448","62441","4","62445","98148","13698.871875","0.178085334375","1.280111654250009E7","166.41451505249864"
"6776","62445","62442","8","62450","98156","13699.96875","0.17809959374999998","1.281481651125009E7","166.59261464624865"
"6777","62450","62447","9","62456","98165","13701.285","0.178116705","1.282851779625009E7","166.77073135124866"
"6778","62456","62450","1","62451","98166","13700.188125","0.178102445625","1.284221798437509E7","166.94883379687366"
"6779","62451","62450","8","62458","98174","13701.72375","0.17812240875","1.285591970812509E7","167.12695620562366"
"6780","62458","62455","9","62464","98183","13703.04","0.17813952","1.286962274812509E7","167.30509572562366"
"6781","62464","62463","399","62862","98582","13790.35125","0.17927456625","1.288341309937509E7","167.48437029187366"
"6782","62862","62855","5","62860","98587","13789.9125","0.1792688625","1.289720301187509E7","167.66363915437367"
"6783","62860","62853","9","62862","98596","13790.35125","0.17927456625","1.291099336312509E7","167.84291372062367"
"6784","62862","62860","8","62868","98604","13791.6675","0.1792916775","1.292478503062509E7","168.02220539812367"
"6785","62868","62861","9","62870","98613","13792.10625","0.17929738125","1.293857713687509E7","168.20150277937367"
"6786","62870","62862","9","62871","98622","13792.325625000001","0.179300233125","1.295236946250009E7","168.38080301249866"
"6787","62871","62869","3","62872","98625","13792.545","0.179303085","1.296616200750009E7","168.56010609749865"
"6788","62872","62863","1","62864","98626","13790.79","0.17928027","1.2979952797500089E7","168.73938636749864"
"6789","62864","62859","9","62868","98635","13791.6675","0.1792916775","1.299374446500009E7","168.91867804499864"
"6790","62868","62864","7","62871","98642","13792.325625000001","0.179300233125","1.300753679062509E7","169.09797827812363"
"6791","62871","62863","2","62865","98644","13791.009375","0.17928312187499998","1.302132780000009E7","169.27726139999862"
"6792","62865","62859","2","62861","98646","13790.131875","0.17927171437499997","1.3035117931875091E7","169.45653311437363"
"6793","62861","62857","8","62865","98654","13791.009375","0.17928312187499998","1.3048908941250091E7","169.63581623624862"
"6794","62865","62860","3","62863","98657","13790.570624999998","0.17927741812499998","1.3062699511875091E7","169.8150936543736"
"6795","62863","62854","8","62862","98665","13790.35125","0.17927456625","1.3076489863125091E7","169.9943682206236"
"6796","62862","62855","1","62856","98666","13789.035","0.17925745499999998","1.3090278898125092E7","170.1736256756236"
"6797","62856","62847","3","62850","98669","13787.71875","0.17924034374999998","1.3104066616875092E7","170.3528660193736"
"6798","62850","62846","9","62855","98678","13788.815625","0.17925460312499997","1.3117855432500092E7","170.5321206224986"
"6799","62855","62849","9","62858","98687","13789.47375","0.17926315874999998","1.3131644906250093E7","170.7113837812486"
"6800","62858","62854","6","62860","98693","13789.9125","0.1792688625","1.3145434818750093E7","170.8906526437486"
"6801","62860","62859","2","62861","98695","13790.131875","0.17927171437499997","1.3159224950625094E7","171.06992435812361"
"6802","62861","62859","2","62861","98697","13790.131875","0.17927171437499997","1.3173015082500095E7","171.24919607249862"
"6803","62861","62853","1","62854","98698","13788.59625","0.17925175125","1.3186803678750094E7","171.42844782374863"
"6804","62854","62849","7","62856","98705","13789.035","0.17925745499999998","1.3200592713750094E7","171.60770527874863"
"6805","62856","62854","6","62860","98711","13789.9125","0.1792688625","1.3214382626250094E7","171.78697414124863"
"6806","62860","62855","6","62861","98717","13790.131875","0.17927171437499997","1.3228172758125095E7","171.96624585562364"
"6807","62861","62860","7","62867","98724","13791.448124999999","0.17928882562499998","1.3241964206250094E7","172.14553468124865"
"6808","62867","62858","1","62859","98725","13789.693125","0.179266010625","1.3255753899375094E7","172.32480069187366"
"6809","62859","62850","4","62854","98729","13788.59625","0.17925175125","1.3269542495625094E7","172.50405244312367"
"6810","62854","62852","4","62856","98733","13789.035","0.17925745499999998","1.3283331530625094E7","172.68330989812367"
"6811","62856","62851","3","62854","98736","13788.59625","0.17925175125","1.3297120126875093E7","172.86256164937367"
"6812","62854","62849","4","62853","98740","13788.376874999996","0.17924889937499994","1.3310908503750093E7","173.04181054874869"
"6813","62853","62852","7","62859","98747","13789.693125","0.179266010625","1.3324698196875094E7","173.2210765593737"
"6814","62859","62856","4","62860","98751","13789.9125","0.1792688625","1.3338488109375093E7","173.4003454218737"
"6815","62860","62854","4","62858","98755","13789.47375","0.17926315874999998","1.3352277583125094E7","173.5796085806237"
"6816","62858","62850","1","62851","98756","13787.938125","0.179243195625","1.3366065521250093E7","173.7588517762487"
"6817","62851","62844","6","62850","98762","13787.71875","0.17924034374999998","1.3379853240000093E7","173.9380921199987"
"6818","62850","62849","5","62854","98767","13788.59625","0.17925175125","1.3393641836250093E7","174.1173438712487"
"6819","62854","62850","1","62851","98768","13787.938125","0.179243195625","1.3407429774375092E7","174.29658706687368"
"6820","62851","62842","9","62851","98777","13787.938125","0.179243195625","1.3421217712500092E7","174.47583026249868"
"6821","62851","62847","7","62854","98784","13788.59625","0.17925175125","1.3435006308750091E7","174.65508201374868"
"6822","62854","62852","9","62861","98793","13790.131875","0.17927171437499997","1.3448796440625092E7","174.8343537281237"
"6823","62861","62852","8","62860","98801","13789.9125","0.1792688625","1.3462586353125092E7","175.0136225906237"
"6824","62860","62853","3","62856","98804","13789.035","0.17925745499999998","1.3476375388125092E7","175.1928800456237"
"6825","62856","62852","5","62857","98809","13789.254374999999","0.17926030687499997","1.3490164642500091E7","175.3721403524987"
"6826","62857","62849","1","62850","98810","13787.71875","0.17924034374999998","1.3503952361250091E7","175.55138069624869"
"6827","62850","62849","9","62858","98819","13789.47375","0.17926315874999998","1.3517741835000092E7","175.73064385499868"
"6828","62858","62850","6","62856","98825","13789.035","0.17925745499999998","1.3531530870000092E7","175.90990130999867"
"6829","62856","62852","7","62859","98832","13789.693125","0.179266010625","1.3545320563125093E7","176.0891673206237"
"6830","62859","62851","4","62855","98836","13788.815625","0.17925460312499997","1.3559109378750093E7","176.2684219237487"
"6831","62855","62850","2","62852","98838","13788.1575","0.17924604749999998","1.3572897536250094E7","176.44766797124868"
"6832","62852","62850","8","62858","98846","13789.47375","0.17926315874999998","1.3586687010000095E7","176.62693112999867"
"6833","62858","62855","7","62862","98853","13790.35125","0.17927456625","1.3600477361250095E7","176.80620569624867"
"6834","62862","62858","6","62864","98859","13790.79","0.17928027","1.3614268151250094E7","176.98548596624866"
"6835","62864","62861","9","62870","98868","13792.10625","0.17929738125","1.3628060257500093E7","177.16478334749866"
"6836","62870","62868","6","62874","98874","13792.983750000001","0.17930878875","1.3641853241250094E7","177.34409213624866"
"6837","62874","62866","8","62874","98882","13792.983750000001","0.17930878875","1.3655646225000095E7","177.52340092499867"
"6838","62874","62868","3","62871","98885","13792.325625000001","0.179300233125","1.3669438550625095E7","177.70270115812366"
"6839","62871","62870","8","62878","98893","13793.861249999996","0.17932019624999995","1.3683232411875095E7","177.88202135437365"
"6840","62878","62877","2","62879","98895","13794.080625","0.179323048125","1.3697026492500095E7","178.06134440249866"
"6841","62879","62876","370","63246","99265","13874.591250000001","0.18036968625","1.3710901083750095E7","178.24171408874867"
"6842","63246","63242","7","63249","99272","13875.249375000001","0.180378241875","1.3724776333125096E7","178.42209233062366"
"6843","63249","63246","6","63252","99278","13875.9075","0.18038679749999997","1.3738652240625096E7","178.60247912812366"
"6844","63252","63251","4","63255","99282","13876.565625","0.180395353125","1.3752528806250097E7","178.78287448124865"
"6845","63255","63249","7","63256","99289","13876.785","0.18039820499999998","1.3766405591250097E7","178.96327268624864"
"6846","63256","63251","3","63254","99292","13876.34625","0.18039250125","1.3780281937500097E7","179.14366518749864"
"6847","63254","63247","9","63256","99301","13876.785","0.18039820499999998","1.3794158722500097E7","179.32406339249863"
"6848","63256","63249","5","63254","99306","13876.34625","0.18039250125","1.3808035068750096E7","179.50445589374863"
"6849","63254","63253","8","63261","99314","13877.881875","0.18041246437499997","1.3821912950625097E7","179.68486835812362"
"6850","63261","63260","6","63266","99320","13878.978750000002","0.18042672375000002","1.3835791929375097E7","179.86529508187363"
"6851","63266","63263","9","63272","99329","13880.295","0.180443835","1.3849672224375097E7","180.04573891687363"
"6852","63272","63271","4","63275","99333","13880.953125","0.180452390625","1.3863553177500097E7","180.22619130749862"
"6853","63275","63267","2","63269","99335","13879.636875","0.18043527937499998","1.3877432814375097E7","180.4066265868736"
"6854","63269","63261","4","63265","99339","13878.759375","0.18042387187499997","1.3891311573750097E7","180.58705045874862"
"6855","63265","63264","6","63270","99345","13879.85625","0.18043813125","1.3905191430000097E7","180.76748858999864"
"6856","63270","63267","1","63268","99346","13879.4175","0.1804324275","1.3919070847500097E7","180.94792101749863"
"6857","63268","63261","6","63267","99352","13879.198124999999","0.18042957562499998","1.3932950045625096E7","181.12835059312363"
"6858","63267","63260","7","63267","99359","13879.198124999999","0.18042957562499998","1.3946829243750095E7","181.30878016874863"
"6859","63267","63266","9","63275","99368","13880.953125","0.180452390625","1.3960710196875095E7","181.48923255937362"
"6860","63275","63273","1","63274","99369","13880.733750000001","0.18044953875","1.3974590930625096E7","181.66968209812362"
"6861","63274","63271","1","63272","99370","13880.295","0.180443835","1.3988471225625096E7","181.85012593312362"
"6862","63272","63267","9","63276","99379","13881.1725","0.1804552425","1.4002352398125095E7","182.0305811756236"
"6863","63276","63271","9","63280","99388","13882.05","0.18046664999999998","1.4016234448125096E7","182.2110478256236"
"6864","63280","63272","4","63276","99392","13881.1725","0.1804552425","1.4030115620625095E7","182.3915030681236"
"6865","63276","63274","9","63283","99401","13882.708125","0.18047520562499997","1.4043998328750096E7","182.57197827374858"
"6866","63283","63279","6","63285","99407","13883.146875","0.180480909375","1.4057881475625096E7","182.7524591831236"
"6867","63285","63281","7","63288","99414","13883.804999999998","0.18048946499999996","1.4071765280625096E7","182.93294864812358"
"6868","63288","63284","1","63285","99415","13883.146875","0.180480909375","1.4085648427500095E7","183.1134295574986"
"6869","63285","63276","5","63281","99420","13882.269375","0.180469501875","1.4099530696875095E7","183.2938990593736"
"6870","63281","63275","5","63280","99425","13882.05","0.18046664999999998","1.4113412746875096E7","183.4743657093736"
"6871","63280","63278","5","63283","99430","13882.708125","0.18047520562499997","1.4127295455000097E7","183.65484091499857"
"6872","63283","63275","8","63283","99438","13882.708125","0.18047520562499997","1.4141178163125098E7","183.83531612062356"
"6873","63283","63278","6","63284","99444","13882.9275","0.18047805749999998","1.4155061090625098E7","184.01579417812357"
"6874","63284","63278","6","63284","99450","13882.9275","0.18047805749999998","1.4168944018125098E7","184.19627223562358"
"6875","63284","63278","6","63284","99456","13882.9275","0.18047805749999998","1.4182826945625098E7","184.3767502931236"
"6876","63284","63278","9","63287","99465","13883.585625","0.18048661312499997","1.4196710531250099E7","184.5572369062486"
"6877","63287","63280","4","63284","99469","13882.9275","0.18047805749999998","1.4210593458750099E7","184.7377149637486"
"6878","63284","63283","1","63284","99470","13882.9275","0.18047805749999998","1.42244763862501E7","184.9181930212486"
"6879","63284","63280","7","63287","99477","13883.585625","0.18048661312499997","1.42383599718751E7","185.0986796343736"
"6880","63287","63283","6","63289","99483","13884.024375","0.180492316875","1.4252243996250099E7","185.2791719512486"
"6881","63289","63282","1","63283","99484","13882.708125","0.18047520562499997","1.42661267043751E7","185.4596471568736"
"6882","63283","63274","2","63276","99486","13881.1725","0.1804552425","1.4280007876875099E7","185.64010239937357"
"6883","63276","63271","2","63273","99488","13880.514374999999","0.18044668687499998","1.4293888391250098E7","185.82054908624858"
"6884","63273","63269","9","63278","99497","13881.611249999996","0.18046094624999995","1.4307770002500098E7","186.00101003249858"
"6885","63278","63272","4","63276","99501","13881.1725","0.1804552425","1.4321651175000098E7","186.18146527499857"
"6886","63276","63269","3","63272","99504","13880.295","0.180443835","1.4335531470000098E7","186.36190910999858"
"6887","63272","63270","8","63278","99512","13881.611249999996","0.18046094624999995","1.4349413081250098E7","186.5423700562486"
"6888","63278","63270","2","63272","99514","13880.295","0.180443835","1.4363293376250098E7","186.7228138912486"
"6889","63272","63267","4","63271","99518","13880.075625000001","0.180440983125","1.4377173451875098E7","186.9032548743736"
"6890","63271","63269","8","63277","99526","13881.391875","0.180458094375","1.4391054843750099E7","187.0837129687486"
"6891","63277","63274","8","63282","99534","13882.488749999999","0.18047235374999998","1.4404937332500098E7","187.2641853224986"
"6892","63282","63280","8","63288","99542","13883.804999999998","0.18048946499999996","1.4418821137500098E7","187.4446747874986"
"6893","63288","63283","4","63287","99546","13883.585625","0.18048661312499997","1.4432704723125098E7","187.6251614006236"
"6894","63287","63281","5","63286","99551","13883.36625","0.18048376124999999","1.44465880893751E7","187.8056451618736"
"6895","63286","63284","9","63293","99560","13884.901875","0.18050372437499998","1.44604729912501E7","187.9861488862486"
"6896","63293","63290","4","63294","99564","13885.12125","0.18050657625","1.44743581125001E7","188.1666554624986"
"6897","63294","63293","7","63300","99571","13886.4375","0.1805236875","1.44882445500001E7","188.3471791499986"
"6898","63300","63295","2","63297","99573","13885.779375","0.18051513187499998","1.45021303293751E7","188.5276942818736"
"6899","63297","63294","4","63298","99577","13885.998749999999","0.18051798374999997","1.4516016328125099E7","188.70821226562362"
"6900","63298","63293","9","63302","99586","13886.87625","0.18052939124999998","1.45299032043751E7","188.8887416568736"
"6901","63302","63298","131","63429","99717","13914.736875","0.180891579375","1.4543817941250099E7","189.0696332362486"
"6902","63429","63423","1","63424","99718","13913.640000000001","0.18087732","1.45577315812501E7","189.2505105562486"
"6903","63424","63419","5","63424","99723","13913.640000000001","0.18087732","1.45716452212501E7","189.4313878762486"
"6904","63424","63415","4","63419","99727","13912.543125","0.180863060625","1.45855577643751E7","189.6122509368736"
"6905","63419","63416","6","63422","99733","13913.20125","0.18087161624999998","1.45994709656251E7","189.7931225531236"
"6906","63422","63418","9","63427","99742","13914.298125","0.18088587562499997","1.46133852637501E7","189.9740084287486"
"6907","63427","63425","2","63427","99744","13914.298125","0.18088587562499997","1.4627299561875101E7","190.15489430437358"
"6908","63427","63425","8","63433","99752","13915.614375","0.18090298687499998","1.4641215176250102E7","190.33579729124858"
"6909","63433","63432","1","63433","99753","13915.614375","0.18090298687499998","1.4655130790625103E7","190.51670027812358"
"6910","63433","63424","9","63433","99762","13915.614375","0.18090298687499998","1.4669046405000104E7","190.69760326499858"
"6911","63433","63432","2","63434","99764","13915.83375","0.18090583875","1.4682962238750104E7","190.87850910374857"
"6912","63434","63433","3","63436","99767","13916.2725","0.18091154249999997","1.4696878511250105E7","191.05942064624858"
"6913","63436","63433","2","63435","99769","13916.053125","0.180908690625","1.4710794564375104E7","191.24032933687357"
"6914","63435","63426","9","63435","99778","13916.053125","0.180908690625","1.4724710617500104E7","191.42123802749856"
"6915","63435","63430","1","63431","99779","13915.175625","0.18089728312499997","1.4738625793125104E7","191.60213531062357"
"6916","63431","63422","6","63428","99785","13914.517499999996","0.18088872749999993","1.4752540310625104E7","191.78302403812356"
"6917","63428","63420","2","63422","99787","13913.20125","0.18087161624999998","1.4766453511875104E7","191.96389565437354"
"6918","63422","63419","9","63428","99796","13914.517499999996","0.18088872749999993","1.4780368029375104E7","192.14478438187354"
"6919","63428","63425","7","63432","99803","13915.394999999999","0.18090013499999996","1.4794283424375104E7","192.32568451687354"
"6920","63432","63423","8","63431","99811","13915.175625","0.18089728312499997","1.4808198600000104E7","192.50658179999854"
"6921","63431","63423","8","63431","99819","13915.175625","0.18089728312499997","1.4822113775625104E7","192.68747908312355"
"6922","63431","63428","9","63437","99828","13916.491875","0.18091439437499998","1.4836030267500104E7","192.86839347749856"
"6923","63437","63430","4","63434","99832","13915.83375","0.18090583875","1.4849946101250105E7","193.04929931624855"
"6924","63434","63430","9","63439","99841","13916.930625","0.180920098125","1.4863863031875104E7","193.23021941437355"
"6925","63439","63438","6","63444","99847","13918.0275","0.1809343575","1.4877781059375104E7","193.41115377187356"
"6926","63444","63437","8","63445","99855","13918.246875","0.180937209375","1.4891699306250103E7","193.59209098124856"
"6927","63445","63438","1","63439","99856","13916.930625","0.180920098125","1.4905616236875102E7","193.77301107937356"
"6928","63439","63436","8","63444","99864","13918.0275","0.1809343575","1.4919534264375102E7","193.95394543687357"
"6929","63444","63435","3","63438","99867","13916.711249999998","0.18091724624999997","1.4933450975625101E7","194.13486268312357"
"6930","63438","63432","8","63440","99875","13917.15","0.18092294999999997","1.4947368125625102E7","194.31578563312357"
"6931","63440","63437","5","63442","99880","13917.588749999999","0.18092865374999997","1.4961285714375101E7","194.49671428687356"
"6932","63442","63433","2","63435","99882","13916.053125","0.180908690625","1.49752017675001E7","194.67762297749854"
"6933","63435","63434","7","63441","99889","13917.369375000002","0.18092580187500001","1.49891191368751E7","194.85854877937354"
"6934","63441","63436","5","63441","99894","13917.369375000002","0.18092580187500001","1.50030365062501E7","195.03947458124853"
"6935","63441","63436","6","63442","99900","13917.588749999999","0.18092865374999997","1.50169540950001E7","195.2204032349985"
"6936","63442","63435","9","63444","99909","13918.0275","0.1809343575","1.50308721225001E7","195.40133759249852"
"6937","63444","63441","1","63442","99910","13917.588749999999","0.18092865374999997","1.5044789711250098E7","195.5822662462485"
"6938","63442","63438","3","63441","99913","13917.369375000002","0.18092580187500001","1.5058707080625098E7","195.7631920481235"
"6939","63441","63440","5","63445","99918","13918.246875","0.180937209375","1.5072625327500097E7","195.9441292574985"
"6940","63445","63438","3","63441","99921","13917.369375000002","0.18092580187500001","1.5086542696875097E7","196.1250550593735"
"6941","63441","63440","5","63445","99926","13918.246875","0.180937209375","1.5100460943750096E7","196.3059922687485"
"6942","63445","63439","1","63440","99927","13917.15","0.18092294999999997","1.5114378093750097E7","196.4869152187485"
"6943","63440","63437","4","63441","99931","13917.369375000002","0.18092580187500001","1.5128295463125097E7","196.66784102062348"
"6944","63441","63438","1","63439","99932","13916.930625","0.180920098125","1.5142212393750096E7","196.84876111874848"
"6945","63439","63436","1","63437","99933","13916.491875","0.18091439437499998","1.5156128885625096E7","197.0296755131235"
"6946","63437","63435","9","63444","99942","13918.0275","0.1809343575","1.5170046913125096E7","197.2106098706235"
"6947","63444","63439","3","63442","99945","13917.588749999999","0.18092865374999997","1.5183964501875095E7","197.3915385243735"
"6948","63442","63435","6","63441","99951","13917.369375000002","0.18092580187500001","1.5197881871250095E7","197.57246432624848"
"6949","63441","63435","7","63442","99958","13917.588749999999","0.18092865374999997","1.5211799460000094E7","197.75339297999847"
"6950","63442","63439","9","63448","99967","13918.904999999999","0.18094576499999998","1.5225718365000093E7","197.93433874499846"
"6951","63448","63441","5","63446","99972","13918.466250000001","0.18094006125","1.5239636831250094E7","198.11527880624845"
"6952","63446","63441","2","63443","99974","13917.808125","0.180931505625","1.5253554639375094E7","198.29621031187347"
"6953","63443","63435","5","63440","99979","13917.15","0.18092294999999997","1.5267471789375095E7","198.47713326187346"
"6954","63440","63431","1","63432","99980","13915.394999999999","0.18090013499999996","1.5281387184375094E7","198.65803339687346"
"6955","63432","63428","4","63432","99984","13915.394999999999","0.18090013499999996","1.5295302579375094E7","198.83893353187347"
"6956","63432","63430","9","63439","99993","13916.930625","0.180920098125","1.5309219510000093E7","199.01985362999847"
"6957","63439","63430","7","63437","100000","13916.491875","0.18091439437499998","1.5323136001875093E7","199.20076802437347"
"6958","63437","63434","6","63440","100006","13917.15","0.18092294999999997","1.5337053151875094E7","199.38169097437347"
"6959","63440","63438","6","63444","100012","13918.0275","0.1809343575","1.5350971179375093E7","199.56262533187348"
"6960","63444","63439","8","63447","100020","13918.685625","0.180942913125","1.5364889865000093E7","199.74356824499847"
"6961","63447","63445","325","63770","100345","13989.54375","0.18186406875","1.5378879408750093E7","199.92543231374847"
"6962","63770","63762","5","63767","100350","13988.885624999999","0.18185551312499998","1.5392868294375092E7","200.10728782687346"
"6963","63767","63760","2","63762","100352","13987.78875","0.18184125375","1.5406856083125092E7","200.28912908062347"
"6964","63762","63757","7","63764","100359","13988.2275","0.1818469575","1.5420844310625091E7","200.47097603812347"
"6965","63764","63755","9","63764","100368","13988.2275","0.1818469575","1.543483253812509E7","200.65282299562347"
"6966","63764","63761","2","63763","100370","13988.008124999998","0.18184410562499997","1.544882054625009E7","200.83466710124847"
"6967","63763","63760","4","63764","100374","13988.2275","0.1818469575","1.546280877375009E7","201.01651405874847"
"6968","63764","63763","4","63767","100378","13988.885624999999","0.18185551312499998","1.5476797659375088E7","201.19836957187346"
"6969","63767","63765","9","63774","100387","13990.421250000001","0.18187547625","1.5490788080625089E7","201.38024504812347"
"6970","63774","63771","2","63773","100389","13990.201874999999","0.18187262437499999","1.5504778282500088E7","201.56211767249846"
"6971","63773","63771","3","63774","100392","13990.421250000001","0.18187547625","1.5518768703750089E7","201.74399314874847"
"6972","63774","63773","6","63779","100398","13991.518125","0.181889735625","1.5532760221875088E7","201.92588288437346"
"6973","63779","63772","7","63779","100405","13991.518125","0.181889735625","1.5546751740000088E7","202.10777261999846"
"6974","63779","63774","2","63776","100407","13990.86","0.18188118","1.5560742600000087E7","202.28965379999846"
"6975","63776","63775","3","63778","100410","13991.298749999996","0.18188688374999995","1.5574733898750087E7","202.47154068374846"
"6976","63778","63775","6","63781","100416","13991.956875","0.181895439375","1.5588725855625087E7","202.65343612312347"
"6977","63781","63779","9","63788","100425","13993.492499999998","0.18191540249999996","1.5602719348125087E7","202.83535152562348"
"6978","63788","63785","8","63793","100433","13994.589375","0.18192966187499998","1.5616713937500088E7","203.01728118749847"
"6979","63793","63784","1","63785","100434","13992.834375","0.181906846875","1.5630706771875087E7","203.19918803437346"
"6980","63785","63780","1","63781","100435","13991.956875","0.181895439375","1.5644698728750087E7","203.38108347374848"
"6981","63781","63779","3","63782","100438","13992.176249999999","0.18189829124999998","1.5658690905000087E7","203.56298176499848"
"6982","63782","63780","4","63784","100442","13992.615","0.18190399499999999","1.5672683520000087E7","203.74488575999848"
"6983","63784","63783","5","63788","100447","13993.492499999998","0.18191540249999996","1.5686677012500087E7","203.9268011624985"
"6984","63788","63785","8","63793","100455","13994.589375","0.18192966187499998","1.5700671601875087E7","204.10873082437348"
"6985","63793","63788","6","63794","100461","13994.80875","0.18193251375","1.5714666410625087E7","204.2906633381235"
"6986","63794","63791","4","63795","100465","13995.028125","0.181935365625","1.5728661438750086E7","204.4725987037485"
"6987","63795","63792","7","63799","100472","13995.905625000001","0.18194677312500002","1.5742657344375087E7","204.6545454768735"
"6988","63799","63796","1","63797","100473","13995.466875","0.181941069375","1.5756652811250087E7","204.8364865462485"
"6989","63797","63794","4","63798","100477","13995.686249999999","0.18194392124999997","1.5770648497500086E7","205.0184304674985"
"6990","63798","63792","5","63797","100482","13995.466875","0.181941069375","1.5784643964375086E7","205.2003715368735"
"6991","63797","63796","4","63800","100486","13996.125","0.18194962499999998","1.5798640089375086E7","205.38232116187348"
"6992","63800","63799","2","63801","100488","13996.344375","0.181952476875","1.5812636433750086E7","205.5642736387485"
"6993","63801","63798","3","63801","100491","13996.344375","0.181952476875","1.5826632778125085E7","205.7462261156235"
"6994","63801","63798","2","63800","100493","13996.125","0.18194962499999998","1.5840628903125085E7","205.9281757406235"
"6995","63800","63796","3","63799","100496","13995.905625000001","0.18194677312500002","1.5854624808750086E7","206.11012251374848"
"6996","63799","63795","5","63800","100501","13996.125","0.18194962499999998","1.5868620933750086E7","206.29207213874847"
"6997","63800","63794","8","63802","100509","13996.56375","0.18195532874999998","1.5882617497500086E7","206.47402746749847"
"6998","63802","63797","2","63799","100511","13995.905625000001","0.18194677312500002","1.5896613403125087E7","206.65597424062346"
"6999","63799","63795","4","63799","100515","13995.905625000001","0.18194677312500002","1.5910609308750087E7","206.83792101374846"
"7000","63799","63796","2","63798","100517","13995.686249999999","0.18194392124999997","1.5924604995000087E7","207.01986493499845"
"7001","63798","63794","8","63802","100525","13996.56375","0.18195532874999998","1.5938601558750087E7","207.20182026374846"
"7002","63802","63796","9","63805","100534","13997.221875","0.18196388437499997","1.5952598780625088E7","207.38378414812345"
"7003","63805","63798","2","63800","100536","13996.125","0.18194962499999998","1.5966594905625088E7","207.56573377312344"
"7004","63800","63796","4","63800","100540","13996.125","0.18194962499999998","1.5980591030625088E7","207.74768339812343"
"7005","63800","63797","2","63799","100542","13995.905625000001","0.18194677312500002","1.5994586936250089E7","207.92963017124842"
"7006","63799","63790","6","63796","100548","13995.247500000001","0.1819382175","1.600858218375009E7","208.11156838874842"
"7007","63796","63788","7","63795","100555","13995.028125","0.181935365625","1.6022577211875089E7","208.29350375437343"
"7008","63795","63788","2","63790","100557","13993.93125","0.18192110625","1.6036571143125089E7","208.47542486062343"
"7009","63790","63785","3","63788","100560","13993.492499999998","0.18191540249999996","1.6050564635625089E7","208.65734026312344"
"7010","63788","63782","5","63787","100565","13993.273125","0.18191255062499997","1.6064557908750089E7","208.83925281374843"
"7011","63787","63782","4","63786","100569","13993.05375","0.18190969875","1.607855096250009E7","209.02116251249842"
"7012","63786","63785","7","63792","100576","13994.369999999999","0.18192680999999997","1.6092545332500089E7","209.2030893224984"
"7013","63792","63790","5","63795","100581","13995.028125","0.181935365625","1.6106540360625088E7","209.38502468812342"
"7014","63795","63794","1","63795","100582","13995.028125","0.181935365625","1.6120535388750087E7","209.56696005374843"
"7015","63795","63789","8","63797","100590","13995.466875","0.181941069375","1.6134530855625087E7","209.74890112312343"
"7016","63797","63791","9","63800","100599","13996.125","0.18194962499999998","1.6148526980625087E7","209.93085074812342"
"7017","63800","63799","1","63800","100600","13996.125","0.18194962499999998","1.6162523105625087E7","210.1128003731234"
"7018","63800","63791","1","63792","100601","13994.369999999999","0.18192680999999997","1.6176517475625087E7","210.2947271831234"
"7019","63792","63790","3","63793","100604","13994.589375","0.18192966187499998","1.6190512065000087E7","210.4766568449984"
"7020","63793","63788","8","63796","100612","13995.247500000001","0.1819382175","1.6204507312500088E7","210.6585950624984"
"7021","63796","63795","138","63933","100750","14025.301875","0.18232892437499998","1.6218532614375088E7","210.8409239868734"
"7022","63933","63931","5","63936","100755","14025.96","0.18233747999999997","1.623255857437509E7","211.0232614668734"
"7023","63936","63931","9","63940","100764","14026.8375","0.18234888749999997","1.624658541187509E7","211.20561035437342"
"7024","63940","63939","6","63945","100770","14027.934375","0.182363146875","1.6260613346250089E7","211.3879735012484"
"7025","63945","63936","3","63939","100773","14026.618125","0.182346035625","1.6274639964375088E7","211.5703195368734"
"7026","63939","63930","9","63939","100782","14026.618125","0.182346035625","1.6288666582500087E7","211.7526655724984"
"7027","63939","63930","8","63938","100790","14026.398749999998","0.18234318374999997","1.6302692981250087E7","211.93500875624838"
"7028","63938","63933","5","63938","100795","14026.398749999998","0.18234318374999997","1.6316719380000087E7","212.11735193999837"
"7029","63938","63933","9","63942","100804","14027.276249999999","0.18235459124999998","1.6330746656250086E7","212.29970653124838"
"7030","63942","63940","9","63949","100813","14028.811875000001","0.182374554375","1.6344775468125086E7","212.48208108562338"
"7031","63949","63944","2","63946","100815","14028.153750000001","0.18236599875","1.6358803621875087E7","212.66444708437336"
"7032","63946","63941","3","63944","100818","14027.715","0.18236029499999998","1.6372831336875087E7","212.84680737937336"
"7033","63944","63942","2","63944","100820","14027.715","0.18236029499999998","1.6386859051875087E7","213.02916767437335"
"7034","63944","63935","8","63943","100828","14027.495625","0.182357443125","1.6400886547500087E7","213.21152511749835"
"7035","63943","63934","7","63941","100835","14027.056875000002","0.18235173937500002","1.6414913604375087E7","213.39387685687336"
"7036","63941","63932","7","63939","100842","14026.618125","0.182346035625","1.6428940222500086E7","213.57622289249835"
"7037","63939","63930","2","63932","100844","14025.082499999999","0.18232607249999996","1.6442965305000085E7","213.75854896499834"
"7038","63932","63924","8","63932","100852","14025.082499999999","0.18232607249999996","1.6456990387500085E7","213.94087503749833"
"7039","63932","63926","5","63931","100857","14024.863125","0.18232322062499998","1.6471015250625085E7","214.12319825812332"
"7040","63931","63923","9","63932","100866","14025.082499999999","0.18232607249999996","1.6485040333125085E7","214.3055243306233"
"7041","63932","63927","9","63936","100875","14025.96","0.18233747999999997","1.6499066293125086E7","214.48786181062331"
"7042","63936","63935","5","63940","100880","14026.8375","0.18234888749999997","1.6513093130625086E7","214.67021069812333"
"7043","63940","63936","1","63937","100881","14026.179375","0.18234033187499998","1.6527119310000086E7","214.85255102999832"
"7044","63937","63928","2","63930","100883","14024.64375","0.18232036875","1.6541143953750087E7","215.03487139874832"
"7045","63930","63923","8","63931","100891","14024.863125","0.18232322062499998","1.6555168816875087E7","215.21719461937332"
"7046","63931","63927","3","63930","100894","14024.64375","0.18232036875","1.6569193460625088E7","215.39951498812331"
"7047","63930","63923","1","63924","100895","14023.327500000001","0.1823032575","1.6583216788125088E7","215.5818182456233"
"7048","63924","63915","9","63924","100904","14023.327500000001","0.1823032575","1.6597240115625089E7","215.7641215031233"
"7049","63924","63917","4","63921","100908","14022.669375000001","0.182294701875","1.661126278500009E7","215.94641620499831"
"7050","63921","63920","5","63925","100913","14023.546875","0.182306109375","1.662528633187509E7","216.1287223143733"
"7051","63925","63916","6","63922","100919","14022.88875","0.18229755374999998","1.663930922062509E7","216.3110198681233"
"7052","63922","63918","9","63927","100928","14023.985625","0.18231181312499997","1.665333320625009E7","216.49333168124832"
"7053","63927","63922","5","63927","100933","14023.985625","0.18231181312499997","1.666735719187509E7","216.67564349437333"
"7054","63927","63923","2","63925","100935","14023.546875","0.182306109375","1.668138073875009E7","216.85794960374832"
"7055","63925","63920","7","63927","100942","14023.985625","0.18231181312499997","1.6695404724375091E7","217.04026141687334"
"7056","63927","63926","9","63935","100951","14025.740625","0.18233462812499998","1.6709430465000091E7","217.22259604499834"
"7057","63935","63933","2","63935","100953","14025.740625","0.18233462812499998","1.672345620562509E7","217.40493067312335"
"7058","63935","63934","8","63942","100961","14027.276249999999","0.18235459124999998","1.673748348187509E7","217.58728526437335"
"7059","63942","63937","8","63945","100969","14027.934375","0.182363146875","1.675151141625009E7","217.76964841124834"
"7060","63945","63942","2","63944","100971","14027.715","0.18236029499999998","1.6765539131250089E7","217.95200870624834"
"7061","63944","63936","3","63939","100974","14026.618125","0.182346035625","1.677956574937509E7","218.13435474187332"
"7062","63939","63935","9","63944","100983","14027.715","0.18236029499999998","1.679359346437509E7","218.31671503687332"
"7063","63944","63936","8","63944","100991","14027.715","0.18236029499999998","1.680762117937509E7","218.4990753318733"
"7064","63944","63943","3","63946","100994","14028.153750000001","0.18236599875","1.682164933312509E7","218.6814413306233"
"7065","63946","63941","2","63943","100996","14027.495625","0.182357443125","1.683567682875009E7","218.8637987737483"
"7066","63943","63937","8","63945","101004","14027.934375","0.182363146875","1.6849704763125088E7","219.0461619206233"
"7067","63945","63944","5","63949","101009","14028.811875000001","0.182374554375","1.686373357500009E7","219.2285364749983"
"7068","63949","63945","7","63952","101016","14029.47","0.18238311","1.6877763045000087E7","219.41091958499828"
"7069","63952","63948","1","63949","101017","14028.811875000001","0.182374554375","1.6891791856875088E7","219.59329413937328"
"7070","63949","63948","1","63949","101018","14028.811875000001","0.182374554375","1.690582066875009E7","219.7756686937483"
"7071","63949","63946","8","63954","101026","14029.90875","0.18238881375","1.691985057750009E7","219.9580575074983"
"7072","63954","63946","4","63950","101030","14029.03125","0.18237740624999998","1.693387960875009E7","220.1404349137483"
"7073","63950","63944","6","63950","101036","14029.03125","0.18237740624999998","1.694790864000009E7","220.3228123199983"
"7074","63950","63948","1","63949","101037","14028.811875000001","0.182374554375","1.696193745187509E7","220.5051868743733"
"7075","63949","63943","9","63952","101046","14029.47","0.18238311","1.697596692187509E7","220.68756998437328"
"7076","63952","63948","3","63951","101049","14029.250625","0.182380258125","1.698999617250009E7","220.86995024249828"
"7077","63951","63945","8","63953","101057","14029.689374999996","0.18238596187499995","1.7004025861875087E7","221.0523362043733"
"7078","63953","63947","8","63955","101065","14030.128125","0.18239166562499998","1.7018055990000088E7","221.2347278699983"
"7079","63955","63946","5","63951","101070","14029.250625","0.182380258125","1.7032085240625087E7","221.4171081281233"
"7080","63951","63944","5","63949","101075","14028.811875000001","0.182374554375","1.7046114052500088E7","221.5994826824983"
"7081","63949","63946","371","64317","101446","14109.541874999999","0.18342404437499998","1.706022359437509E7","221.78290672687328"
"7082","64317","64314","9","64323","101455","14110.858124999999","0.18344115562499996","1.707433445250009E7","221.96634788249827"
"7083","64323","64322","8","64330","101463","14112.39375","0.18346111874999999","1.708844684625009E7","222.14980900124826"
"7084","64330","64325","7","64332","101470","14112.832499999999","0.18346682249999996","1.710255967875009E7","222.33327582374827"
"7085","64332","64325","4","64329","101474","14112.174375","0.183458266875","1.711667185312509E7","222.51673409062326"
"7086","64329","64321","7","64328","101481","14111.954999999996","0.18345541499999993","1.713078380812509E7","222.70018950562326"
"7087","64328","64324","7","64331","101488","14112.613125","0.183463970625","1.714489642125009E7","222.88365347624827"
"7088","64331","64328","9","64337","101497","14113.929375","0.18348108187499998","1.715901035062509E7","223.06713455812326"
"7089","64337","64335","7","64342","101504","14115.026249999999","0.18349534124999997","1.717312537687509E7","223.25062989937325"
"7090","64342","64334","2","64336","101506","14113.71","0.18347822999999996","1.7187239086875092E7","223.43410812937324"
"7091","64336","64327","4","64331","101510","14112.613125","0.183463970625","1.7201351700000092E7","223.61757209999826"
"7092","64331","64322","5","64327","101515","14111.735625","0.18345256312499997","1.721546343562509E7","223.80102466312326"
"7093","64327","64318","2","64320","101517","14110.2","0.1834326","1.722957363562509E7","223.98445726312326"
"7094","64320","64312","8","64320","101525","14110.2","0.1834326","1.724368383562509E7","224.16788986312326"
"7095","64320","64316","4","64320","101529","14110.2","0.1834326","1.725779403562509E7","224.35132246312327"
"7096","64320","64317","8","64325","101537","14111.296875","0.183446859375","1.727190533250009E7","224.53476932249828"
"7097","64325","64323","4","64327","101541","14111.735625","0.18345256312499997","1.7286017068125088E7","224.71822188562328"
"7098","64327","64323","4","64327","101545","14111.735625","0.18345256312499997","1.7300128803750087E7","224.90167444874828"
"7099","64327","64320","4","64324","101549","14111.077500000001","0.1834440075","1.7314239881250087E7","225.08511845624827"
"7100","64324","64320","3","64323","101552","14110.858124999999","0.18344115562499996","1.732835073937509E7","225.26855961187326"
"7101","64323","64316","7","64323","101559","14110.858124999999","0.18344115562499996","1.734246159750009E7","225.45200076749825"
"7102","64323","64315","9","64324","101568","14111.077500000001","0.1834440075","1.735657267500009E7","225.63544477499823"
"7103","64324","64315","7","64322","101575","14110.63875","0.18343830374999998","1.7370683313750092E7","225.81888307874823"
"7104","64322","64317","7","64324","101582","14111.077500000001","0.1834440075","1.7384794391250093E7","226.00232708624821"
"7105","64324","64323","7","64330","101589","14112.39375","0.18346111874999999","1.7398906785000093E7","226.1857882049982"
"7106","64330","64327","2","64329","101591","14112.174375","0.183458266875","1.7413018959375095E7","226.3692464718732"
"7107","64329","64320","9","64329","101600","14112.174375","0.183458266875","1.7427131133750096E7","226.5527047387482"
"7108","64329","64320","4","64324","101604","14111.077500000001","0.1834440075","1.7441242211250097E7","226.73614874624818"
"7109","64324","64316","2","64318","101606","14109.76125","0.18342689624999997","1.7455351972500097E7","226.9195756424982"
"7110","64318","64316","5","64321","101611","14110.419375000001","0.18343545187500002","1.7469462391875096E7","227.1030110943732"
"7111","64321","64313","5","64318","101616","14109.76125","0.18342689624999997","1.7483572153125096E7","227.2864379906232"
"7112","64318","64310","7","64317","101623","14109.541874999999","0.18342404437499998","1.7497681695000097E7","227.4698620349982"
"7113","64317","64310","5","64315","101628","14109.103125","0.18341834062499998","1.7511790798125096E7","227.65328037562318"
"7114","64315","64314","5","64319","101633","14109.980625","0.183429748125","1.7525900778750096E7","227.8367101237482"
"7115","64319","64315","4","64319","101637","14109.980625","0.183429748125","1.7540010759375095E7","228.0201398718732"
"7116","64319","64316","2","64318","101639","14109.76125","0.18342689624999997","1.7554120520625096E7","228.2035667681232"
"7117","64318","64315","2","64317","101641","14109.541874999999","0.18342404437499998","1.7568230062500097E7","228.3869908124982"
"7118","64317","64316","6","64322","101647","14110.63875","0.18343830374999998","1.75823407012501E7","228.5704291162482"
"7119","64322","64315","5","64320","101652","14110.2","0.1834326","1.7596450901250098E7","228.7538617162482"
"7120","64320","64317","4","64321","101656","14110.419375000001","0.18343545187500002","1.7610561320625097E7","228.9372971681232"
"7121","64321","64320","7","64327","101663","14111.735625","0.18345256312499997","1.7624673056250095E7","229.1207497312482"
"7122","64327","64320","9","64329","101672","14112.174375","0.183458266875","1.7638785230625097E7","229.3042079981232"
"7123","64329","64326","1","64327","101673","14111.735625","0.18345256312499997","1.7652896966250096E7","229.4876605612482"
"7124","64327","64319","8","64327","101681","14111.735625","0.18345256312499997","1.7667008701875094E7","229.6711131243732"
"7125","64327","64324","8","64332","101689","14112.832499999999","0.18346682249999996","1.7681121534375094E7","229.8545799468732"
"7126","64332","64328","4","64332","101693","14112.832499999999","0.18346682249999996","1.7695234366875093E7","230.0380467693732"
"7127","64332","64326","9","64335","101702","14113.490625","0.183475378125","1.7709347857500095E7","230.2215221474982"
"7128","64335","64326","1","64327","101703","14111.735625","0.18345256312499997","1.7723459593125094E7","230.4049747106232"
"7129","64327","64323","6","64329","101709","14112.174375","0.183458266875","1.7737571767500095E7","230.5884329774982"
"7130","64329","64326","8","64334","101717","14113.27125","0.18347252625","1.7751685038750093E7","230.7719055037482"
"7131","64334","64333","2","64335","101719","14113.490625","0.183475378125","1.7765798529375095E7","230.9553808818732"
"7132","64335","64331","1","64332","101720","14112.832499999999","0.18346682249999996","1.7779911361875094E7","231.1388477043732"
"7133","64332","64330","4","64334","101724","14113.27125","0.18347252625","1.7794024633125093E7","231.3223202306232"
"7134","64334","64331","9","64340","101733","14114.5875","0.1834896375","1.780813922062509E7","231.5058098681232"
"7135","64340","64335","4","64339","101737","14114.368125","0.183486785625","1.782225358875009E7","231.68929665374822"
"7136","64339","64334","6","64340","101743","14114.5875","0.1834896375","1.783636817625009E7","231.87278629124822"
"7137","64340","64332","2","64334","101745","14113.27125","0.18347252625","1.7850481447500087E7","232.05625881749822"
"7138","64334","64333","2","64335","101747","14113.490625","0.183475378125","1.786459493812509E7","232.2397341956232"
"7139","64335","64329","8","64337","101755","14113.929375","0.18348108187499998","1.787870886750009E7","232.4232152774982"
"7140","64337","64329","8","64337","101763","14113.929375","0.18348108187499998","1.789282279687509E7","232.6066963593732"
"7141","64337","64334","367","64701","102130","14193.781875","0.184519164375","1.790701657875009E7","232.79121552374818"
"7142","64701","64699","5","64704","102135","14194.44","0.18452772","1.792121101875009E7","232.97574324374818"
"7143","64704","64698","3","64701","102138","14193.781875","0.184519164375","1.793540480062509E7","233.16026240812317"
"7144","64701","64699","1","64700","102139","14193.5625","0.1845163125","1.794959836312509E7","233.34477872062317"
"7145","64700","64698","7","64705","102146","14194.659375","0.18453057187499997","1.796379302250009E7","233.52930929249817"
"7146","64705","64701","2","64703","102148","14194.220624999996","0.18452486812499994","1.797798724312509E7","233.71383416062318"
"7147","64703","64698","6","64704","102154","14194.44","0.18452772","1.799218168312509E7","233.89836188062318"
"7148","64704","64698","6","64704","102160","14194.44","0.18452772","1.800637612312509E7","234.0828896006232"
"7149","64704","64702","4","64706","102164","14194.87875","0.18453342374999998","1.802057100187509E7","234.2674230243732"
"7150","64706","64697","7","64704","102171","14194.44","0.18452772","1.8034765441875093E7","234.4519507443732"
"7151","64704","64700","9","64709","102180","14195.536875","0.184541979375","1.804896097875009E7","234.6364927237482"
"7152","64709","64701","6","64707","102186","14195.098124999999","0.18453627562499997","1.806315607687509E7","234.8210289993732"
"7153","64707","64702","1","64703","102187","14194.220624999996","0.18452486812499994","1.807735029750009E7","235.0055538674982"
"7154","64703","64695","8","64703","102195","14194.220624999996","0.18452486812499994","1.8091544518125087E7","235.19007873562322"
"7155","64703","64702","8","64710","102203","14195.75625","0.18454483124999999","1.810574027437509E7","235.37462356687323"
"7156","64710","64704","3","64707","102206","14195.098124999999","0.18453627562499997","1.8119935372500088E7","235.55915984249822"
"7157","64707","64699","1","64700","102207","14193.5625","0.1845163125","1.8134128935000088E7","235.7436761549982"
"7158","64700","64692","9","64701","102216","14193.781875","0.184519164375","1.8148322716875087E7","235.9281953193732"
"7159","64701","64692","7","64699","102223","14193.343125000001","0.18451346062500001","1.8162516060000088E7","236.1127087799982"
"7160","64699","64691","4","64695","102227","14192.465625","0.184502053125","1.8176708525625087E7","236.2972108331232"
"7161","64695","64686","9","64695","102236","14192.465625","0.184502053125","1.8190900991250087E7","236.48171288624818"
"7162","64695","64686","2","64688","102238","14190.929999999998","0.18448208999999996","1.8205091921250086E7","236.66619497624816"
"7163","64688","64685","1","64686","102239","14190.49125","0.18447638624999999","1.8219282412500087E7","236.85067136249816"
"7164","64686","64679","2","64681","102241","14189.394375","0.184462126875","1.8233471806875087E7","237.03513348937315"
"7165","64681","64673","5","64678","102246","14188.736249999996","0.18445357124999995","1.8247660543125086E7","237.21958706062316"
"7166","64678","64671","6","64677","102252","14188.516875","0.184450719375","1.8261849060000084E7","237.40403777999816"
"7167","64677","64671","1","64672","102253","14187.42","0.18443646","1.8276036480000086E7","237.58847423999816"
"7168","64672","64668","6","64674","102259","14187.858750000001","0.18444216375","1.8290224338750087E7","237.77291640374816"
"7169","64674","64673","8","64681","102267","14189.394375","0.184462126875","1.8304413733125087E7","237.95737853062315"
"7170","64681","64679","7","64686","102274","14190.49125","0.18447638624999999","1.8318604224375088E7","238.14185491687314"
"7171","64686","64679","6","64685","102280","14190.271875","0.184473534375","1.833279449625009E7","238.32632845124814"
"7172","64685","64677","5","64682","102285","14189.613749999999","0.18446497874999998","1.834698411000009E7","238.51079342999813"
"7173","64682","64673","4","64677","102289","14188.516875","0.184450719375","1.8361172626875088E7","238.69524414937314"
"7174","64677","64673","4","64677","102293","14188.516875","0.184450719375","1.8375361143750086E7","238.87969486874815"
"7175","64677","64674","6","64680","102299","14189.175","0.18445927499999998","1.8389550318750087E7","239.06415414374814"
"7176","64680","64672","8","64680","102307","14189.175","0.18445927499999998","1.8403739493750088E7","239.24861341874814"
"7177","64680","64674","1","64675","102308","14188.078125","0.184445015625","1.8417927571875088E7","239.43305843437312"
"7178","64675","64672","5","64677","102313","14188.516875","0.184450719375","1.8432116088750087E7","239.61750915374813"
"7179","64677","64671","5","64676","102318","14188.2975","0.1844478675","1.8446304386250086E7","239.80195702124814"
"7180","64676","64669","7","64676","102325","14188.2975","0.1844478675","1.8460492683750086E7","239.98640488874815"
"7181","64676","64670","9","64679","102334","14188.955625","0.184456423125","1.8474681639375087E7","240.17086131187315"
"7182","64679","64670","8","64678","102342","14188.736249999996","0.18445357124999995","1.8488870375625085E7","240.35531488312316"
"7183","64678","64677","6","64683","102348","14189.833125","0.18446783062499997","1.8503060208750084E7","240.53978271374817"
"7184","64683","64680","3","64683","102351","14189.833125","0.18446783062499997","1.8517250041875083E7","240.72425054437318"
"7185","64683","64676","5","64681","102356","14189.394375","0.184462126875","1.8531439436250083E7","240.90871267124817"
"7186","64681","64679","5","64684","102361","14190.0525","0.18447068249999998","1.854562948875008E7","241.09318335374817"
"7187","64684","64681","9","64690","102370","14191.36875","0.18448779375","1.855982085750008E7","241.27767114749818"
"7188","64690","64682","8","64690","102378","14191.36875","0.18448779375","1.857401222625008E7","241.4621589412482"
"7189","64690","64681","9","64690","102387","14191.36875","0.18448779375","1.8588203595000077E7","241.6466467349982"
"7190","64690","64684","8","64692","102395","14191.807499999999","0.18449349749999996","1.8602395402500078E7","241.8311402324982"
"7191","64692","64688","3","64691","102398","14191.588125000002","0.184490645625","1.861658699062508E7","242.0156308781232"
"7192","64691","64685","3","64688","102401","14190.929999999998","0.18448208999999996","1.863077792062508E7","242.2001129681232"
"7193","64688","64679","5","64684","102406","14190.0525","0.18447068249999998","1.8644967973125078E7","242.3845836506232"
"7194","64684","64683","2","64685","102408","14190.271875","0.184473534375","1.865915824500008E7","242.5690571849982"
"7195","64685","64676","8","64684","102416","14190.0525","0.18447068249999998","1.8673348297500078E7","242.7535278674982"
"7196","64684","64678","8","64686","102424","14190.49125","0.18447638624999999","1.868753878875008E7","242.9380042537482"
"7197","64686","64685","8","64693","102432","14192.026875","0.18449634937499998","1.870173081562508E7","243.1225006031232"
"7198","64693","64688","3","64691","102435","14191.588125000002","0.184490645625","1.871592240375008E7","243.3069912487482"
"7199","64691","64688","5","64693","102440","14192.026875","0.18449634937499998","1.873011443062508E7","243.4914875981232"
"7200","64693","64690","3","64693","102443","14192.026875","0.18449634937499998","1.874430645750008E7","243.6759839474982"
"7201","64693","64689","450","65139","102893","14289.868125","0.185768285625","1.875859632562508E7","243.86175223312318"
"7202","65139","5139","0","5139","102893","1127.368125","0.014655785624999999","1.875972369375008E7","243.87640801874818"
"7203","5139","5139","10000","15139","112893","3321.118125","0.043174535624999996","1.876304481187508E7","243.9195825543732"
"7204","15139","15138","8","15146","112901","3322.65375","0.04319449875","1.8766367465625077E7","243.9627770531232"
"7205","15146","15145","3","15148","112904","3323.0924999999997","0.04320020249999999","1.876969055812508E7","244.0059772556232"
"7206","15148","15146","8","15154","112912","3324.4087500000005","0.04321731375000001","1.877301496687508E7","244.0491945693732"
"7207","15154","15148","9","15157","112921","3325.066874999999","0.04322586937499998","1.877634003375008E7","244.0924204387482"
"7208","15157","15153","6","15159","112927","3325.505625","0.04323157312499999","1.8779665539375078E7","244.13565201187322"
"7209","15159","15155","3","15158","112930","3325.2862499999997","0.04322872124999999","1.8782990825625077E7","244.1788807331232"
"7210","15158","15153","8","15161","112938","3325.944375","0.043237276875","1.8786316770000078E7","244.2221180099982"
"7211","15161","15157","7","15164","112945","3326.6025","0.0432458325","1.8789643372500077E7","244.2653638424982"
"7212","15164","15158","2","15160","112947","3325.725","0.04323442499999999","1.879296909750008E7","244.3085982674982"
"7213","15160","15153","6","15159","112953","3325.505625","0.04323157312499999","1.8796294603125077E7","244.35182984062322"
"7214","15159","15158","6","15164","112959","3326.6025","0.0432458325","1.8799621205625076E7","244.39507567312322"
"7215","15164","15163","2","15165","112961","3326.821875","0.043248684375","1.8802948027500074E7","244.4383243574982"
"7216","15165","15163","7","15170","112968","3327.91875","0.04326294375","1.8806275946250074E7","244.4815873012482"
"7217","15170","15165","1","15166","112969","3327.04125","0.04325153625","1.8809602987500075E7","244.5248388374982"
"7218","15166","15161","7","15168","112976","3327.48","0.043257239999999995","1.8812930467500076E7","244.5680960774982"
"7219","15168","15161","6","15167","112982","3327.260625","0.043254388124999994","1.8816257728125077E7","244.61135046562322"
"7220","15167","15161","7","15168","112989","3327.48","0.043257239999999995","1.8819585208125077E7","244.65460770562322"
"7221","15168","15163","5","15168","112994","3327.48","0.043257239999999995","1.8822912688125078E7","244.69786494562322"
"7222","15168","15163","7","15170","113001","3327.91875","0.04326294375","1.8826240606875077E7","244.74112788937322"
"7223","15170","15162","6","15168","113007","3327.48","0.043257239999999995","1.8829568086875077E7","244.78438512937322"
"7224","15168","15161","6","15167","113013","3327.260625","0.043254388124999994","1.883289534750008E7","244.82763951749823"
"7225","15167","15158","1","15159","113014","3325.505625","0.04323157312499999","1.8836220853125077E7","244.87087109062324"
"7226","15159","15156","3","15159","113017","3325.505625","0.04323157312499999","1.8839546358750075E7","244.91410266374825"
"7227","15159","15154","2","15156","113019","3324.8475000000003","0.0432230175","1.8842871206250075E7","244.95732568124825"
"7228","15156","15151","7","15158","113026","3325.2862499999997","0.04322872124999999","1.8846196492500074E7","245.00055440249824"
"7229","15158","15154","2","15156","113028","3324.8475000000003","0.0432230175","1.8849521340000074E7","245.04377741999824"
"7230","15156","15150","7","15157","113035","3325.066874999999","0.04322586937499998","1.8852846406875074E7","245.08700328937323"
"7231","15157","15148","6","15154","113041","3324.4087500000005","0.04321731375000001","1.8856170815625075E7","245.13022060312323"
"7232","15154","15147","6","15153","113047","3324.189375","0.043214461875","1.8859495005000073E7","245.17343506499824"
"7233","15153","15148","8","15156","113055","3324.8475000000003","0.0432230175","1.8862819852500074E7","245.21665808249824"
"7234","15156","15150","7","15157","113062","3325.066874999999","0.04322586937499998","1.8866144919375073E7","245.25988395187323"
"7235","15157","15152","2","15154","113064","3324.4087500000005","0.04321731375000001","1.8869469328125075E7","245.30310126562324"
"7236","15154","15146","3","15149","113067","3323.3118750000003","0.043203054375","1.8872792640000075E7","245.34630431999824"
"7237","15149","15141","9","15150","113076","3323.53125","0.043205906249999995","1.8876116171250075E7","245.38951022624823"
"7238","15150","15143","5","15148","113081","3323.0924999999997","0.04320020249999999","1.8879439263750076E7","245.43271042874824"
"7239","15148","15143","7","15150","113088","3323.53125","0.043205906249999995","1.8882762795000076E7","245.47591633499823"
"7240","15150","15145","2","15147","113090","3322.8731249999996","0.04319735062499999","1.8886085668125078E7","245.51911368562324"
"7241","15147","15144","6","15150","113096","3323.53125","0.043205906249999995","1.8889409199375078E7","245.56231959187323"
"7242","15150","15144","2","15146","113098","3322.65375","0.04319449875","1.8892731853125077E7","245.60551409062325"
"7243","15146","15140","2","15142","113100","3321.77625","0.04318309124999999","1.8896053629375078E7","245.64869718187325"
"7244","15142","15140","4","15144","113104","3322.215","0.043188795","1.8899375844375078E7","245.69188597687324"
"7245","15144","15142","7","15149","113111","3323.3118750000003","0.043203054375","1.890269915625008E7","245.73508903124824"
"7246","15149","15143","6","15149","113117","3323.3118750000003","0.043203054375","1.890602246812508E7","245.77829208562324"
"7247","15149","15140","4","15144","113121","3322.215","0.043188795","1.890934468312508E7","245.82148088062323"
"7248","15144","15142","5","15147","113126","3322.8731249999996","0.04319735062499999","1.891266755625008E7","245.86467823124823"
"7249","15147","15145","3","15148","113129","3323.0924999999997","0.04320020249999999","1.891599064875008E7","245.90787843374824"
"7250","15148","15140","7","15147","113136","3322.8731249999996","0.04319735062499999","1.8919313521875083E7","245.95107578437324"
"7251","15147","15138","5","15143","113141","3321.995625","0.043185943125","1.8922635517500084E7","245.99426172749824"
"7252","15143","15139","9","15148","113150","3323.0924999999997","0.04320020249999999","1.8925958610000085E7","246.03746192999824"
"7253","15148","15141","3","15144","113153","3322.215","0.043188795","1.8929280825000085E7","246.08065072499824"
"7254","15144","15140","8","15148","113161","3323.0924999999997","0.04320020249999999","1.8932603917500086E7","246.12385092749824"
"7255","15148","15141","8","15149","113169","3323.3118750000003","0.043203054375","1.8935927229375087E7","246.16705398187324"
"7256","15149","15147","7","15154","113176","3324.4087500000005","0.04321731375000001","1.8939251638125088E7","246.21027129562324"
"7257","15154","15149","4","15153","113180","3324.189375","0.043214461875","1.8942575827500086E7","246.25348575749825"
"7258","15153","15147","2","15149","113182","3323.3118750000003","0.043203054375","1.8945899139375087E7","246.29668881187325"
"7259","15149","15140","7","15147","113189","3322.8731249999996","0.04319735062499999","1.894922201250009E7","246.33988616249826"
"7260","15147","15138","9","15147","113198","3322.8731249999996","0.04319735062499999","1.895254488562509E7","246.38308351312327"
"7261","15147","15144","3","15147","113201","3322.8731249999996","0.04319735062499999","1.8955867758750092E7","246.42628086374827"
"7262","15147","15138","3","15141","113204","3321.556875","0.043180239375","1.8959189315625094E7","246.46946110312328"
"7263","15141","15135","3","15138","113207","3320.89875","0.043171683749999995","1.8962510214375094E7","246.51263278687327"
"7264","15138","15137","4","15141","113211","3321.556875","0.043180239375","1.8965831771250095E7","246.55581302624827"
"7265","15141","15135","6","15141","113217","3321.556875","0.043180239375","1.8969153328125097E7","246.59899326562328"
"7266","15141","15132","2","15134","113219","3320.02125","0.04316027625","1.8972473349375095E7","246.64215354187328"
"7267","15134","15131","6","15137","113225","3320.6793749999997","0.043168831874999994","1.8975794028750096E7","246.68532237374828"
"7268","15137","15130","4","15134","113229","3320.02125","0.04316027625","1.8979114050000094E7","246.72848264999828"
"7269","15134","15129","8","15137","113237","3320.6793749999997","0.043168831874999994","1.8982434729375094E7","246.77165148187328"
"7270","15137","15134","5","15139","113242","3321.118125","0.043174535624999996","1.8985755847500093E7","246.8148260174983"
"7271","15139","15135","4","15139","113246","3321.118125","0.043174535624999996","1.8989076965625092E7","246.8580005531233"
"7272","15139","15136","4","15140","113250","3321.3375","0.0431773875","1.899239830312509E7","246.9011779406233"
"7273","15140","15139","4","15143","113254","3321.995625","0.043185943125","1.899572029875009E7","246.9443638837483"
"7274","15143","15141","4","15145","113258","3322.434375","0.043191646874999996","1.899904273312509E7","246.9875555306233"
"7275","15145","15140","8","15148","113266","3323.0924999999997","0.04320020249999999","1.900236582562509E7","247.0307557331233"
"7276","15148","15142","9","15151","113275","3323.750625","0.043208758124999996","1.900568957625009E7","247.0739644912483"
"7277","15151","15148","4","15152","113279","3323.97","0.04321161","1.900901354625009E7","247.11717610124828"
"7278","15152","15148","2","15150","113281","3323.53125","0.043205906249999995","1.901233707750009E7","247.16038200749827"
"7279","15150","15147","5","15152","113286","3323.97","0.04321161","1.901566104750009E7","247.20359361749826"
"7280","15152","15151","7","15158","113293","3325.2862499999997","0.04322872124999999","1.9018986333750088E7","247.24682233874825"
"7281","15158","15152","2","15154","113295","3324.4087500000005","0.04321731375000001","1.902231074250009E7","247.29003965249825"
"7282","15154","15152","3","15155","113298","3324.628125","0.043220165625","1.902563537062509E7","247.33325981812325"
"7283","15155","15154","5","15159","113303","3325.505625","0.04323157312499999","1.902896087625009E7","247.37649139124827"
"7284","15159","15154","3","15157","113306","3325.066874999999","0.04322586937499998","1.9032285943125088E7","247.41971726062326"
"7285","15157","15152","3","15155","113309","3324.628125","0.043220165625","1.903561057125009E7","247.46293742624826"
"7286","15155","15154","9","15163","113318","3326.383125","0.043242980624999997","1.903893695437509E7","247.50618040687326"
"7287","15163","15154","6","15160","113324","3325.725","0.04323442499999999","1.904226267937509E7","247.54941483187326"
"7288","15160","15153","9","15162","113333","3326.1637499999997","0.043240128749999995","1.904558884312509E7","247.59265496062326"
"7289","15162","15159","2","15161","113335","3325.944375","0.043237276875","1.904891478750009E7","247.63589223749827"
"7290","15161","15158","5","15163","113340","3326.383125","0.043242980624999997","1.905224117062509E7","247.67913521812326"
"7291","15163","15155","9","15164","113349","3326.6025","0.0432458325","1.905556777312509E7","247.72238105062326"
"7292","15164","15159","2","15161","113351","3325.944375","0.043237276875","1.905889371750009E7","247.76561832749826"
"7293","15161","15157","6","15163","113357","3326.383125","0.043242980624999997","1.906222010062509E7","247.80886130812326"
"7294","15163","15158","3","15161","113360","3325.944375","0.043237276875","1.906554604500009E7","247.85209858499826"
"7295","15161","15152","7","15159","113367","3325.505625","0.04323157312499999","1.906887155062509E7","247.89533015812327"
"7296","15159","15154","7","15161","113374","3325.944375","0.043237276875","1.907219749500009E7","247.93856743499828"
"7297","15161","15154","7","15161","113381","3325.944375","0.043237276875","1.907552343937509E7","247.98180471187328"
"7298","15161","15157","8","15165","113389","3326.821875","0.043248684375","1.907885026125009E7","248.02505339624827"
"7299","15165","15164","3","15167","113392","3327.260625","0.043254388124999994","1.908217752187509E7","248.06830778437327"
"7300","15167","15158","4","15162","113396","3326.1637499999997","0.043240128749999995","1.908550368562509E7","248.11154791312327"
"7301","15162","15159","6","15165","113402","3326.821875","0.043248684375","1.908883050750009E7","248.15479659749826"
"7302","15165","15156","9","15165","113411","3326.821875","0.043248684375","1.909215732937509E7","248.19804528187325"
"7303","15165","15158","4","15162","113415","3326.1637499999997","0.043240128749999995","1.909548349312509E7","248.24128541062325"
"7304","15162","15160","6","15166","113421","3327.04125","0.04325153625","1.909881053437509E7","248.28453694687326"
"7305","15166","15164","6","15170","113427","3327.91875","0.04326294375","1.910213845312509E7","248.32779989062325"
"7306","15170","15161","2","15163","113429","3326.383125","0.043242980624999997","1.910546483625009E7","248.37104287124825"
"7307","15163","15159","9","15168","113438","3327.48","0.043257239999999995","1.910879231625009E7","248.41430011124825"
"7308","15168","15163","2","15165","113440","3326.821875","0.043248684375","1.9112119138125088E7","248.45754879562324"
"7309","15165","15161","6","15167","113446","3327.260625","0.043254388124999994","1.911544639875009E7","248.50080318374825"
"7310","15167","15163","5","15168","113451","3327.48","0.043257239999999995","1.911877387875009E7","248.54406042374825"
"7311","15168","15165","5","15170","113456","3327.91875","0.04326294375","1.912210179750009E7","248.58732336749824"
"7312","15170","15161","4","15165","113460","3326.821875","0.043248684375","1.9125428619375087E7","248.63057205187323"
"7313","15165","15156","2","15158","113462","3325.2862499999997","0.04322872124999999","1.9128753905625086E7","248.67380077312322"
"7314","15158","15154","8","15162","113470","3326.1637499999997","0.043240128749999995","1.9132080069375087E7","248.71704090187322"
"7315","15162","15161","2","15163","113472","3326.383125","0.043242980624999997","1.9135406452500086E7","248.76028388249821"
"7316","15163","15154","8","15162","113480","3326.1637499999997","0.043240128749999995","1.9138732616250087E7","248.80352401124821"
"7317","15162","15160","3","15163","113483","3326.383125","0.043242980624999997","1.9142058999375086E7","248.8467669918732"
"7318","15163","15154","5","15159","113488","3325.505625","0.04323157312499999","1.9145384505000085E7","248.88999856499822"
"7319","15159","15150","1","15151","113489","3323.750625","0.043208758124999996","1.9148708255625084E7","248.9332073231232"
"7320","15151","15149","3","15152","113492","3323.97","0.04321161","1.9152032225625083E7","248.9764189331232"
"7321","15152","15146","6","15152","113498","3323.97","0.04321161","1.915535619562508E7","249.01963054312318"
"7322","15152","15146","9","15155","113507","3324.628125","0.043220165625","1.9158680823750082E7","249.0628507087482"
"7323","15155","15149","8","15157","113515","3325.066874999999","0.04322586937499998","1.9162005890625082E7","249.10607657812318"
"7324","15157","15155","1","15156","113516","3324.8475000000003","0.0432230175","1.9165330738125082E7","249.14929959562318"
"7325","15156","15150","5","15155","113521","3324.628125","0.043220165625","1.9168655366250083E7","249.19251976124818"
"7326","15155","15153","5","15158","113526","3325.2862499999997","0.04322872124999999","1.917198065250008E7","249.23574848249817"
"7327","15158","15155","8","15163","113534","3326.383125","0.043242980624999997","1.917530703562508E7","249.27899146312316"
"7328","15163","15160","5","15165","113539","3326.821875","0.043248684375","1.917863385750008E7","249.32224014749815"
"7329","15165","15157","6","15163","113545","3326.383125","0.043242980624999997","1.918196024062508E7","249.36548312812315"
"7330","15163","15154","3","15157","113548","3325.066874999999","0.04322586937499998","1.918528530750008E7","249.40870899749814"
"7331","15157","15149","2","15151","113550","3323.750625","0.043208758124999996","1.918860905812508E7","249.45191775562313"
"7332","15151","15146","7","15153","113557","3324.189375","0.043214461875","1.9191933247500077E7","249.49513221749814"
"7333","15153","15145","1","15146","113558","3322.65375","0.04319449875","1.9195255901250076E7","249.53832671624815"
"7334","15146","15145","9","15154","113567","3324.4087500000005","0.04321731375000001","1.9198580310000077E7","249.58154402999816"
"7335","15154","15150","9","15159","113576","3325.505625","0.04323157312499999","1.9201905815625075E7","249.62477560312317"
"7336","15159","15158","3","15161","113579","3325.944375","0.043237276875","1.9205231760000076E7","249.66801287999817"
"7337","15161","15154","3","15157","113582","3325.066874999999","0.04322586937499998","1.9208556826875076E7","249.71123874937317"
"7338","15157","15149","7","15156","113589","3324.8475000000003","0.0432230175","1.9211881674375076E7","249.75446176687316"
"7339","15156","15147","1","15148","113590","3323.0924999999997","0.04320020249999999","1.9215204766875077E7","249.79766196937317"
"7340","15148","15139","2","15141","113592","3321.556875","0.043180239375","1.921852632375008E7","249.84084220874817"
"7341","15141","15140","7","15147","113599","3322.8731249999996","0.04319735062499999","1.922184919687508E7","249.88403955937318"
"7342","15147","15138","4","15142","113603","3321.77625","0.04318309124999999","1.922517097312508E7","249.92722265062318"
"7343","15142","15135","6","15141","113609","3321.556875","0.043180239375","1.9228492530000083E7","249.97040288999818"
"7344","15141","15135","7","15142","113616","3321.77625","0.04318309124999999","1.9231814306250084E7","250.01358598124818"
"7345","15142","15140","2","15142","113618","3321.77625","0.04318309124999999","1.9235136082500085E7","250.05676907249818"
"7346","15142","15138","3","15141","113621","3321.556875","0.043180239375","1.9238457639375087E7","250.0999493118732"
"7347","15141","15138","5","15143","113626","3321.995625","0.043185943125","1.9241779635000087E7","250.14313525499819"
"7348","15143","15137","2","15139","113628","3321.118125","0.043174535624999996","1.9245100753125086E7","250.1863097906232"
"7349","15139","15133","4","15137","113632","3320.6793749999997","0.043168831874999994","1.9248421432500087E7","250.2294786224982"
"7350","15137","15130","5","15135","113637","3320.240625","0.043163128125","1.925174167312509E7","250.2726417506232"
"7351","15135","15126","4","15130","113641","3319.14375","0.04314886875","1.925506081687509E7","250.3157906193732"
"7352","15130","15128","1","15129","113642","3318.9243750000005","0.043146016875000005","1.925837974125009E7","250.3589366362482"
"7353","15129","15127","9","15136","113651","3320.46","0.04316598","1.926170020125009E7","250.4021026162482"
"7354","15136","15130","7","15137","113658","3320.6793749999997","0.043168831874999994","1.926502088062509E7","250.44527144812318"
"7355","15137","15134","3","15137","113661","3320.6793749999997","0.043168831874999994","1.926834156000009E7","250.48844027999817"
"7356","15137","15135","5","15140","113666","3321.3375","0.0431773875","1.927166289750009E7","250.53161766749818"
"7357","15140","15131","7","15138","113673","3320.89875","0.043171683749999995","1.927498379625009E7","250.57478935124817"
"7358","15138","15130","9","15139","113682","3321.118125","0.043174535624999996","1.927830491437509E7","250.61796388687318"
"7359","15139","15136","3","15139","113685","3321.118125","0.043174535624999996","1.928162603250009E7","250.6611384224982"
"7360","15139","15138","5","15143","113690","3321.995625","0.043185943125","1.928494802812509E7","250.7043243656232"
"7361","15143","15135","6","15141","113696","3321.556875","0.043180239375","1.928826958500009E7","250.7475046049982"
"7362","15141","15136","6","15142","113702","3321.77625","0.04318309124999999","1.929159136125009E7","250.7906876962482"
"7363","15142","15133","2","15135","113704","3320.240625","0.043163128125","1.9294911601875093E7","250.8338508243732"
"7364","15135","15131","2","15133","113706","3319.8018749999997","0.043157424374999996","1.929823140375009E7","250.8770082487482"
"7365","15133","15127","6","15133","113712","3319.8018749999997","0.043157424374999996","1.930155120562509E7","250.92016567312322"
"7366","15133","15126","3","15129","113715","3318.9243750000005","0.043146016875000005","1.9304870130000092E7","250.96331168999822"
"7367","15129","15127","7","15134","113722","3320.02125","0.04316027625","1.930819015125009E7","251.00647196624823"
"7368","15134","15129","5","15134","113727","3320.02125","0.04316027625","1.931151017250009E7","251.04963224249823"
"7369","15134","15130","3","15133","113730","3319.8018749999997","0.043157424374999996","1.9314829974375088E7","251.09278966687324"
"7370","15133","15125","7","15132","113737","3319.582499999999","0.04315457249999999","1.9318149556875087E7","251.13594423937323"
"7371","15132","15130","8","15138","113745","3320.89875","0.043171683749999995","1.9321470455625087E7","251.17911592312322"
"7372","15138","15135","6","15141","113751","3321.556875","0.043180239375","1.932479201250009E7","251.22229616249822"
"7373","15141","15137","1","15138","113752","3320.89875","0.043171683749999995","1.932811291125009E7","251.2654678462482"
"7374","15138","15133","7","15140","113759","3321.3375","0.0431773875","1.9331434248750087E7","251.30864523374822"
"7375","15140","15135","9","15144","113768","3322.215","0.043188795","1.9334756463750087E7","251.35183402874821"
"7376","15144","15143","3","15146","113771","3322.65375","0.04319449875","1.9338079117500085E7","251.39502852749823"
"7377","15146","15145","2","15147","113773","3322.8731249999996","0.04319735062499999","1.9341401990625087E7","251.43822587812323"
"7378","15147","15146","4","15150","113777","3323.53125","0.043205906249999995","1.9344725521875087E7","251.48143178437323"
"7379","15150","15144","2","15146","113779","3322.65375","0.04319449875","1.9348048175625086E7","251.52462628312324"
"7380","15146","15139","2","15141","113781","3321.556875","0.043180239375","1.9351369732500087E7","251.56780652249824"
"7381","15141","15132","8","15140","113789","3321.3375","0.0431773875","1.9354691070000086E7","251.61098390999825"
"7382","15140","15139","3","15142","113792","3321.77625","0.04318309124999999","1.9358012846250087E7","251.65416700124825"
"7383","15142","15133","9","15142","113801","3321.77625","0.04318309124999999","1.9361334622500088E7","251.69735009249825"
"7384","15142","15137","4","15141","113805","3321.556875","0.043180239375","1.936465617937509E7","251.74053033187326"
"7385","15141","15137","3","15140","113808","3321.3375","0.0431773875","1.936797751687509E7","251.78370771937327"
"7386","15140","15138","7","15145","113815","3322.434375","0.043191646874999996","1.9371299951250087E7","251.82689936624826"
"7387","15145","15140","6","15146","113821","3322.65375","0.04319449875","1.9374622605000086E7","251.87009386499827"
"7388","15146","15144","9","15153","113830","3324.189375","0.043214461875","1.9377946794375084E7","251.91330832687328"
"7389","15153","15149","8","15157","113838","3325.066874999999","0.04322586937499998","1.9381271861250084E7","251.95653419624827"
"7390","15157","15148","4","15152","113842","3323.97","0.04321161","1.9384595831250083E7","251.99974580624826"
"7391","15152","15147","4","15151","113846","3323.750625","0.043208758124999996","1.9387919581875082E7","252.04295456437325"
"7392","15151","15142","2","15144","113848","3322.215","0.043188795","1.9391241796875082E7","252.08614335937324"
"7393","15144","15138","4","15142","113852","3321.77625","0.04318309124999999","1.9394563573125083E7","252.12932645062324"
"7394","15142","15140","5","15145","113857","3322.434375","0.043191646874999996","1.9397886007500082E7","252.17251809749823"
"7395","15145","15139","1","15140","113858","3321.3375","0.0431773875","1.940120734500008E7","252.21569548499824"
"7396","15140","15135","3","15138","113861","3320.89875","0.043171683749999995","1.940452824375008E7","252.25886716874822"
"7397","15138","15137","3","15140","113864","3321.3375","0.0431773875","1.940784958125008E7","252.30204455624823"
"7398","15140","15135","2","15137","113866","3320.6793749999997","0.043168831874999994","1.941117026062508E7","252.34521338812323"
"7399","15137","15130","5","15135","113871","3320.240625","0.043163128125","1.941449050125008E7","252.38837651624823"
"7400","15135","15131","1","15132","113872","3319.582499999999","0.04315457249999999","1.941781008375008E7","252.43153108874822"
"7401","15132","15131","1","15132","113873","3319.582499999999","0.04315457249999999","1.942112966625008E7","252.4746856612482"
"7402","15132","15130","8","15138","113881","3320.89875","0.043171683749999995","1.942445056500008E7","252.5178573449982"
"7403","15138","15131","1","15132","113882","3319.582499999999","0.04315457249999999","1.942777014750008E7","252.56101191749818"
"7404","15132","15127","2","15129","113884","3318.9243750000005","0.043146016875000005","1.943108907187508E7","252.60415793437318"
"7405","15129","15120","3","15123","113887","3317.6081249999997","0.04312890562499999","1.943440668000008E7","252.64728683999817"
"7406","15123","15114","7","15121","113894","3317.169375","0.043123201874999996","1.943772384937508E7","252.69041004187318"
"7407","15121","15118","1","15119","113895","3316.730625","0.043117498125","1.944104058000008E7","252.7335275399982"
"7408","15119","15117","8","15125","113903","3318.046875","0.043134609375","1.944435862687508E7","252.77666214937318"
"7409","15125","15120","3","15123","113906","3317.6081249999997","0.04312890562499999","1.944767623500008E7","252.81979105499818"
"7410","15123","15121","5","15126","113911","3318.26625","0.04313746125","1.945099450125008E7","252.8629285162482"
"7411","15126","15120","7","15127","113918","3318.485625","0.043140313124999996","1.945431298687508E7","252.9060688293732"
"7412","15127","15118","8","15126","113926","3318.26625","0.04313746125","1.945763125312508E7","252.9492062906232"
"7413","15126","15122","7","15129","113933","3318.9243750000005","0.043146016875000005","1.946095017750008E7","252.9923523074982"
"7414","15129","15123","1","15124","113934","3317.8275000000003","0.0431317575","1.946426800500008E7","253.0354840649982"
"7415","15124","15117","4","15121","113938","3317.169375","0.043123201874999996","1.946758517437508E7","253.0786072668732"
"7416","15121","15112","1","15113","113939","3315.414375","0.043100386874999994","1.947090058875008E7","253.12170765374822"
"7417","15113","15105","7","15112","113946","3315.1949999999997","0.04309753499999999","1.947421578375008E7","253.1648051887482"
"7418","15112","15103","7","15110","113953","3314.75625","0.04309183125","1.947753054000008E7","253.2078970199982"
"7419","15110","15104","5","15109","113958","3314.536875","0.043088979374999996","1.948084507687508E7","253.2509859993732"
"7420","15109","15106","3","15109","113961","3314.536875","0.043088979374999996","1.9484159613750078E7","253.2940749787482"
"7421","15109","15102","6","15108","113967","3314.3174999999997","0.043086127499999995","1.9487473931250077E7","253.3371611062482"
"7422","15108","15100","6","15106","113973","3313.8787500000003","0.04308042375","1.9490787810000077E7","253.38024152999822"
"7423","15106","15105","6","15111","113979","3314.975625","0.043094683125","1.9494102785625078E7","253.4233362131232"
"7424","15111","15103","4","15107","113983","3314.098124999999","0.04308327562499999","1.9497416883750077E7","253.46641948874822"
"7425","15107","15100","5","15105","113988","3313.659375","0.043077571875","1.9500730543125078E7","253.5094970606232"
"7426","15105","15097","8","15105","113996","3313.659375","0.043077571875","1.950404420250008E7","253.5525746324982"
"7427","15105","15097","1","15098","113997","3312.1237499999997","0.04305760875","1.950735632625008E7","253.59563224124818"
"7428","15098","15091","6","15097","114003","3311.9043749999996","0.043054756874999996","1.951066823062508E7","253.63868699812318"
"7429","15097","15090","1","15091","114004","3310.588125","0.043037645625","1.9513978818750083E7","253.68172464374817"
"7430","15091","15089","9","15098","114013","3312.1237499999997","0.04305760875","1.9517290942500085E7","253.72478225249816"
"7431","15098","15095","1","15096","114014","3311.685","0.043051904999999994","1.9520602627500083E7","253.76783415749816"
"7432","15096","15090","6","15096","114020","3311.685","0.043051904999999994","1.9523914312500082E7","253.81088606249816"
"7433","15096","15090","3","15093","114023","3311.026875","0.043043349375","1.9527225339375082E7","253.85392941187317"
"7434","15093","15088","9","15097","114032","3311.9043749999996","0.043054756874999996","1.9530537243750084E7","253.89698416874816"
"7435","15097","15095","1","15096","114033","3311.685","0.043051904999999994","1.9533848928750083E7","253.94003607374816"
"7436","15096","15095","8","15103","114041","3313.220625","0.043071868124999996","1.953716214937508E7","253.98310794187316"
"7437","15103","15094","2","15096","114043","3311.685","0.043051904999999994","1.954047383437508E7","254.02615984687316"
"7438","15096","15093","2","15095","114045","3311.465625","0.04304905312499999","1.954378530000008E7","254.06920889999816"
"7439","15095","15094","7","15101","114052","3312.781875","0.043066164375","1.954709808187508E7","254.11227506437316"
"7440","15101","15097","5","15102","114057","3313.00125","0.043069016249999995","1.9550411083125077E7","254.15534408062317"
"7441","15102","15095","4","15099","114061","3312.3431250000003","0.043060460625000005","1.9553723426250078E7","254.19840454124815"
"7442","15099","15093","6","15099","114067","3312.3431250000003","0.043060460625000005","1.955703576937508E7","254.24146500187314"
"7443","15099","15090","7","15097","114074","3311.9043749999996","0.043054756874999996","1.956034767375008E7","254.28451975874813"
"7444","15097","15093","1","15094","114075","3311.24625","0.04304620125","1.956365892000008E7","254.32756595999814"
"7445","15094","15087","8","15095","114083","3311.465625","0.04304905312499999","1.956697038562508E7","254.37061501312314"
"7446","15095","15087","5","15092","114088","3310.8075","0.0430404975","1.957028119312508E7","254.41365551062313"
"7447","15092","15091","9","15100","114097","3312.5625","0.0430633125","1.957359375562508E7","254.45671882312314"
"7448","15100","15093","2","15095","114099","3311.465625","0.04304905312499999","1.957690522125008E7","254.49976787624814"
"7449","15095","15088","1","15089","114100","3310.149375","0.043031941875","1.958021537062508E7","254.54279981812314"
"7450","15089","15088","1","15089","114101","3310.149375","0.043031941875","1.9583525520000078E7","254.58583175999814"
"7451","15089","15081","8","15089","114109","3310.149375","0.043031941875","1.9586835669375077E7","254.62886370187314"
"7452","15089","15087","5","15092","114114","3310.8075","0.0430404975","1.9590146476875078E7","254.67190419937313"
"7453","15092","15086","7","15093","114121","3311.026875","0.043043349375","1.959345750375008E7","254.71494754874814"
"7454","15093","15088","4","15092","114125","3310.8075","0.0430404975","1.959676831125008E7","254.75798804624813"
"7455","15092","15090","6","15096","114131","3311.685","0.043051904999999994","1.9600079996250078E7","254.80103995124813"
"7456","15096","15093","4","15097","114135","3311.9043749999996","0.043054756874999996","1.960339190062508E7","254.84409470812312"
"7457","15097","15095","1","15096","114136","3311.685","0.043051904999999994","1.960670358562508E7","254.88714661312312"
"7458","15096","15090","8","15098","114144","3312.1237499999997","0.04305760875","1.961001570937508E7","254.9302042218731"
"7459","15098","15094","7","15101","114151","3312.781875","0.043066164375","1.961332849125008E7","254.97327038624812"
"7460","15101","15099","1","15100","114152","3312.5625","0.0430633125","1.961664105375008E7","255.01633369874813"
"7461","15100","15095","4","15099","114156","3312.3431250000003","0.043060460625000005","1.961995339687508E7","255.0593941593731"
"7462","15099","15095","3","15098","114159","3312.1237499999997","0.04305760875","1.962326552062508E7","255.1024517681231"
"7463","15098","15091","3","15094","114162","3311.24625","0.04304620125","1.962657676687508E7","255.1454979693731"
"7464","15094","15090","4","15094","114166","3311.24625","0.04304620125","1.962988801312508E7","255.18854417062312"
"7465","15094","15090","1","15091","114167","3310.588125","0.043037645625","1.9633198601250082E7","255.2315818162481"
"7466","15091","15084","1","15085","114168","3309.271875","0.043020534374999995","1.9636507873125084E7","255.2746023506231"
"7467","15085","15083","8","15091","114176","3310.588125","0.043037645625","1.9639818461250085E7","255.3176399962481"
"7468","15091","15083","5","15088","114181","3309.93","0.04302908999999999","1.9643128391250085E7","255.3606690862481"
"7469","15088","15082","5","15087","114186","3309.7106249999997","0.04302623812499999","1.9646438101875085E7","255.4036953243731"
"7470","15087","15080","7","15087","114193","3309.7106249999997","0.04302623812499999","1.9649747812500086E7","255.4467215624981"
"7471","15087","15082","5","15087","114198","3309.7106249999997","0.04302623812499999","1.9653057523125086E7","255.48974780062312"
"7472","15087","15081","2","15083","114200","3308.8331249999997","0.04301483062499999","1.9656366356250085E7","255.53276263124812"
"7473","15083","15079","9","15088","114209","3309.93","0.04302908999999999","1.9659676286250085E7","255.57579172124812"
"7474","15088","15084","9","15093","114218","3311.026875","0.043043349375","1.9662987313125085E7","255.61883507062313"
"7475","15093","15086","3","15089","114221","3310.149375","0.043031941875","1.9666297462500084E7","255.66186701249813"
"7476","15089","15081","5","15086","114226","3309.49125","0.04302338625","1.9669606953750085E7","255.70489039874815"
"7477","15086","15078","2","15080","114228","3308.175","0.043006275","1.9672915128750086E7","255.74789667374816"
"7478","15080","15075","3","15078","114231","3307.73625","0.043000571249999994","1.9676222865000084E7","255.79089724499815"
"7479","15078","15074","8","15082","114239","3308.613749999999","0.043011978749999985","1.9679531478750084E7","255.83390922374815"
"7480","15082","15075","1","15076","114240","3307.2975","0.0429948675","1.9682838776250083E7","255.87690409124815"
"7481","15076","15067","9","15076","114249","3307.2975","0.0429948675","1.9686146073750082E7","255.91989895874815"
"7482","15076","15069","4","15073","114253","3306.6393749999997","0.042986311874999995","1.9689452713125084E7","255.96288527062316"
"7483","15073","15066","5","15071","114258","3306.200625","0.042980608125","1.9692758913750082E7","256.0058658787482"
"7484","15071","15069","9","15078","114267","3307.73625","0.043000571249999994","1.969606665000008E7","256.0488664499982"
"7485","15078","15069","2","15071","114269","3306.200625","0.042980608125","1.969937285062508E7","256.09184705812316"
"7486","15071","15064","2","15066","114271","3305.10375","0.04296634875","1.970267795437508E7","256.13481340687315"
"7487","15066","15062","9","15071","114280","3306.200625","0.042980608125","1.970598415500008E7","256.17779401499814"
"7488","15071","15068","4","15072","114284","3306.4199999999996","0.042983459999999994","1.970929057500008E7","256.22077747499816"
"7489","15072","15067","8","15075","114292","3307.078125","0.042992015625","1.971259765312508E7","256.26376949062313"
"7490","15075","15071","6","15077","114298","3307.516875","0.04299771937499999","1.971590517000008E7","256.30676720999816"
"7491","15077","15074","8","15082","114306","3308.613749999999","0.043011978749999985","1.971921378375008E7","256.34977918874813"
"7492","15082","15076","1","15077","114307","3307.516875","0.04299771937499999","1.972252130062508E7","256.39277690812315"
"7493","15077","15070","1","15071","114308","3306.200625","0.042980608125","1.9725827501250077E7","256.43575751624815"
"7494","15071","15068","3","15071","114311","3306.200625","0.042980608125","1.9729133701875076E7","256.47873812437314"
"7495","15071","15067","2","15069","114313","3305.761875","0.042974904375","1.9732439463750076E7","256.52171302874814"
"7496","15069","15063","3","15066","114316","3305.10375","0.04296634875","1.9735744567500077E7","256.5646793774981"
"7497","15066","15065","1","15066","114317","3305.10375","0.04296634875","1.973904967125008E7","256.6076457262481"
"7498","15066","15057","2","15059","114319","3303.568125","0.04294638562499999","1.9742353239375077E7","256.6505921118731"
"7499","15059","15056","8","15064","114327","3304.665","0.042960645","1.9745657904375076E7","256.6935527568731"
"7500","15064","15061","7","15068","114334","3305.5425","0.042972052499999996","1.9748963446875077E7","256.73652480937307"
"7501","15068","15061","9","15070","114343","3305.98125","0.04297775624999999","1.9752269428125076E7","256.7795025656231"
"7502","15070","15069","9","15078","114352","3307.73625","0.043000571249999994","1.9755577164375074E7","256.8225031368731"
"7503","15078","15072","3","15075","114355","3307.078125","0.042992015625","1.9758884242500074E7","256.86549515249806"
"7504","15075","15068","5","15073","114360","3306.6393749999997","0.042986311874999995","1.9762190881875075E7","256.90848146437304"
"7505","15073","15065","9","15074","114369","3306.8587500000003","0.04298916375","1.9765497740625076E7","256.95147062812305"
"7506","15074","15071","6","15077","114375","3307.516875","0.04299771937499999","1.9768805257500075E7","256.99446834749807"
"7507","15077","15074","5","15079","114380","3307.9556250000005","0.043003423125","1.9772113213125076E7","257.0374717706231"
"7508","15079","15076","3","15079","114383","3307.9556250000005","0.043003423125","1.9775421168750077E7","257.0804751937481"
"7509","15079","15077","3","15080","114386","3308.175","0.043006275","1.977872934375008E7","257.1234814687481"
"7510","15080","15076","9","15085","114395","3309.271875","0.043020534374999995","1.978203861562508E7","257.16650200312307"
"7511","15085","15079","5","15084","114400","3309.0525","0.043017682499999994","1.9785347668125078E7","257.2095196856231"
"7512","15084","15079","4","15083","114404","3308.8331249999997","0.04301483062499999","1.9788656501250077E7","257.2525345162481"
"7513","15083","15076","7","15083","114411","3308.8331249999997","0.04301483062499999","1.9791965334375076E7","257.2955493468731"
"7514","15083","15082","6","15088","114417","3309.93","0.04302908999999999","1.9795275264375076E7","257.3385784368731"
"7515","15088","15087","8","15095","114425","3311.465625","0.04304905312499999","1.9798586730000075E7","257.3816274899981"
"7516","15095","15087","3","15090","114428","3310.36875","0.04303479375","1.9801897098750073E7","257.4246622837481"
"7517","15090","15087","1","15088","114429","3309.93","0.04302908999999999","1.9805207028750073E7","257.4676913737481"
"7518","15088","15084","1","15085","114430","3309.271875","0.043020534374999995","1.9808516300625075E7","257.5107119081231"
"7519","15085","15080","8","15088","114438","3309.93","0.04302908999999999","1.9811826230625074E7","257.5537409981231"
"7520","15088","15081","5","15086","114443","3309.49125","0.04302338625","1.9815135721875075E7","257.5967643843731"
"7521","15086","15082","7","15089","114450","3310.149375","0.043031941875","1.9818445871250074E7","257.6397963262481"
"7522","15089","15084","9","15093","114459","3311.026875","0.043043349375","1.9821756898125075E7","257.6828396756231"
"7523","15093","15088","7","15095","114466","3311.465625","0.04304905312499999","1.9825068363750074E7","257.7258887287481"
"7524","15095","15094","8","15102","114474","3313.00125","0.043069016249999995","1.9828381365000073E7","257.7689577449981"
"7525","15102","15096","9","15105","114483","3313.659375","0.043077571875","1.9831695024375074E7","257.8120353168731"
"7526","15105","15100","1","15101","114484","3312.781875","0.043066164375","1.9835007806250073E7","257.8551014812481"
"7527","15101","15092","6","15098","114490","3312.1237499999997","0.04305760875","1.9838319930000074E7","257.8981590899981"
"7528","15098","15097","7","15104","114497","3313.4400000000005","0.043074720000000004","1.9841633370000076E7","257.9412338099981"
"7529","15104","15100","7","15107","114504","3314.098124999999","0.04308327562499999","1.9844947468125075E7","257.9843170856231"
"7530","15107","15099","4","15103","114508","3313.220625","0.043071868124999996","1.9848260688750073E7","258.02738895374813"
"7531","15103","15101","2","15103","114510","3313.220625","0.043071868124999996","1.985157390937507E7","258.07046082187316"
"7532","15103","15099","2","15101","114512","3312.781875","0.043066164375","1.985488669125007E7","258.11352698624813"
"7533","15101","15093","5","15098","114517","3312.1237499999997","0.04305760875","1.9858198815000072E7","258.15658459499815"
"7534","15098","15096","1","15097","114518","3311.9043749999996","0.043054756874999996","1.9861510719375074E7","258.19963935187315"
"7535","15097","15094","7","15101","114525","3312.781875","0.043066164375","1.9864823501250073E7","258.2427055162481"
"7536","15101","15092","6","15098","114531","3312.1237499999997","0.04305760875","1.9868135625000075E7","258.28576312499814"
"7537","15098","15094","1","15095","114532","3311.465625","0.04304905312499999","1.9871447090625074E7","258.32881217812314"
"7538","15095","15089","8","15097","114540","3311.9043749999996","0.043054756874999996","1.9874758995000076E7","258.37186693499814"
"7539","15097","15089","2","15091","114542","3310.588125","0.043037645625","1.9878069583125077E7","258.41490458062316"
"7540","15091","15083","7","15090","114549","3310.36875","0.04303479375","1.9881379951875076E7","258.45793937437315"
"7541","15090","15084","3","15087","114552","3309.7106249999997","0.04302623812499999","1.9884689662500076E7","258.50096561249813"
"7542","15087","15083","2","15085","114554","3309.271875","0.043020534374999995","1.9887998934375077E7","258.5439861468731"
"7543","15085","15083","1","15084","114555","3309.0525","0.043017682499999994","1.9891307986875076E7","258.58700382937315"
"7544","15084","15080","2","15082","114557","3308.613749999999","0.043011978749999985","1.9894616600625075E7","258.6300158081231"
"7545","15082","15073","4","15077","114561","3307.516875","0.04299771937499999","1.9897924117500074E7","258.67301352749814"
"7546","15077","15068","3","15071","114564","3306.200625","0.042980608125","1.9901230318125073E7","258.71599413562313"
"7547","15071","15062","7","15069","114571","3305.761875","0.042974904375","1.9904536080000073E7","258.75896903999814"
"7548","15069","15062","1","15063","114572","3304.445625","0.042957793125","1.9907840525625072E7","258.80192683312316"
"7549","15063","15057","4","15061","114576","3304.006875","0.042952089374999995","1.9911144532500073E7","258.84487892249814"
"7550","15061","15052","4","15056","114580","3302.9100000000003","0.04293783","1.9914447442500073E7","258.88781675249817"
"7551","15056","15047","8","15055","114588","3302.690625","0.042934978125","1.9917750133125074E7","258.9307517306232"
"7552","15055","15054","3","15057","114591","3303.129374999999","0.042940681874999984","1.9921053262500074E7","258.97369241249817"
"7553","15057","15049","5","15054","114596","3302.4712500000005","0.04293212625","1.9924355733750075E7","259.01662453874815"
"7554","15054","15051","8","15059","114604","3303.568125","0.04294638562499999","1.9927659301875073E7","259.05957092437313"
"7555","15059","15054","8","15062","114612","3304.2262499999997","0.042954941249999996","1.9930963528125074E7","259.10252586562314"
"7556","15062","15054","8","15062","114620","3304.2262499999997","0.042954941249999996","1.9934267754375074E7","259.14548080687314"
"7557","15062","15060","8","15068","114628","3305.5425","0.042972052499999996","1.9937573296875075E7","259.1884528593731"
"7558","15068","15064","6","15070","114634","3305.98125","0.04297775624999999","1.9940879278125074E7","259.23143061562314"
"7559","15070","15061","1","15062","114635","3304.2262499999997","0.042954941249999996","1.9944183504375074E7","259.27438555687314"
"7560","15062","15059","7","15066","114642","3305.10375","0.04296634875","1.9947488608125076E7","259.3173519056231"
"7561","15066","15057","2","15059","114644","3303.568125","0.04294638562499999","1.9950792176250074E7","259.3602982912481"
"7562","15059","15055","8","15063","114652","3304.445625","0.042957793125","1.9954096621875074E7","259.40325608437314"
"7563","15063","15058","2","15060","114654","3303.7875","0.042949237499999994","1.9957400409375075E7","259.44620532187315"
"7564","15060","15059","2","15061","114656","3304.006875","0.042952089374999995","1.9960704416250076E7","259.48915741124813"
"7565","15061","15058","6","15064","114662","3304.665","0.042960645","1.9964009081250075E7","259.5321180562481"
"7566","15064","15058","9","15067","114671","3305.323125","0.042969200624999995","1.9967314404375076E7","259.57508725687313"
"7567","15067","15060","6","15066","114677","3305.10375","0.04296634875","1.9970619508125078E7","259.6180536056231"
"7568","15066","15059","7","15066","114684","3305.10375","0.04296634875","1.997392461187508E7","259.6610199543731"
"7569","15066","15062","4","15066","114688","3305.10375","0.04296634875","1.997722971562508E7","259.7039863031231"
"7570","15066","15060","1","15061","114689","3304.006875","0.042952089374999995","1.9980533722500082E7","259.74693839249807"
"7571","15061","15059","5","15064","114694","3304.665","0.042960645","1.998383838750008E7","259.78989903749806"
"7572","15064","15056","2","15058","114696","3303.3487499999997","0.04294353374999999","1.998714173625008E7","259.8328425712481"
"7573","15058","15055","4","15059","114700","3303.568125","0.04294638562499999","1.999044530437508E7","259.87578895687307"
"7574","15059","15053","8","15061","114708","3304.006875","0.042952089374999995","1.999374931125008E7","259.91874104624804"
"7575","15061","15056","1","15057","114709","3303.129374999999","0.042940681874999984","1.999705244062508E7","259.96168172812304"
"7576","15057","15053","4","15057","114713","3303.129374999999","0.042940681874999984","2.000035557000008E7","260.00462240999803"
"7577","15057","15053","5","15058","114718","3303.3487499999997","0.04294353374999999","2.0003658918750077E7","260.04756594374805"
"7578","15058","15057","8","15065","114726","3304.884375","0.042963496875","2.0006963803125076E7","260.0905294406231"
"7579","15065","15058","6","15064","114732","3304.665","0.042960645","2.0010268468125075E7","260.13349008562307"
"7580","15064","15057","2","15059","114734","3303.568125","0.04294638562499999","2.0013572036250073E7","260.17643647124805"
"7581","15059","15052","1","15053","114735","3302.251875","0.042929274375","2.001687428812507E7","260.21936574562307"
"7582","15053","15052","5","15057","114740","3303.129374999999","0.042940681874999984","2.002017741750007E7","260.26230642749806"
"7583","15057","15055","9","15064","114749","3304.665","0.042960645","2.002348208250007E7","260.30526707249805"
"7584","15064","15056","9","15065","114758","3304.884375","0.042963496875","2.002678696687507E7","260.3482305693731"
"7585","15065","15056","2","15058","114760","3303.3487499999997","0.04294353374999999","2.0030090315625068E7","260.3911741031231"
"7586","15058","15055","8","15063","114768","3304.445625","0.042957793125","2.0033394761250068E7","260.4341318962481"
"7587","15063","15059","8","15067","114776","3305.323125","0.042969200624999995","2.003670008437507E7","260.4771010968731"
"7588","15067","15066","1","15067","114777","3305.323125","0.042969200624999995","2.004000540750007E7","260.52007029749814"
"7589","15067","15060","9","15069","114786","3305.761875","0.042974904375","2.004331116937507E7","260.56304520187314"
"7590","15069","15068","6","15074","114792","3306.8587500000003","0.04298916375","2.004661802812507E7","260.60603436562315"
"7591","15074","15069","5","15074","114797","3306.8587500000003","0.04298916375","2.004992488687507E7","260.64902352937315"
"7592","15074","15071","5","15076","114802","3307.2975","0.0429948675","2.005323218437507E7","260.69201839687315"
"7593","15076","15073","6","15079","114808","3307.9556250000005","0.043003423125","2.005654014000007E7","260.73502181999817"
"7594","15079","15071","2","15073","114810","3306.6393749999997","0.042986311874999995","2.0059846779375073E7","260.77800813187315"
"7595","15073","15072","7","15079","114817","3307.9556250000005","0.043003423125","2.0063154735000074E7","260.82101155499817"
"7596","15079","15074","7","15081","114824","3308.3943750000003","0.043009126875000005","2.0066463129375074E7","260.86402068187317"
"7597","15081","15076","8","15084","114832","3309.0525","0.043017682499999994","2.0069772181875072E7","260.9070383643732"
"7598","15084","15082","5","15087","114837","3309.7106249999997","0.04302623812499999","2.0073081892500073E7","260.9500646024982"
"7599","15087","15086","2","15088","114839","3309.93","0.04302908999999999","2.0076391822500072E7","260.9930936924982"
"7600","15088","15080","3","15083","114842","3308.8331249999997","0.04301483062499999","2.007970065562507E7","261.0361085231232"
"7601","15083","15079","3","15082","114845","3308.613749999999","0.043011978749999985","2.008300926937507E7","261.07912050187315"
"7602","15082","15074","5","15079","114850","3307.9556250000005","0.043003423125","2.0086317225000072E7","261.12212392499816"
"7603","15079","15073","4","15077","114854","3307.516875","0.04299771937499999","2.008962474187507E7","261.1651216443732"
"7604","15077","15071","8","15079","114862","3307.9556250000005","0.043003423125","2.0092932697500072E7","261.2081250674982"
"7605","15079","15070","2","15072","114864","3306.4199999999996","0.042983459999999994","2.0096239117500074E7","261.2511085274982"
"7606","15072","15069","1","15070","114865","3305.98125","0.04297775624999999","2.0099545098750073E7","261.29408628374824"
"7607","15070","15066","5","15071","114870","3306.200625","0.042980608125","2.0102851299375072E7","261.33706689187323"
"7608","15071","15067","9","15076","114879","3307.2975","0.0429948675","2.010615859687507E7","261.38006175937323"
"7609","15076","15075","4","15079","114883","3307.9556250000005","0.043003423125","2.0109466552500073E7","261.42306518249825"
"7610","15079","15077","1","15078","114884","3307.73625","0.043000571249999994","2.011277428875007E7","261.46606575374824"
"7611","15078","15075","4","15079","114888","3307.9556250000005","0.043003423125","2.0116082244375072E7","261.50906917687325"
"7612","15079","15074","6","15080","114894","3308.175","0.043006275","2.0119390419375073E7","261.55207545187324"
"7613","15080","15074","9","15083","114903","3308.8331249999997","0.04301483062499999","2.0122699252500072E7","261.59509028249823"
"7614","15083","15082","8","15090","114911","3310.36875","0.04303479375","2.012600962125007E7","261.63812507624823"
"7615","15090","15087","9","15096","114920","3311.685","0.043051904999999994","2.012932130625007E7","261.68117698124826"
"7616","15096","15087","6","15093","114926","3311.026875","0.043043349375","2.013263233312507E7","261.72422033062327"
"7617","15093","15090","8","15098","114934","3312.1237499999997","0.04305760875","2.013594445687507E7","261.7672779393733"
"7618","15098","15089","5","15094","114939","3311.24625","0.04304620125","2.013925570312507E7","261.81032414062327"
"7619","15094","15089","7","15096","114946","3311.685","0.043051904999999994","2.014256738812507E7","261.8533760456233"
"7620","15096","15093","1","15094","114947","3311.24625","0.04304620125","2.014587863437507E7","261.89642224687327"
"7621","15094","15088","4","15092","114951","3310.8075","0.0430404975","2.014918944187507E7","261.93946274437326"
"7622","15092","15090","4","15094","114955","3311.24625","0.04304620125","2.015250068812507E7","261.98250894562324"
"7623","15094","15085","1","15086","114956","3309.49125","0.04302338625","2.015581017937507E7","262.02553233187325"
"7624","15086","15085","1","15086","114957","3309.49125","0.04302338625","2.0159119670625072E7","262.06855571812326"
"7625","15086","15080","3","15083","114960","3308.8331249999997","0.04301483062499999","2.016242850375007E7","262.11157054874826"
"7626","15083","15081","4","15085","114964","3309.271875","0.043020534374999995","2.0165737775625072E7","262.15459108312325"
"7627","15085","15078","1","15079","114965","3307.9556250000005","0.043003423125","2.0169045731250074E7","262.19759450624827"
"7628","15079","15073","7","15080","114972","3308.175","0.043006275","2.0172353906250075E7","262.24060078124825"
"7629","15080","15076","6","15082","114978","3308.613749999999","0.043011978749999985","2.0175662520000074E7","262.2836127599982"
"7630","15082","15080","7","15087","114985","3309.7106249999997","0.04302623812499999","2.0178972230625074E7","262.3266389981232"
"7631","15087","15079","2","15081","114987","3308.3943750000003","0.043009126875000005","2.0182280625000075E7","262.3696481249982"
"7632","15081","15080","4","15084","114991","3309.0525","0.043017682499999994","2.0185589677500073E7","262.41266580749823"
"7633","15084","15077","1","15078","114992","3307.73625","0.043000571249999994","2.018889741375007E7","262.4556663787482"
"7634","15078","15070","4","15074","114996","3306.8587500000003","0.04298916375","2.019220427250007E7","262.4986555424982"
"7635","15074","15065","6","15071","115002","3306.200625","0.042980608125","2.019551047312507E7","262.5416361506232"
"7636","15071","15066","4","15070","115006","3305.98125","0.04297775624999999","2.019881645437507E7","262.58461390687324"
"7637","15070","15062","7","15069","115013","3305.761875","0.042974904375","2.020212221625007E7","262.62758881124824"
"7638","15069","15061","3","15064","115016","3304.665","0.042960645","2.020542688125007E7","262.67054945624824"
"7639","15064","15060","4","15064","115020","3304.665","0.042960645","2.0208731546250068E7","262.71351010124823"
"7640","15064","15063","3","15066","115023","3305.10375","0.04296634875","2.021203665000007E7","262.7564764499982"
"7641","15066","15065","6","15071","115029","3306.200625","0.042980608125","2.0215342850625068E7","262.7994570581232"
"7642","15071","15069","9","15078","115038","3307.73625","0.043000571249999994","2.0218650586875066E7","262.8424576293732"
"7643","15078","15072","4","15076","115042","3307.2975","0.0429948675","2.0221957884375066E7","262.8854524968732"
"7644","15076","15072","2","15074","115044","3306.8587500000003","0.04298916375","2.0225264743125066E7","262.9284416606232"
"7645","15074","15070","1","15071","115045","3306.200625","0.042980608125","2.0228570943750065E7","262.9714222687482"
"7646","15071","15066","3","15069","115048","3305.761875","0.042974904375","2.0231876705625065E7","263.0143971731232"
"7647","15069","15063","5","15068","115053","3305.5425","0.042972052499999996","2.0235182248125065E7","263.0573692256232"
"7648","15068","15064","5","15069","115058","3305.761875","0.042974904375","2.0238488010000065E7","263.1003441299982"
"7649","15069","15064","5","15069","115063","3305.761875","0.042974904375","2.0241793771875065E7","263.1433190343732"
"7650","15069","15064","9","15073","115072","3306.6393749999997","0.042986311874999995","2.0245100411250066E7","263.18630534624816"
"7651","15073","15071","3","15074","115075","3306.8587500000003","0.04298916375","2.0248407270000067E7","263.22929450999817"
"7652","15074","15072","3","15075","115078","3307.078125","0.042992015625","2.0251714348125067E7","263.27228652562314"
"7653","15075","15066","9","15075","115087","3307.078125","0.042992015625","2.0255021426250067E7","263.3152785412481"
"7654","15075","15073","1","15074","115088","3306.8587500000003","0.04298916375","2.0258328285000067E7","263.3582677049981"
"7655","15074","15065","8","15073","115096","3306.6393749999997","0.042986311874999995","2.026163492437507E7","263.4012540168731"
"7656","15073","15067","4","15071","115100","3306.200625","0.042980608125","2.0264941125000067E7","263.4442346249981"
"7657","15071","15066","2","15068","115102","3305.5425","0.042972052499999996","2.0268246667500068E7","263.4872066774981"
"7658","15068","15062","9","15071","115111","3306.200625","0.042980608125","2.0271552868125066E7","263.5301872856231"
"7659","15071","15065","7","15072","115118","3306.4199999999996","0.042983459999999994","2.0274859288125068E7","263.5731707456231"
"7660","15072","15069","7","15076","115125","3307.2975","0.0429948675","2.0278166585625067E7","263.6161656131231"
"7661","15076","15074","1","15075","115126","3307.078125","0.042992015625","2.0281473663750067E7","263.65915762874806"
"7662","15075","15070","3","15073","115129","3306.6393749999997","0.042986311874999995","2.028478030312507E7","263.70214394062305"
"7663","15073","15066","4","15070","115133","3305.98125","0.04297775624999999","2.0288086284375068E7","263.74512169687307"
"7664","15070","15061","8","15069","115141","3305.761875","0.042974904375","2.0291392046250068E7","263.78809660124807"
"7665","15069","15068","8","15076","115149","3307.2975","0.0429948675","2.0294699343750067E7","263.83109146874807"
"7666","15076","15070","8","15078","115157","3307.73625","0.043000571249999994","2.0298007080000065E7","263.87409203999806"
"7667","15078","15073","1","15074","115158","3306.8587500000003","0.04298916375","2.0301313938750066E7","263.91708120374807"
"7668","15074","15068","2","15070","115160","3305.98125","0.04297775624999999","2.0304619920000065E7","263.9600589599981"
"7669","15070","15063","9","15072","115169","3306.4199999999996","0.042983459999999994","2.0307926340000067E7","264.0030424199981"
"7670","15072","15071","7","15078","115176","3307.73625","0.043000571249999994","2.0311234076250065E7","264.0460429912481"
"7671","15078","15074","6","15080","115182","3308.175","0.043006275","2.0314542251250066E7","264.0890492662481"
"7672","15080","15072","3","15075","115185","3307.078125","0.042992015625","2.0317849329375066E7","264.13204128187306"
"7673","15075","15066","3","15069","115188","3305.761875","0.042974904375","2.0321155091250066E7","264.17501618624806"
"7674","15069","15064","7","15071","115195","3306.200625","0.042980608125","2.0324461291875064E7","264.21799679437305"
"7675","15071","15066","2","15068","115197","3305.5425","0.042972052499999996","2.0327766834375065E7","264.260968846873"
"7676","15068","15062","4","15066","115201","3305.10375","0.04296634875","2.0331071938125066E7","264.303935195623"
"7677","15066","15062","6","15068","115207","3305.5425","0.042972052499999996","2.0334377480625067E7","264.346907248123"
"7678","15068","15062","3","15065","115210","3304.884375","0.042963496875","2.0337682365000065E7","264.389870744998"
"7679","15065","15060","9","15069","115219","3305.761875","0.042974904375","2.0340988126875065E7","264.432845649373"
"7680","15069","15060","4","15064","115223","3304.665","0.042960645","2.0344292791875064E7","264.475806294373"
"7681","15064","15063","6","15069","115229","3305.761875","0.042974904375","2.0347598553750064E7","264.518781198748"
"7682","15069","15060","3","15063","115232","3304.445625","0.042957793125","2.0350902999375064E7","264.561738991873"
"7683","15063","15060","3","15063","115235","3304.445625","0.042957793125","2.0354207445000064E7","264.60469678499805"
"7684","15063","15058","5","15063","115240","3304.445625","0.042957793125","2.0357511890625063E7","264.6476545781231"
"7685","15063","15057","9","15066","115249","3305.10375","0.04296634875","2.0360816994375065E7","264.69062092687307"
"7686","15066","15063","1","15064","115250","3304.665","0.042960645","2.0364121659375064E7","264.73358157187306"
"7687","15064","15059","8","15067","115258","3305.323125","0.042969200624999995","2.0367426982500065E7","264.77655077249807"
"7688","15067","15062","1","15063","115259","3304.445625","0.042957793125","2.0370731428125065E7","264.8195085656231"
"7689","15063","15062","2","15064","115261","3304.665","0.042960645","2.0374036093125064E7","264.8624692106231"
"7690","15064","15063","2","15065","115263","3304.884375","0.042963496875","2.0377340977500062E7","264.9054327074981"
"7691","15065","15057","3","15060","115266","3303.7875","0.042949237499999994","2.0380644765000064E7","264.9483819449981"
"7692","15060","15052","4","15056","115270","3302.9100000000003","0.04293783","2.0383947675000064E7","264.99131977499815"
"7693","15056","15050","5","15055","115275","3302.690625","0.042934978125","2.0387250365625065E7","265.03425475312315"
"7694","15055","15051","6","15057","115281","3303.129374999999","0.042940681874999984","2.0390553495000064E7","265.07719543499815"
"7695","15057","15050","6","15056","115287","3302.9100000000003","0.04293783","2.0393856405000065E7","265.1201332649982"
"7696","15056","15054","7","15061","115294","3304.006875","0.042952089374999995","2.0397160411875065E7","265.16308535437315"
"7697","15061","15053","1","15054","115295","3302.4712500000005","0.04293212625","2.0400462883125067E7","265.20601748062313"
"7698","15054","15051","7","15058","115302","3303.3487499999997","0.04294353374999999","2.0403766231875066E7","265.24896101437315"
"7699","15058","15055","8","15063","115310","3304.445625","0.042957793125","2.0407070677500065E7","265.2919188074982"
"7700","15063","15057","4","15061","115314","3304.006875","0.042952089374999995","2.0410374684375066E7","265.33487089687316"
"7701","15061","15052","1","15053","115315","3302.251875","0.042929274375","2.0413676936250065E7","265.37780017124817"
"7702","15053","15044","2","15046","115317","3300.71625","0.04290931125","2.0416977652500063E7","265.4207094824982"
"7703","15046","15043","7","15050","115324","3301.59375","0.042920718749999996","2.0420279246250063E7","265.4636302012482"
"7704","15050","15048","2","15050","115326","3301.59375","0.042920718749999996","2.0423580840000063E7","265.5065509199982"
"7705","15050","15047","1","15048","115327","3301.1549999999997","0.042915014999999994","2.0426881995000064E7","265.5494659349982"
"7706","15048","15047","2","15049","115329","3301.3743750000003","0.042917866875","2.0430183369375065E7","265.59238380187315"
"7707","15049","15041","8","15049","115337","3301.3743750000003","0.042917866875","2.0433484743750066E7","265.6353016687481"
"7708","15049","15041","3","15044","115340","3300.2775","0.042903607499999996","2.0436785021250065E7","265.67820527624815"
"7709","15044","15043","3","15046","115343","3300.71625","0.04290931125","2.0440085737500064E7","265.72111458749816"
"7710","15046","15045","3","15048","115346","3301.1549999999997","0.042915014999999994","2.0443386892500065E7","265.76402960249817"
"7711","15048","15046","9","15055","115355","3302.690625","0.042934978125","2.0446689583125066E7","265.8069645806232"
"7712","15055","15052","9","15061","115364","3304.006875","0.042952089374999995","2.0449993590000067E7","265.84991666999815"
"7713","15061","15058","5","15063","115369","3304.445625","0.042957793125","2.0453298035625067E7","265.8928744631232"
"7714","15063","15055","5","15060","115374","3303.7875","0.042949237499999994","2.0456601823125068E7","265.9358237006232"
"7715","15060","15051","1","15052","115375","3302.0325","0.04292642249999999","2.0459903855625067E7","265.9787501231232"
"7716","15052","15047","3","15050","115378","3301.59375","0.042920718749999996","2.0463205449375067E7","266.0216708418732"
"7717","15050","15049","1","15050","115379","3301.59375","0.042920718749999996","2.0466507043125067E7","266.06459156062317"
"7718","15050","15043","5","15048","115384","3301.1549999999997","0.042915014999999994","2.0469808198125068E7","266.1075065756232"
"7719","15048","15047","3","15050","115387","3301.59375","0.042920718749999996","2.0473109791875068E7","266.1504272943732"
"7720","15050","15047","8","15055","115395","3302.690625","0.042934978125","2.047641248250007E7","266.1933622724982"
"7721","15055","15047","2","15049","115397","3301.3743750000003","0.042917866875","2.047971385687507E7","266.23628013937315"
"7722","15049","15040","1","15041","115398","3299.619375","0.042895051875","2.048301347625007E7","266.27917519124816"
"7723","15041","15032","8","15040","115406","3299.4","0.0428922","2.048631287625007E7","266.32206739124814"
"7724","15040","15035","5","15040","115411","3299.4","0.0428922","2.0489612276250068E7","266.3649595912481"
"7725","15040","15033","9","15042","115420","3299.83875","0.042897903749999994","2.049291211500007E7","266.4078574949981"
"7726","15042","15034","3","15037","115423","3298.7418749999997","0.042883644374999995","2.049621085687507E7","266.4507411393731"
"7727","15037","15028","5","15033","115428","3297.8643749999997","0.04287223687499999","2.049950872125007E7","266.4936133762481"
"7728","15033","15024","3","15027","115431","3296.548125","0.042855125625","2.0502805269375067E7","266.5364685018731"
"7729","15027","15025","8","15033","115439","3297.8643749999997","0.04287223687499999","2.0506103133750066E7","266.5793407387481"
"7730","15033","15027","6","15033","115445","3297.8643749999997","0.04287223687499999","2.0509400998125065E7","266.6222129756231"
"7731","15033","15027","2","15029","115447","3296.9868750000005","0.042860829375000006","2.0512697985000066E7","266.6650738049981"
"7732","15029","15028","3","15031","115450","3297.4256250000003","0.042866533125","2.0515995410625067E7","266.7079403381231"
"7733","15031","15027","6","15033","115456","3297.8643749999997","0.04287223687499999","2.0519293275000066E7","266.75081257499806"
"7734","15033","15026","8","15034","115464","3298.08375","0.04287508874999999","2.0522591358750064E7","266.7936876637481"
"7735","15034","15025","8","15033","115472","3297.8643749999997","0.04287223687499999","2.0525889223125063E7","266.83655990062306"
"7736","15033","15029","1","15030","115473","3297.20625","0.04286368125","2.0529186429375064E7","266.8794235818731"
"7737","15030","15029","8","15037","115481","3298.7418749999997","0.042883644374999995","2.0532485171250064E7","266.9223072262481"
"7738","15037","15031","8","15039","115489","3299.180625","0.042889348125","2.0535784351875063E7","266.9651965743731"
"7739","15039","15037","4","15041","115493","3299.619375","0.042895051875","2.0539083971250065E7","267.00809162624813"
"7740","15041","15034","4","15038","115497","3298.96125","0.042886496249999996","2.0542382932500064E7","267.0509781224981"
"7741","15038","15035","9","15044","115506","3300.2775","0.042903607499999996","2.0545683210000064E7","267.09388172999815"
"7742","15044","15040","1","15041","115507","3299.619375","0.042895051875","2.0548982829375066E7","267.13677678187315"
"7743","15041","15034","1","15035","115508","3298.303125","0.042877940625","2.0552281132500067E7","267.1796547224981"
"7744","15035","15026","6","15032","115514","3297.644999999999","0.04286938499999998","2.0555578777500067E7","267.22252410749815"
"7745","15032","15029","2","15031","115516","3297.4256250000003","0.042866533125","2.0558876203125067E7","267.26539064062314"
"7746","15031","15022","3","15025","115519","3296.109375","0.042849421874999995","2.0562172312500067E7","267.30824006249816"
"7747","15025","15019","4","15023","115523","3295.6706249999997","0.04284371812499999","2.056546798312507E7","267.3510837806232"
"7748","15023","15016","7","15023","115530","3295.6706249999997","0.04284371812499999","2.056876365375007E7","267.3939274987482"
"7749","15023","15021","6","15027","115536","3296.548125","0.042855125625","2.057206020187507E7","267.4367826243732"
"7750","15027","15026","1","15027","115537","3296.548125","0.042855125625","2.0575356750000067E7","267.47963774999823"
"7751","15027","15021","3","15024","115540","3295.8900000000003","0.04284657","2.0578652640000068E7","267.5224843199982"
"7752","15024","15019","5","15024","115545","3295.8900000000003","0.04284657","2.058194853000007E7","267.5653308899982"
"7753","15024","15021","5","15026","115550","3296.32875","0.042852273749999996","2.0585244858750068E7","267.6081831637482"
"7754","15026","15024","3","15027","115553","3296.548125","0.042855125625","2.0588541406875066E7","267.6510382893732"
"7755","15027","15021","4","15025","115557","3296.109375","0.042849421874999995","2.0591837516250066E7","267.69388771124824"
"7756","15025","15021","1","15022","115558","3295.4512499999996","0.04284086624999999","2.059513296750007E7","267.73672857749824"
"7757","15022","15018","9","15027","115567","3296.548125","0.042855125625","2.0598429515625067E7","267.77958370312325"
"7758","15027","15025","3","15028","115570","3296.7675","0.0428579775","2.0601726283125065E7","267.8224416806232"
"7759","15028","15019","3","15022","115573","3295.4512499999996","0.04284086624999999","2.0605021734375067E7","267.86528254687323"
"7760","15022","15017","8","15025","115581","3296.109375","0.042849421874999995","2.0608317843750067E7","267.90813196874825"
"7761","15025","15016","2","15018","115583","3294.57375","0.04282945875","2.0611612417500068E7","267.95096142749827"
"7762","15018","15017","9","15026","115592","3296.32875","0.042852273749999996","2.0614908746250067E7","267.99381370124826"
"7763","15026","15019","9","15028","115601","3296.7675","0.0428579775","2.0618205513750065E7","268.03667167874823"
"7764","15028","15023","8","15031","115609","3297.4256250000003","0.042866533125","2.0621502939375065E7","268.0795382118732"
"7765","15031","15025","6","15031","115615","3297.4256250000003","0.042866533125","2.0624800365000065E7","268.1224047449982"
"7766","15031","15030","1","15031","115616","3297.4256250000003","0.042866533125","2.0628097790625066E7","268.1652712781232"
"7767","15031","15030","1","15031","115617","3297.4256250000003","0.042866533125","2.0631395216250066E7","268.2081378112482"
"7768","15031","15026","5","15031","115622","3297.4256250000003","0.042866533125","2.0634692641875066E7","268.2510043443732"
"7769","15031","15025","7","15032","115629","3297.644999999999","0.04286938499999998","2.0637990286875065E7","268.2938737293732"
"7770","15032","15031","4","15035","115633","3298.303125","0.042877940625","2.0641288590000067E7","268.3367516699982"
"7771","15035","15031","2","15033","115635","3297.8643749999997","0.04287223687499999","2.0644586454375066E7","268.3796239068732"
"7772","15033","15025","8","15033","115643","3297.8643749999997","0.04287223687499999","2.0647884318750065E7","268.42249614374816"
"7773","15033","15026","1","15027","115644","3296.548125","0.042855125625","2.0651180866875064E7","268.4653512693732"
"7774","15027","15025","8","15033","115652","3297.8643749999997","0.04287223687499999","2.0654478731250063E7","268.50822350624816"
"7775","15033","15025","2","15027","115654","3296.548125","0.042855125625","2.065777527937506E7","268.55107863187317"
"7776","15027","15022","4","15026","115658","3296.32875","0.042852273749999996","2.066107160812506E7","268.59393090562315"
"7777","15026","15021","1","15022","115659","3295.4512499999996","0.04284086624999999","2.0664367059375063E7","268.63677177187316"
"7778","15022","15017","7","15024","115666","3295.8900000000003","0.04284657","2.0667662949375063E7","268.67961834187315"
"7779","15024","15021","9","15030","115675","3297.20625","0.04286368125","2.0670960155625064E7","268.7224820231232"
"7780","15030","15023","1","15024","115676","3295.8900000000003","0.04284657","2.0674256045625065E7","268.7653285931232"
"7781","15024","15021","6","15027","115682","3296.548125","0.042855125625","2.0677552593750063E7","268.8081837187482"
"7782","15027","15024","8","15032","115690","3297.644999999999","0.04286938499999998","2.0680850238750063E7","268.8510531037482"
"7783","15032","15030","3","15033","115693","3297.8643749999997","0.04287223687499999","2.068414810312506E7","268.8939253406232"
"7784","15033","15027","1","15028","115694","3296.7675","0.0428579775","2.068744487062506E7","268.93678331812316"
"7785","15028","15020","3","15023","115697","3295.6706249999997","0.04284371812499999","2.069074054125006E7","268.9796270362482"
"7786","15023","15019","1","15020","115698","3295.0125","0.042835162499999996","2.069403555375006E7","269.0224621987482"
"7787","15020","15013","1","15014","115699","3293.69625","0.042818051249999996","2.069732925000006E7","269.0652802499982"
"7788","15014","15011","5","15016","115704","3294.135","0.042823755","2.070062338500006E7","269.10810400499815"
"7789","15016","15010","3","15013","115707","3293.476875","0.042815199374999995","2.070391686187506E7","269.15091920437317"
"7790","15013","15008","2","15010","115709","3292.81875","0.04280664375","2.0707209680625062E7","269.19372584812317"
"7791","15010","15005","1","15006","115710","3291.9412500000003","0.04279523625","2.0710501621875063E7","269.2365210843732"
"7792","15006","15003","3","15006","115713","3291.9412500000003","0.04279523625","2.0713793563125063E7","269.2793163206232"
"7793","15006","15001","1","15002","115714","3291.06375","0.042783828749999996","2.071708462687506E7","269.32210014937317"
"7794","15002","15000","8","15008","115722","3292.3799999999997","0.042800939999999996","2.072037700687506E7","269.3649010893732"
"7795","15008","15005","6","15011","115728","3293.038125","0.042809495625","2.072367004500006E7","269.4077105849982"
"7796","15011","15004","4","15008","115732","3292.3799999999997","0.042800939999999996","2.072696242500006E7","269.4505115249982"
"7797","15008","14999","5","15004","115737","3291.5025000000005","0.042789532500000005","2.073025392750006E7","269.49330105749823"
"7798","15004","15003","6","15009","115743","3292.599375","0.042803791875","2.073354652687506E7","269.5361048493732"
"7799","15009","15002","7","15009","115750","3292.599375","0.042803791875","2.073683912625006E7","269.5789086412482"
"7800","15009","15000","2","15002","115752","3291.06375","0.042783828749999996","2.0740130190000057E7","269.62169246999815"
"7801","15002","14997","4","15001","115756","3290.844375","0.042780976875","2.0743421034375057E7","269.66447344687316"
"7802","15001","14996","1","14997","115757","3289.9668749999996","0.04276956937499999","2.074671100125006E7","269.7072430162482"
"7803","14997","14994","1","14995","115758","3289.528125","0.042763865624999994","2.0750000529375058E7","269.75000688187316"
"7804","14995","14992","8","15000","115766","3290.625","0.042778125","2.0753291154375058E7","269.79278500687315"
"7805","15000","14999","2","15001","115768","3290.844375","0.042780976875","2.0756581998750057E7","269.83556598374815"
"7806","15001","14998","6","15004","115774","3291.5025000000005","0.042789532500000005","2.075987350125006E7","269.8783555162482"
"7807","15004","14997","4","15001","115778","3290.844375","0.042780976875","2.0763164345625058E7","269.9211364931232"
"7808","15001","14996","7","15003","115785","3291.283125","0.042786680625","2.0766455628750056E7","269.9639231737482"
"7809","15003","14995","2","14997","115787","3289.9668749999996","0.04276956937499999","2.0769745595625058E7","270.0066927431232"
"7810","14997","14988","1","14989","115788","3288.211875","0.042746754374999994","2.0773033807500057E7","270.0494394974982"
"7811","14989","14988","6","14994","115794","3289.30875","0.04276101375","2.0776323116250057E7","270.0922005112482"
"7812","14994","14986","1","14987","115795","3287.7731249999997","0.04274105062499999","2.0779610889375057E7","270.13494156187323"
"7813","14987","14980","7","14987","115802","3287.7731249999997","0.04274105062499999","2.0782898662500057E7","270.17768261249824"
"7814","14987","14980","1","14981","115803","3286.4568750000003","0.042723939375","2.0786185119375058E7","270.2204065518732"
"7815","14981","14972","5","14977","115808","3285.579375","0.042712531874999994","2.0789470698750056E7","270.2631190837482"
"7816","14977","14976","8","14984","115816","3287.115","0.042732494999999995","2.0792757813750055E7","270.3058515787482"
"7817","14984","14982","4","14986","115820","3287.55375","0.04273819875","2.0796045367500056E7","270.3485897774982"
"7818","14986","14978","1","14979","115821","3286.0181250000005","0.042718235625","2.0799331385625057E7","270.3913080131232"
"7819","14979","14971","1","14972","115822","3284.4824999999996","0.042698272499999995","2.080261586812506E7","270.4340062856232"
"7820","14972","14963","6","14969","115828","3283.824375","0.042689716875","2.080589969250006E7","270.47669600249816"
"7821","14969","14966","8","14974","115836","3284.9212500000003","0.042703976250000004","2.080918461375006E7","270.51939997874814"
"7822","14974","14967","5","14972","115841","3284.4824999999996","0.042698272499999995","2.081246909625006E7","270.56209825124813"
"7823","14972","14971","6","14977","115847","3285.579375","0.042712531874999994","2.081575467562506E7","270.6048107831231"
"7824","14977","14973","9","14982","115856","3286.676249999999","0.042726791249999986","2.081904135187506E7","270.64753757437313"
"7825","14982","14979","9","14988","115865","3287.9925","0.04274390249999999","2.082232934437506E7","270.6902814768731"
"7826","14988","14984","7","14991","115872","3288.650625","0.042752458125000004","2.082561799500006E7","270.7330339349981"
"7827","14991","14983","9","14992","115881","3288.87","0.04275531","2.082890686500006E7","270.7757892449981"
"7828","14992","14989","9","14998","115890","3290.1862499999997","0.04277242124999999","2.0832197051250063E7","270.8185616662481"
"7829","14998","14995","6","15001","115896","3290.844375","0.042780976875","2.0835487895625062E7","270.8613426431231"
"7830","15001","14999","5","15004","115901","3291.5025000000005","0.042789532500000005","2.0838779398125064E7","270.90413217562315"
"7831","15004","15003","8","15011","115909","3293.038125","0.042809495625","2.0842072436250065E7","270.94694167124817"
"7832","15011","15003","6","15009","115915","3292.599375","0.042803791875","2.0845365035625063E7","270.98974546312314"
"7833","15009","15001","4","15005","115919","3291.721875","0.042792384375","2.0848656757500064E7","271.03253784749813"
"7834","15005","15003","5","15008","115924","3292.3799999999997","0.042800939999999996","2.0851949137500063E7","271.07533878749814"
"7835","15008","15000","3","15003","115927","3291.283125","0.042786680625","2.085524042062506E7","271.11812546812314"
"7836","15003","15000","2","15002","115929","3291.06375","0.042783828749999996","2.085853148437506E7","271.1609092968731"
"7837","15002","14996","1","14997","115930","3289.9668749999996","0.04276956937499999","2.086182145125006E7","271.20367886624814"
"7838","14997","14992","6","14998","115936","3290.1862499999997","0.04277242124999999","2.0865111637500063E7","271.24645128749813"
"7839","14998","14995","8","15003","115944","3291.283125","0.042786680625","2.086840292062506E7","271.28923796812313"
"7840","15003","15000","1","15001","115945","3290.844375","0.042780976875","2.087169376500006E7","271.33201894499814"
"7841","15001","14993","2","14995","115947","3289.528125","0.042763865624999994","2.087498329312506E7","271.3747828106231"
"7842","14995","14992","7","14999","115954","3290.4056250000003","0.042775273125","2.087827369875006E7","271.41755808374813"
"7843","14999","14990","7","14997","115961","3289.9668749999996","0.04276956937499999","2.088156366562506E7","271.46032765312316"
"7844","14997","14993","1","14994","115962","3289.30875","0.04276101375","2.088485297437506E7","271.50308866687317"
"7845","14994","14987","8","14995","115970","3289.528125","0.042763865624999994","2.088814250250006E7","271.54585253249815"
"7846","14995","14993","6","14999","115976","3290.4056250000003","0.042775273125","2.089143290812506E7","271.58862780562316"
"7847","14999","14990","1","14991","115977","3288.650625","0.042752458125000004","2.0894721558750063E7","271.63138026374816"
"7848","14991","14988","8","14996","115985","3289.7475","0.042766717499999995","2.089801130625006E7","271.67414698124816"
"7849","14996","14994","3","14997","115988","3289.9668749999996","0.04276956937499999","2.0901301273125064E7","271.7169165506232"
"7850","14997","14992","7","14999","115995","3290.4056250000003","0.042775273125","2.0904591678750064E7","271.7596918237482"
"7851","14999","14997","6","15003","116001","3291.283125","0.042786680625","2.0907882961875062E7","271.8024785043732"
"7852","15003","15002","7","15009","116008","3292.599375","0.042803791875","2.091117556125006E7","271.8452822962482"
"7853","15009","15002","2","15004","116010","3291.5025000000005","0.042789532500000005","2.0914467063750062E7","271.8880718287482"
"7854","15004","15002","1","15003","116011","3291.283125","0.042786680625","2.091775834687506E7","271.9308585093732"
"7855","15003","15002","2","15004","116013","3291.5025000000005","0.042789532500000005","2.092104984937506E7","271.9736480418732"
"7856","15004","15002","6","15008","116019","3292.3799999999997","0.042800939999999996","2.092434222937506E7","272.0164489818732"
"7857","15008","15006","9","15015","116028","3293.915625","0.042820903125","2.092763614500006E7","272.05926988499823"
"7858","15015","15007","9","15016","116037","3294.135","0.042823755","2.093093028000006E7","272.1020936399982"
"7859","15016","15010","6","15016","116043","3294.135","0.042823755","2.0934224415000062E7","272.1449173949982"
"7860","15016","15009","1","15010","116044","3292.81875","0.04280664375","2.0937517233750064E7","272.1877240387482"
"7861","15010","15008","2","15010","116046","3292.81875","0.04280664375","2.0940810052500065E7","272.23053068249817"
"7862","15010","15008","5","15013","116051","3293.476875","0.042815199374999995","2.0944103529375065E7","272.2733458818732"
"7863","15013","15005","9","15014","116060","3293.69625","0.042818051249999996","2.0947397225625064E7","272.31616393312316"
"7864","15014","15011","6","15017","116066","3294.354375","0.042826606875","2.0950691580000065E7","272.35899053999816"
"7865","15017","15015","4","15019","116070","3294.793125","0.042832310625","2.0953986373125065E7","272.40182285062315"
"7866","15019","15016","5","15021","116075","3295.231875","0.042838014375","2.0957281605000064E7","272.4446608649981"
"7867","15021","15013","6","15019","116081","3294.793125","0.042832310625","2.0960576398125064E7","272.4874931756231"
"7868","15019","15010","9","15019","116090","3294.793125","0.042832310625","2.0963871191250063E7","272.5303254862481"
"7869","15019","15014","8","15022","116098","3295.4512499999996","0.04284086624999999","2.0967166642500065E7","272.5731663524981"
"7870","15022","15020","3","15023","116101","3295.6706249999997","0.04284371812499999","2.0970462313125066E7","272.61601007062313"
"7871","15023","15022","4","15026","116105","3296.32875","0.042852273749999996","2.0973758641875066E7","272.6588623443731"
"7872","15026","15020","9","15029","116114","3296.9868750000005","0.042860829375000006","2.0977055628750067E7","272.7017231737481"
"7873","15029","15024","8","15032","116122","3297.644999999999","0.04286938499999998","2.0980353273750067E7","272.74459255874814"
"7874","15032","15024","6","15030","116128","3297.20625","0.04286368125","2.0983650480000068E7","272.78745623999816"
"7875","15030","15029","2","15031","116130","3297.4256250000003","0.042866533125","2.0986947905625068E7","272.83032277312316"
"7876","15031","15027","5","15032","116135","3297.644999999999","0.04286938499999998","2.0990245550625067E7","272.8731921581232"
"7877","15032","15023","4","15027","116139","3296.548125","0.042855125625","2.0993542098750066E7","272.9160472837482"
"7878","15027","15019","5","15024","116144","3295.8900000000003","0.04284657","2.0996837988750067E7","272.9588938537482"
"7879","15024","15021","2","15023","116146","3295.6706249999997","0.04284371812499999","2.1000133659375068E7","273.0017375718732"
"7880","15023","15015","3","15018","116149","3294.57375","0.04282945875","2.100342823312507E7","273.0445670306232"
"7881","15018","15011","6","15017","116155","3294.354375","0.042826606875","2.100672258750007E7","273.0873936374982"
"7882","15017","15009","7","15016","116162","3294.135","0.042823755","2.101001672250007E7","273.1302173924982"
"7883","15016","15015","5","15020","116167","3295.0125","0.042835162499999996","2.101331173500007E7","273.1730525549982"
"7884","15020","15011","9","15020","116176","3295.0125","0.042835162499999996","2.101660674750007E7","273.2158877174982"
"7885","15020","15011","9","15020","116185","3295.0125","0.042835162499999996","2.101990176000007E7","273.25872287999823"
"7886","15020","15012","2","15014","116187","3293.69625","0.042818051249999996","2.1023195456250068E7","273.3015409312482"
"7887","15014","15007","8","15015","116195","3293.915625","0.042820903125","2.1026489371875066E7","273.3443618343732"
"7888","15015","15006","9","15015","116204","3293.915625","0.042820903125","2.1029783287500065E7","273.3871827374982"
"7889","15015","15013","4","15017","116208","3294.354375","0.042826606875","2.1033077641875066E7","273.4300093443732"
"7890","15017","15016","3","15019","116211","3294.793125","0.042832310625","2.1036372435000066E7","273.4728416549982"
"7891","15019","15014","5","15019","116216","3294.793125","0.042832310625","2.1039667228125066E7","273.5156739656232"
"7892","15019","15016","5","15021","116221","3295.231875","0.042838014375","2.1042962460000064E7","273.5585119799982"
"7893","15021","15019","7","15026","116228","3296.32875","0.042852273749999996","2.1046258788750064E7","273.60136425374816"
"7894","15026","15022","7","15029","116235","3296.9868750000005","0.042860829375000006","2.1049555775625065E7","273.64422508312316"
"7895","15029","15024","9","15033","116244","3297.8643749999997","0.04287223687499999","2.1052853640000064E7","273.68709731999814"
"7896","15033","15026","7","15033","116251","3297.8643749999997","0.04287223687499999","2.1056151504375063E7","273.72996955687313"
"7897","15033","15032","5","15037","116256","3298.7418749999997","0.042883644374999995","2.1059450246250063E7","273.77285320124815"
"7898","15037","15031","1","15032","116257","3297.644999999999","0.04286938499999998","2.1062747891250063E7","273.81572258624817"
"7899","15032","15026","7","15033","116264","3297.8643749999997","0.04287223687499999","2.106604575562506E7","273.85859482312316"
"7900","15033","15030","5","15035","116269","3298.303125","0.042877940625","2.1069344058750063E7","273.90147276374813"
"7901","15035","15034","5","15039","116274","3299.180625","0.042889348125","2.1072643239375062E7","273.94436211187315"
"7902","15039","15034","8","15042","116282","3299.83875","0.042897903749999994","2.1075943078125063E7","273.9872600156231"
"7903","15042","15039","2","15041","116284","3299.619375","0.042895051875","2.1079242697500065E7","274.03015506749813"
"7904","15041","15032","4","15036","116288","3298.5225","0.0428807925","2.1082541220000066E7","274.07303585999813"
"7905","15036","15033","3","15036","116291","3298.5225","0.0428807925","2.1085839742500067E7","274.11591665249813"
"7906","15036","15029","7","15036","116298","3298.5225","0.0428807925","2.1089138265000068E7","274.15879744499813"
"7907","15036","15033","2","15035","116300","3298.303125","0.042877940625","2.109243656812507E7","274.2016753856231"
"7908","15035","15032","7","15039","116307","3299.180625","0.042889348125","2.109573574875007E7","274.2445647337481"
"7909","15039","15034","3","15037","116310","3298.7418749999997","0.042883644374999995","2.109903449062507E7","274.28744837812314"
"7910","15037","15033","7","15040","116317","3299.4","0.0428922","2.1102333890625067E7","274.3303405781231"
"7911","15040","15038","6","15044","116323","3300.2775","0.042903607499999996","2.1105634168125067E7","274.37324418562315"
"7912","15044","15042","5","15047","116328","3300.9356249999996","0.04291216312499999","2.110893510375007E7","274.41615634874813"
"7913","15047","15046","2","15048","116330","3301.1549999999997","0.042915014999999994","2.111223625875007E7","274.45907136374814"
"7914","15048","15044","9","15053","116339","3302.251875","0.042929274375","2.1115538510625068E7","274.50200063812315"
"7915","15053","15047","1","15048","116340","3301.1549999999997","0.042915014999999994","2.111883966562507E7","274.54491565312316"
"7916","15048","15045","3","15048","116343","3301.1549999999997","0.042915014999999994","2.112214082062507E7","274.58783066812316"
"7917","15048","15044","7","15051","116350","3301.813125","0.042923570625","2.112544263375007E7","274.6307542387482"
"7918","15051","15044","9","15053","116359","3302.251875","0.042929274375","2.1128744885625068E7","274.6736835131232"
"7919","15053","15047","1","15048","116360","3301.1549999999997","0.042915014999999994","2.113204604062507E7","274.7165985281232"
"7920","15048","15046","7","15053","116367","3302.251875","0.042929274375","2.1135348292500068E7","274.7595278024982"
"7921","15053","15045","5","15050","116372","3301.59375","0.042920718749999996","2.1138649886250068E7","274.8024485212482"
"7922","15050","15049","5","15054","116377","3302.4712500000005","0.04293212625","2.114195235750007E7","274.8453806474982"
"7923","15054","15051","8","15059","116385","3303.568125","0.04294638562499999","2.1145255925625067E7","274.8883270331232"
"7924","15059","15054","6","15060","116391","3303.7875","0.042949237499999994","2.114855971312507E7","274.9312762706232"
"7925","15060","15057","6","15063","116397","3304.445625","0.042957793125","2.115186415875007E7","274.9742340637482"
"7926","15063","15056","4","15060","116401","3303.7875","0.042949237499999994","2.115516794625007E7","275.0171833012482"
"7927","15060","15052","1","15053","116402","3302.251875","0.042929274375","2.1158470198125068E7","275.06011257562324"
"7928","15053","15047","6","15053","116408","3302.251875","0.042929274375","2.1161772450000066E7","275.10304184999825"
"7929","15053","15050","6","15056","116414","3302.9100000000003","0.04293783","2.1165075360000066E7","275.1459796799983"
"7930","15056","15047","7","15054","116421","3302.4712500000005","0.04293212625","2.1168377831250068E7","275.18891180624826"
"7931","15054","15050","2","15052","116423","3302.0325","0.04292642249999999","2.1171679863750067E7","275.23183822874825"
"7932","15052","15048","2","15050","116425","3301.59375","0.042920718749999996","2.1174981457500067E7","275.27475894749824"
"7933","15050","15049","1","15050","116426","3301.59375","0.042920718749999996","2.1178283051250067E7","275.31767966624824"
"7934","15050","15047","3","15050","116429","3301.59375","0.042920718749999996","2.1181584645000067E7","275.36060038499824"
"7935","15050","15041","4","15045","116433","3300.496875","0.042906459375","2.1184885141875066E7","275.4035068443732"
"7936","15045","15043","2","15045","116435","3300.496875","0.042906459375","2.1188185638750065E7","275.4464133037482"
"7937","15045","15039","6","15045","116441","3300.496875","0.042906459375","2.1191486135625064E7","275.4893197631232"
"7938","15045","15043","5","15048","116446","3301.1549999999997","0.042915014999999994","2.1194787290625066E7","275.5322347781232"
"7939","15048","15041","1","15042","116447","3299.83875","0.042897903749999994","2.1198087129375067E7","275.5751326818732"
"7940","15042","15033","9","15042","116456","3299.83875","0.042897903749999994","2.1201386968125068E7","275.61803058562316"
"7941","15042","15034","7","15041","116463","3299.619375","0.042895051875","2.120468658750007E7","275.66092563749817"
"7942","15041","15038","9","15047","116472","3300.9356249999996","0.04291216312499999","2.120798752312507E7","275.70383780062315"
"7943","15047","15046","9","15055","116481","3302.690625","0.042934978125","2.121129021375007E7","275.74677277874815"
"7944","15055","15053","2","15055","116483","3302.690625","0.042934978125","2.1214592904375073E7","275.78970775687316"
"7945","15055","15050","4","15054","116487","3302.4712500000005","0.04293212625","2.1217895375625074E7","275.83263988312314"
"7946","15054","15053","9","15062","116496","3304.2262499999997","0.042954941249999996","2.1221199601875074E7","275.87559482437314"
"7947","15062","15061","9","15070","116505","3305.98125","0.04297775624999999","2.1224505583125073E7","275.91857258062316"
"7948","15070","15064","4","15068","116509","3305.5425","0.042972052499999996","2.1227811125625074E7","275.96154463312314"
"7949","15068","15061","6","15067","116515","3305.323125","0.042969200624999995","2.1231116448750075E7","276.00451383374815"
"7950","15067","15062","5","15067","116520","3305.323125","0.042969200624999995","2.1234421771875076E7","276.04748303437316"
"7951","15067","15061","5","15066","116525","3305.10375","0.04296634875","2.1237726875625078E7","276.09044938312314"
"7952","15066","15063","1","15064","116526","3304.665","0.042960645","2.1241031540625077E7","276.13341002812314"
"7953","15064","15055","4","15059","116530","3303.568125","0.04294638562499999","2.1244335108750075E7","276.1763564137481"
"7954","15059","15056","6","15062","116536","3304.2262499999997","0.042954941249999996","2.1247639335000075E7","276.2193113549981"
"7955","15062","15056","6","15062","116542","3304.2262499999997","0.042954941249999996","2.1250943561250076E7","276.26226629624813"
"7956","15062","15056","9","15065","116551","3304.884375","0.042963496875","2.1254248445625074E7","276.30522979312315"
"7957","15065","15059","8","15067","116559","3305.323125","0.042969200624999995","2.1257553768750075E7","276.34819899374816"
"7958","15067","15061","5","15066","116564","3305.10375","0.04296634875","2.1260858872500077E7","276.39116534249814"
"7959","15066","15065","2","15067","116566","3305.323125","0.042969200624999995","2.1264164195625078E7","276.43413454312315"
"7960","15067","15065","6","15071","116572","3306.200625","0.042980608125","2.1267470396250077E7","276.47711515124814"
"7961","15071","15067","4","15071","116576","3306.200625","0.042980608125","2.1270776596875075E7","276.52009575937313"
"7962","15071","15066","7","15073","116583","3306.6393749999997","0.042986311874999995","2.1274083236250076E7","276.5630820712481"
"7963","15073","15067","4","15071","116587","3306.200625","0.042980608125","2.1277389436875075E7","276.6060626793731"
"7964","15071","15070","8","15078","116595","3307.73625","0.043000571249999994","2.1280697173125073E7","276.6490632506231"
"7965","15078","15071","1","15072","116596","3306.4199999999996","0.042983459999999994","2.1284003593125075E7","276.6920467106231"
"7966","15072","15069","1","15070","116597","3305.98125","0.04297775624999999","2.1287309574375074E7","276.73502446687314"
"7967","15070","15062","4","15066","116601","3305.10375","0.04296634875","2.1290614678125076E7","276.7779908156231"
"7968","15066","15057","1","15058","116602","3303.3487499999997","0.04294353374999999","2.1293918026875075E7","276.82093434937315"
"7969","15058","15057","3","15060","116605","3303.7875","0.042949237499999994","2.1297221814375076E7","276.86388358687316"
"7970","15060","15059","7","15066","116612","3305.10375","0.04296634875","2.1300526918125078E7","276.90684993562314"
"7971","15066","15061","8","15069","116620","3305.761875","0.042974904375","2.1303832680000078E7","276.94982483999814"
"7972","15069","15063","9","15072","116629","3306.4199999999996","0.042983459999999994","2.130713910000008E7","276.99280829999816"
"7973","15072","15067","1","15068","116630","3305.5425","0.042972052499999996","2.131044464250008E7","277.03578035249814"
"7974","15068","15059","6","15065","116636","3304.884375","0.042963496875","2.131374952687508E7","277.07874384937315"
"7975","15065","15060","8","15068","116644","3305.5425","0.042972052499999996","2.131705506937508E7","277.12171590187313"
"7976","15068","15063","2","15065","116646","3304.884375","0.042963496875","2.1320359953750078E7","277.16467939874815"
"7977","15065","15056","7","15063","116653","3304.445625","0.042957793125","2.1323664399375077E7","277.2076371918732"
"7978","15063","15062","3","15065","116656","3304.884375","0.042963496875","2.1326969283750076E7","277.2506006887482"
"7979","15065","15062","7","15069","116663","3305.761875","0.042974904375","2.1330275045625076E7","277.2935755931232"
"7980","15069","15065","1","15066","116664","3305.10375","0.04296634875","2.1333580149375077E7","277.3365419418732"
"7981","15066","15059","4","15063","116668","3304.445625","0.042957793125","2.1336884595000077E7","277.3794997349982"
"7982","15063","15058","4","15062","116672","3304.2262499999997","0.042954941249999996","2.1340188821250077E7","277.4224546762482"
"7983","15062","15057","7","15064","116679","3304.665","0.042960645","2.1343493486250076E7","277.4654153212482"
"7984","15064","15063","5","15068","116684","3305.5425","0.042972052499999996","2.1346799028750077E7","277.5083873737482"
"7985","15068","15061","8","15069","116692","3305.761875","0.042974904375","2.1350104790625077E7","277.5513622781232"
"7986","15069","15068","3","15071","116695","3306.200625","0.042980608125","2.1353410991250075E7","277.59434288624817"
"7987","15071","15065","6","15071","116701","3306.200625","0.042980608125","2.1356717191875074E7","277.63732349437316"
"7988","15071","15068","4","15072","116705","3306.4199999999996","0.042983459999999994","2.1360023611875076E7","277.6803069543732"
"7989","15072","15070","7","15077","116712","3307.516875","0.04299771937499999","2.1363331128750075E7","277.7233046737482"
"7990","15077","15069","1","15070","116713","3305.98125","0.04297775624999999","2.1366637110000074E7","277.7662824299982"
"7991","15070","15066","8","15074","116721","3306.8587500000003","0.04298916375","2.1369943968750075E7","277.80927159374824"
"7992","15074","15070","1","15071","116722","3306.200625","0.042980608125","2.1373250169375073E7","277.8522522018732"
"7993","15071","15070","2","15072","116724","3306.4199999999996","0.042983459999999994","2.1376556589375075E7","277.89523566187324"
"7994","15072","15066","4","15070","116728","3305.98125","0.04297775624999999","2.1379862570625074E7","277.93821341812327"
"7995","15070","15069","7","15076","116735","3307.2975","0.0429948675","2.1383169868125074E7","277.98120828562327"
"7996","15076","15072","1","15073","116736","3306.6393749999997","0.042986311874999995","2.1386476507500075E7","278.02419459749825"
"7997","15073","15065","1","15066","116737","3305.10375","0.04296634875","2.1389781611250076E7","278.06716094624824"
"7998","15066","15059","7","15066","116744","3305.10375","0.04296634875","2.1393086715000078E7","278.1101272949982"
"7999","15066","15061","3","15064","116747","3304.665","0.042960645","2.1396391380000077E7","278.1530879399982"
"8000","15064","15059","1","15060","116748","3303.7875","0.042949237499999994","2.139969516750008E7","278.1960371774982"
"8001","15060","15056","6","15062","116754","3304.2262499999997","0.042954941249999996","2.140299939375008E7","278.23899211874823"
"8002","15062","15060","7","15067","116761","3305.323125","0.042969200624999995","2.140630471687508E7","278.28196131937324"
"8003","15067","15065","1","15066","116762","3305.10375","0.04296634875","2.140960982062508E7","278.3249276681232"
"8004","15066","15062","7","15069","116769","3305.761875","0.042974904375","2.141291558250008E7","278.3679025724982"
"8005","15069","15068","2","15070","116771","3305.98125","0.04297775624999999","2.141622156375008E7","278.41088032874825"
"8006","15070","15061","2","15063","116773","3304.445625","0.042957793125","2.141952600937508E7","278.4538381218733"
"8007","15063","15054","1","15055","116774","3302.690625","0.042934978125","2.142282870000008E7","278.4967730999983"
"8008","15055","15052","3","15055","116777","3302.690625","0.042934978125","2.1426131390625082E7","278.5397080781233"
"8009","15055","15052","7","15059","116784","3303.568125","0.04294638562499999","2.142943495875008E7","278.58265446374827"
"8010","15059","15051","8","15059","116792","3303.568125","0.04294638562499999","2.143273852687508E7","278.62560084937326"
"8011","15059","15056","6","15062","116798","3304.2262499999997","0.042954941249999996","2.143604275312508E7","278.66855579062326"
"8012","15062","15061","6","15067","116804","3305.323125","0.042969200624999995","2.143934807625008E7","278.71152499124827"
"8013","15067","15065","9","15074","116813","3306.8587500000003","0.04298916375","2.144265493500008E7","278.7545141549983"
"8014","15074","15072","6","15078","116819","3307.73625","0.043000571249999994","2.144596267125008E7","278.79751472624827"
"8015","15078","15074","3","15077","116822","3307.516875","0.04299771937499999","2.1449270188125078E7","278.8405124456233"
"8016","15077","15072","9","15081","116831","3308.3943750000003","0.043009126875000005","2.1452578582500078E7","278.8835215724983"
"8017","15081","15073","7","15080","116838","3308.175","0.043006275","2.145588675750008E7","278.9265278474983"
"8018","15080","15072","6","15078","116844","3307.73625","0.043000571249999994","2.1459194493750077E7","278.96952841874827"
"8019","15078","15070","9","15079","116853","3307.9556250000005","0.043003423125","2.1462502449375078E7","279.0125318418733"
"8020","15079","15073","8","15081","116861","3308.3943750000003","0.043009126875000005","2.146581084375008E7","279.0555409687483"
"8021","15081","15077","1","15078","116862","3307.73625","0.043000571249999994","2.1469118580000076E7","279.0985415399983"
"8022","15078","15077","9","15086","116871","3309.49125","0.04302338625","2.1472428071250077E7","279.1415649262483"
"8023","15086","15085","3","15088","116874","3309.93","0.04302908999999999","2.1475738001250077E7","279.1845940162483"
"8024","15088","15080","6","15086","116880","3309.49125","0.04302338625","2.1479047492500078E7","279.2276174024983"
"8025","15086","15085","3","15088","116883","3309.93","0.04302908999999999","2.1482357422500078E7","279.2706464924983"
"8026","15088","15086","7","15093","116890","3311.026875","0.043043349375","2.1485668449375078E7","279.3136898418733"
"8027","15093","15086","2","15088","116892","3309.93","0.04302908999999999","2.1488978379375078E7","279.35671893187333"
"8028","15088","15082","6","15088","116898","3309.93","0.04302908999999999","2.1492288309375077E7","279.39974802187334"
"8029","15088","15083","4","15087","116902","3309.7106249999997","0.04302623812499999","2.1495598020000078E7","279.4427742599983"
"8030","15087","15083","1","15084","116903","3309.0525","0.043017682499999994","2.1498907072500076E7","279.48579194249834"
"8031","15084","15082","9","15091","116912","3310.588125","0.043037645625","2.1502217660625078E7","279.52882958812336"
"8032","15091","15083","8","15091","116920","3310.588125","0.043037645625","2.150552824875008E7","279.5718672337484"
"8033","15091","15084","8","15092","116928","3310.8075","0.0430404975","2.150883905625008E7","279.61490773124837"
"8034","15092","15089","8","15097","116936","3311.9043749999996","0.043054756874999996","2.1512150960625082E7","279.65796248812336"
"8035","15097","15090","9","15099","116945","3312.3431250000003","0.043060460625000005","2.1515463303750083E7","279.70102294874835"
"8036","15099","15092","6","15098","116951","3312.1237499999997","0.04305760875","2.1518775427500084E7","279.74408055749836"
"8037","15098","15095","7","15102","116958","3313.00125","0.043069016249999995","2.1522088428750083E7","279.78714957374837"
"8038","15102","15100","3","15103","116961","3313.220625","0.043071868124999996","2.152540164937508E7","279.8302214418734"
"8039","15103","15097","4","15101","116965","3312.781875","0.043066164375","2.152871443125008E7","279.87328760624837"
"8040","15101","15094","7","15101","116972","3312.781875","0.043066164375","2.153202721312508E7","279.91635377062335"
"8041","15101","15092","2","15094","116974","3311.24625","0.04304620125","2.153533845937508E7","279.9593999718733"
"8042","15094","15091","9","15100","116983","3312.5625","0.0430633125","2.153865102187508E7","280.00246328437333"
"8043","15100","15096","7","15103","116990","3313.220625","0.043071868124999996","2.1541964242500078E7","280.04553515249836"
"8044","15103","15099","8","15107","116998","3314.098124999999","0.04308327562499999","2.1545278340625077E7","280.08861842812337"
"8045","15107","15100","3","15103","117001","3313.220625","0.043071868124999996","2.1548591561250076E7","280.1316902962484"
"8046","15103","15098","5","15103","117006","3313.220625","0.043071868124999996","2.1551904781875074E7","280.1747621643734"
"8047","15103","15094","2","15096","117008","3311.685","0.043051904999999994","2.1555216466875073E7","280.21781406937345"
"8048","15096","15092","2","15094","117010","3311.24625","0.04304620125","2.1558527713125072E7","280.2608602706234"
"8049","15094","15089","3","15092","117013","3310.8075","0.0430404975","2.1561838520625073E7","280.3039007681234"
"8050","15092","15090","2","15092","117015","3310.8075","0.0430404975","2.1565149328125075E7","280.3469412656234"
"8051","15092","15088","4","15092","117019","3310.8075","0.0430404975","2.1568460135625076E7","280.3899817631234"
"8052","15092","15088","9","15097","117028","3311.9043749999996","0.043054756874999996","2.1571772040000077E7","280.4330365199984"
"8053","15097","15094","2","15096","117030","3311.685","0.043051904999999994","2.1575083725000076E7","280.4760884249984"
"8054","15096","15092","9","15101","117039","3312.781875","0.043066164375","2.1578396506875075E7","280.5191545893734"
"8055","15101","15098","9","15107","117048","3314.098124999999","0.04308327562499999","2.1581710605000075E7","280.5622378649984"
"8056","15107","15099","4","15103","117052","3313.220625","0.043071868124999996","2.1585023825625073E7","280.6053097331234"
"8057","15103","15101","5","15106","117057","3313.8787500000003","0.04308042375","2.1588337704375073E7","280.6483901568734"
"8058","15106","15101","8","15109","117065","3314.536875","0.043088979374999996","2.159165224125007E7","280.6914791362484"
"8059","15109","15100","5","15105","117070","3313.659375","0.043077571875","2.1594965900625072E7","280.7345567081234"
"8060","15105","15097","3","15100","117073","3312.5625","0.0430633125","2.1598278463125072E7","280.77762002062343"
"8061","15100","15094","8","15102","117081","3313.00125","0.043069016249999995","2.160159146437507E7","280.82068903687343"
"8062","15102","15093","6","15099","117087","3312.3431250000003","0.043060460625000005","2.160490380750007E7","280.8637494974984"
"8063","15099","15095","7","15102","117094","3313.00125","0.043069016249999995","2.160821680875007E7","280.9068185137484"
"8064","15102","15095","8","15103","117102","3313.220625","0.043071868124999996","2.161153002937507E7","280.94989038187344"
"8065","15103","15102","4","15106","117106","3313.8787500000003","0.04308042375","2.161484390812507E7","280.99297080562343"
"8066","15106","15101","7","15108","117113","3314.3174999999997","0.043086127499999995","2.1618158225625068E7","281.0360569331234"
"8067","15108","15106","6","15112","117119","3315.1949999999997","0.04309753499999999","2.162147342062507E7","281.0791544681234"
"8068","15112","15106","5","15111","117124","3314.975625","0.043094683125","2.162478839625007E7","281.1222491512484"
"8069","15111","15110","8","15118","117132","3316.51125","0.04311464625","2.162810490750007E7","281.1653637974984"
"8070","15118","15115","6","15121","117138","3317.169375","0.043123201874999996","2.163142207687507E7","281.2084869993734"
"8071","15121","15118","9","15127","117147","3318.485625","0.043140313124999996","2.1634740562500067E7","281.2516273124984"
"8072","15127","15124","4","15128","117151","3318.705","0.043143165","2.1638059267500065E7","281.2947704774984"
"8073","15128","15122","8","15130","117159","3319.14375","0.04314886875","2.1641378411250066E7","281.3379193462484"
"8074","15130","15122","6","15128","117165","3318.705","0.043143165","2.1644697116250064E7","281.3810625112484"
"8075","15128","15124","3","15127","117168","3318.485625","0.043140313124999996","2.1648015601875063E7","281.42420282437337"
"8076","15127","15125","7","15132","117175","3319.582499999999","0.04315457249999999","2.1651335184375063E7","281.46735739687335"
"8077","15132","15124","3","15127","117178","3318.485625","0.043140313124999996","2.165465367000006E7","281.51049770999833"
"8078","15127","15122","1","15123","117179","3317.6081249999997","0.04312890562499999","2.1657971278125063E7","281.55362661562333"
"8079","15123","15117","6","15123","117185","3317.6081249999997","0.04312890562499999","2.1661288886250064E7","281.5967555212483"
"8080","15123","15120","6","15126","117191","3318.26625","0.04313746125","2.1664607152500063E7","281.63989298249834"
"8081","15126","15123","5","15128","117196","3318.705","0.043143165","2.166792585750006E7","281.68303614749834"
"8082","15128","15121","6","15127","117202","3318.485625","0.043140313124999996","2.167124434312506E7","281.7261764606233"
"8083","15127","15123","4","15127","117206","3318.485625","0.043140313124999996","2.167456282875006E7","281.7693167737483"
"8084","15127","15125","6","15131","117212","3319.3631250000003","0.043151720625","2.167788219187506E7","281.8124684943733"
"8085","15131","15130","8","15138","117220","3320.89875","0.043171683749999995","2.168120309062506E7","281.85564017812334"
"8086","15138","15133","4","15137","117224","3320.6793749999997","0.043168831874999994","2.168452377000006E7","281.89880900999833"
"8087","15137","15134","2","15136","117226","3320.46","0.04316598","2.168784423000006E7","281.94197498999836"
"8088","15136","15129","4","15133","117230","3319.8018749999997","0.043157424374999996","2.169116403187506E7","281.98513241437337"
"8089","15133","15127","3","15130","117233","3319.14375","0.04314886875","2.169448317562506E7","282.02828128312336"
"8090","15130","15121","2","15123","117235","3317.6081249999997","0.04312890562499999","2.169780078375006E7","282.07141018874836"
"8091","15123","15120","3","15123","117238","3317.6081249999997","0.04312890562499999","2.1701118391875062E7","282.11453909437336"
"8092","15123","15119","8","15127","117246","3318.485625","0.043140313124999996","2.170443687750006E7","282.15767940749834"
"8093","15127","15122","1","15123","117247","3317.6081249999997","0.04312890562499999","2.1707754485625062E7","282.20080831312333"
"8094","15123","15122","4","15126","117251","3318.26625","0.04313746125","2.171107275187506E7","282.24394577437334"
"8095","15126","15125","4","15129","117255","3318.9243750000005","0.043146016875000005","2.1714391676250063E7","282.2870917912484"
"8096","15129","15123","6","15129","117261","3318.9243750000005","0.043146016875000005","2.1717710600625064E7","282.3302378081234"
"8097","15129","15120","5","15125","117266","3318.046875","0.043134609375","2.1721028647500064E7","282.3733724174984"
"8098","15125","15124","3","15127","117269","3318.485625","0.043140313124999996","2.1724347133125063E7","282.41651273062337"
"8099","15127","15118","3","15121","117272","3317.169375","0.043123201874999996","2.172766430250006E7","282.4596359324984"
"8100","15121","15112","3","15115","117275","3315.853125","0.043106090624999996","2.173098015562506E7","282.50274202312335"
"8101","15115","15109","5","15114","117280","3315.63375","0.043103238749999995","2.173429578937506E7","282.54584526187335"
"8102","15114","15109","3","15112","117283","3315.1949999999997","0.04309753499999999","2.173761098437506E7","282.58894279687337"
"8103","15112","15107","5","15112","117288","3315.1949999999997","0.04309753499999999","2.174092617937506E7","282.6320403318734"
"8104","15112","15106","2","15108","117290","3314.3174999999997","0.043086127499999995","2.174424049687506E7","282.67512645937336"
"8105","15108","15103","5","15108","117295","3314.3174999999997","0.043086127499999995","2.1747554814375058E7","282.71821258687334"
"8106","15108","15100","9","15109","117304","3314.536875","0.043088979374999996","2.1750869351250056E7","282.76130156624833"
"8107","15109","15101","8","15109","117312","3314.536875","0.043088979374999996","2.1754183888125055E7","282.80439054562333"
"8108","15109","15106","3","15109","117315","3314.536875","0.043088979374999996","2.1757498425000053E7","282.84747952499833"
"8109","15109","15104","4","15108","117319","3314.3174999999997","0.043086127499999995","2.176081274250005E7","282.8905656524983"
"8110","15108","15105","2","15107","117321","3314.098124999999","0.04308327562499999","2.176412684062505E7","282.9336489281233"
"8111","15107","15103","3","15106","117324","3313.8787500000003","0.04308042375","2.176744071937505E7","282.9767293518733"
"8112","15106","15098","4","15102","117328","3313.00125","0.043069016249999995","2.177075372062505E7","283.0197983681233"
"8113","15102","15097","3","15100","117331","3312.5625","0.0430633125","2.177406628312505E7","283.0628616806233"
"8114","15100","15095","5","15100","117336","3312.5625","0.0430633125","2.177737884562505E7","283.1059249931233"
"8115","15100","15092","6","15098","117342","3312.1237499999997","0.04305760875","2.178069096937505E7","283.14898260187334"
"8116","15098","15089","5","15094","117347","3311.24625","0.04304620125","2.178400221562505E7","283.1920288031233"
"8117","15094","15088","5","15093","117352","3311.026875","0.043043349375","2.178731324250005E7","283.23507215249833"
"8118","15093","15091","6","15097","117358","3311.9043749999996","0.043054756874999996","2.1790625146875054E7","283.2781269093733"
"8119","15097","15093","3","15096","117361","3311.685","0.043051904999999994","2.1793936831875052E7","283.32117881437335"
"8120","15096","15088","6","15094","117367","3311.24625","0.04304620125","2.1797248078125052E7","283.36422501562333"
"8121","15094","15092","5","15097","117372","3311.9043749999996","0.043054756874999996","2.1800559982500054E7","283.4072797724983"
"8122","15097","15089","3","15092","117375","3310.8075","0.0430404975","2.1803870790000055E7","283.4503202699983"
"8123","15092","15086","5","15091","117380","3310.588125","0.043037645625","2.1807181378125057E7","283.49335791562333"
"8124","15091","15083","6","15089","117386","3310.149375","0.043031941875","2.1810491527500056E7","283.5363898574983"
"8125","15089","15087","2","15089","117388","3310.149375","0.043031941875","2.1813801676875055E7","283.5794217993733"
"8126","15089","15085","9","15094","117397","3311.24625","0.04304620125","2.1817112923125055E7","283.62246800062326"
"8127","15094","15091","1","15092","117398","3310.8075","0.0430404975","2.1820423730625056E7","283.66550849812324"
"8128","15092","15087","4","15091","117402","3310.588125","0.043037645625","2.1823734318750057E7","283.70854614374826"
"8129","15091","15089","1","15090","117403","3310.36875","0.04303479375","2.1827044687500056E7","283.75158093749826"
"8130","15090","15089","4","15093","117407","3311.026875","0.043043349375","2.1830355714375056E7","283.7946242868733"
"8131","15093","15089","9","15098","117416","3312.1237499999997","0.04305760875","2.1833667838125058E7","283.8376818956233"
"8132","15098","15097","1","15098","117417","3312.1237499999997","0.04305760875","2.183697996187506E7","283.8807395043733"
"8133","15098","15094","1","15095","117418","3311.465625","0.04304905312499999","2.1840291427500058E7","283.9237885574983"
"8134","15095","15087","1","15088","117419","3309.93","0.04302908999999999","2.1843601357500058E7","283.9668176474983"
"8135","15088","15087","2","15089","117421","3310.149375","0.043031941875","2.1846911506875057E7","284.0098495893733"
"8136","15089","15081","1","15082","117422","3308.613749999999","0.043011978749999985","2.1850220120625056E7","284.05286156812326"
"8137","15082","15081","1","15082","117423","3308.613749999999","0.043011978749999985","2.1853528734375056E7","284.09587354687324"
"8138","15082","15074","5","15079","117428","3307.9556250000005","0.043003423125","2.1856836690000057E7","284.13887696999825"
"8139","15079","15071","8","15079","117436","3307.9556250000005","0.043003423125","2.186014464562506E7","284.18188039312327"
"8140","15079","15071","2","15073","117438","3306.6393749999997","0.042986311874999995","2.186345128500006E7","284.22486670499825"
"8141","15073","15072","3","15075","117441","3307.078125","0.042992015625","2.186675836312506E7","284.2678587206232"
"8142","15075","15068","3","15071","117444","3306.200625","0.042980608125","2.187006456375006E7","284.3108393287482"
"8143","15071","15062","3","15065","117447","3304.884375","0.042963496875","2.1873369448125057E7","284.35380282562323"
"8144","15065","15058","8","15066","117455","3305.10375","0.04296634875","2.187667455187506E7","284.3967691743732"
"8145","15066","15058","8","15066","117463","3305.10375","0.04296634875","2.187997965562506E7","284.4397355231232"
"8146","15066","15061","8","15069","117471","3305.761875","0.042974904375","2.188328541750006E7","284.4827104274982"
"8147","15069","15067","8","15075","117479","3307.078125","0.042992015625","2.188659249562506E7","284.5257024431232"
"8148","15075","15070","9","15079","117488","3307.9556250000005","0.043003423125","2.188990045125006E7","284.5687058662482"
"8149","15079","15076","8","15084","117496","3309.0525","0.043017682499999994","2.189320950375006E7","284.6117235487482"
"8150","15084","15081","3","15084","117499","3309.0525","0.043017682499999994","2.1896518556250058E7","284.65474123124824"
"8151","15084","15077","9","15086","117508","3309.49125","0.04302338625","2.189982804750006E7","284.69776461749825"
"8152","15086","15082","7","15089","117515","3310.149375","0.043031941875","2.1903138196875058E7","284.7407965593732"
"8153","15089","15083","9","15092","117524","3310.8075","0.0430404975","2.190644900437506E7","284.7838370568732"
"8154","15092","15088","3","15091","117527","3310.588125","0.043037645625","2.190975959250006E7","284.82687470249823"
"8155","15091","15087","7","15094","117534","3311.24625","0.04304620125","2.191307083875006E7","284.8699209037482"
"8156","15094","15086","3","15089","117537","3310.149375","0.043031941875","2.191638098812506E7","284.9129528456232"
"8157","15089","15087","6","15093","117543","3311.026875","0.043043349375","2.191969201500006E7","284.9559961949982"
"8158","15093","15089","7","15096","117550","3311.685","0.043051904999999994","2.192300370000006E7","284.9990480999982"
"8159","15096","15095","5","15100","117555","3312.5625","0.0430633125","2.192631626250006E7","285.04211141249823"
"8160","15100","15091","7","15098","117562","3312.1237499999997","0.04305760875","2.192962838625006E7","285.08516902124825"
"8161","15098","15089","9","15098","117571","3312.1237499999997","0.04305760875","2.193294051000006E7","285.12822662999827"
"8162","15098","15094","8","15102","117579","3313.00125","0.043069016249999995","2.193625351125006E7","285.17129564624827"
"8163","15102","15096","8","15104","117587","3313.4400000000005","0.043074720000000004","2.193956695125006E7","285.21437036624826"
"8164","15104","15103","3","15106","117590","3313.8787500000003","0.04308042375","2.194288083000006E7","285.25745078999824"
"8165","15106","15098","1","15099","117591","3312.3431250000003","0.043060460625000005","2.1946193173125062E7","285.30051125062323"
"8166","15099","15091","7","15098","117598","3312.1237499999997","0.04305760875","2.1949505296875063E7","285.34356885937325"
"8167","15098","15097","7","15104","117605","3313.4400000000005","0.043074720000000004","2.1952818736875065E7","285.38664357937324"
"8168","15104","15102","8","15110","117613","3314.75625","0.04309183125","2.1956133493125066E7","285.42973541062327"
"8169","15110","15106","9","15115","117622","3315.853125","0.043106090624999996","2.1959449346250065E7","285.47284150124824"
"8170","15115","15114","4","15118","117626","3316.51125","0.04311464625","2.1962765857500065E7","285.51595614749823"
"8171","15118","15117","3","15120","117629","3316.95","0.043120349999999995","2.1966082807500064E7","285.5590764974982"
"8172","15120","15119","9","15128","117638","3318.705","0.043143165","2.1969401512500063E7","285.6022196624982"
"8173","15128","15126","1","15127","117639","3318.485625","0.043140313124999996","2.197271999812506E7","285.6453599756232"
"8174","15127","15119","1","15120","117640","3316.95","0.043120349999999995","2.197603694812506E7","285.6884803256232"
"8175","15120","15112","8","15120","117648","3316.95","0.043120349999999995","2.197935389812506E7","285.73160067562316"
"8176","15120","15117","4","15121","117652","3317.169375","0.043123201874999996","2.198267106750006E7","285.77472387749816"
"8177","15121","15115","7","15122","117659","3317.3887499999996","0.04312605374999999","2.198598845625006E7","285.81784993124813"
"8178","15122","15121","5","15126","117664","3318.26625","0.04313746125","2.198930672250006E7","285.86098739249815"
"8179","15126","15124","8","15132","117672","3319.582499999999","0.04315457249999999","2.199262630500006E7","285.90414196499813"
"8180","15132","15129","6","15135","117678","3320.240625","0.043163128125","2.199594654562506E7","285.94730509312313"
"8181","15135","15126","7","15133","117685","3319.8018749999997","0.043157424374999996","2.199926634750006E7","285.99046251749814"
"8182","15133","15132","9","15141","117694","3321.556875","0.043180239375","2.200258790437506E7","286.0336427568731"
"8183","15141","15133","5","15138","117699","3320.89875","0.043171683749999995","2.200590880312506E7","286.07681444062314"
"8184","15138","15132","4","15136","117703","3320.46","0.04316598","2.2009229263125062E7","286.11998042062316"
"8185","15136","15134","3","15137","117706","3320.6793749999997","0.043168831874999994","2.2012549942500062E7","286.16314925249816"
"8186","15137","15129","8","15137","117714","3320.6793749999997","0.043168831874999994","2.2015870621875063E7","286.20631808437315"
"8187","15137","15133","4","15137","117718","3320.6793749999997","0.043168831874999994","2.2019191301250063E7","286.24948691624815"
"8188","15137","15134","8","15142","117726","3321.77625","0.04318309124999999","2.2022513077500064E7","286.29267000749815"
"8189","15142","15135","8","15143","117734","3321.995625","0.043185943125","2.2025835073125064E7","286.33585595062317"
"8190","15143","15137","5","15142","117739","3321.77625","0.04318309124999999","2.2029156849375065E7","286.37903904187317"
"8191","15142","15137","3","15140","117742","3321.3375","0.0431773875","2.2032478186875064E7","286.4222164293732"
"8192","15140","15136","5","15141","117747","3321.556875","0.043180239375","2.2035799743750066E7","286.46539666874816"
"8193","15141","15135","7","15142","117754","3321.77625","0.04318309124999999","2.2039121520000067E7","286.50857975999816"
"8194","15142","15134","1","15135","117755","3320.240625","0.043163128125","2.2042441760625068E7","286.55174288812316"
"8195","15135","15131","8","15139","117763","3321.118125","0.043174535624999996","2.2045762878750067E7","286.59491742374814"
"8196","15139","15130","4","15134","117767","3320.02125","0.04316027625","2.2049082900000066E7","286.6380776999981"
"8197","15134","15133","1","15134","117768","3320.02125","0.04316027625","2.2052402921250064E7","286.6812379762481"
"8198","15134","15131","2","15133","117770","3319.8018749999997","0.043157424374999996","2.2055722723125063E7","286.7243954006231"
"8199","15133","15127","8","15135","117778","3320.240625","0.043163128125","2.2059042963750064E7","286.7675585287481"
"8200","15135","15130","7","15137","117785","3320.6793749999997","0.043168831874999994","2.2062363643125065E7","286.8107273606231"
"8201","15137","15128","7","15135","117792","3320.240625","0.043163128125","2.2065683883750066E7","286.8538904887481"
"8202","15135","15134","6","15140","117798","3321.3375","0.0431773875","2.2069005221250065E7","286.8970678762481"
"8203","15140","15131","9","15140","117807","3321.3375","0.0431773875","2.2072326558750063E7","286.9402452637481"
"8204","15140","15134","9","15143","117816","3321.995625","0.043185943125","2.2075648554375064E7","286.98343120687315"
"8205","15143","15141","5","15146","117821","3322.65375","0.04319449875","2.2078971208125062E7","287.02662570562313"
"8206","15146","15142","2","15144","117823","3322.215","0.043188795","2.2082293423125062E7","287.0698145006231"
"8207","15144","15142","5","15147","117828","3322.8731249999996","0.04319735062499999","2.2085616296250064E7","287.11301185124813"
"8208","15147","15144","3","15147","117831","3322.8731249999996","0.04319735062499999","2.2088939169375066E7","287.15620920187314"
"8209","15147","15139","4","15143","117835","3321.995625","0.043185943125","2.2092261165000066E7","287.19939514499816"
"8210","15143","15134","3","15137","117838","3320.6793749999997","0.043168831874999994","2.2095581844375066E7","287.24256397687316"
"8211","15137","15135","9","15144","117847","3322.215","0.043188795","2.2098904059375066E7","287.28575277187315"
"8212","15144","15138","3","15141","117850","3321.556875","0.043180239375","2.2102225616250068E7","287.3289330112481"
"8213","15141","15140","9","15149","117859","3323.3118750000003","0.043203054375","2.210554892812507E7","287.3721360656231"
"8214","15149","15148","6","15154","117865","3324.4087500000005","0.04321731375000001","2.210887333687507E7","287.41535337937313"
"8215","15154","15151","3","15154","117868","3324.4087500000005","0.04321731375000001","2.211219774562507E7","287.45857069312314"
"8216","15154","15145","2","15147","117870","3322.8731249999996","0.04319735062499999","2.2115520618750073E7","287.50176804374814"
"8217","15147","15139","3","15142","117873","3321.77625","0.04318309124999999","2.2118842395000074E7","287.54495113499814"
"8218","15142","15136","8","15144","117881","3322.215","0.043188795","2.2122164610000074E7","287.58813992999814"
"8219","15144","15136","9","15145","117890","3322.434375","0.043191646874999996","2.2125487044375073E7","287.63133157687315"
"8220","15145","15142","3","15145","117893","3322.434375","0.043191646874999996","2.2128809478750072E7","287.67452322374817"
"8221","15145","15137","3","15140","117896","3321.3375","0.0431773875","2.213213081625007E7","287.7177006112482"
"8222","15140","15134","3","15137","117899","3320.6793749999997","0.043168831874999994","2.213545149562507E7","287.76086944312317"
"8223","15137","15132","1","15133","117900","3319.8018749999997","0.043157424374999996","2.213877129750007E7","287.8040268674982"
"8224","15133","15132","5","15137","117905","3320.6793749999997","0.043168831874999994","2.214209197687507E7","287.8471956993732"
"8225","15137","15136","6","15142","117911","3321.77625","0.04318309124999999","2.214541375312507E7","287.8903787906232"
"8226","15142","15137","7","15144","117918","3322.215","0.043188795","2.214873596812507E7","287.93356758562317"
"8227","15144","15138","8","15146","117926","3322.65375","0.04319449875","2.215205862187507E7","287.97676208437315"
"8228","15146","15145","6","15151","117932","3323.750625","0.043208758124999996","2.215538237250007E7","288.01997084249814"
"8229","15151","15148","5","15153","117937","3324.189375","0.043214461875","2.2158706561875068E7","288.0631853043731"
"8230","15153","15151","2","15153","117939","3324.189375","0.043214461875","2.2162030751250066E7","288.1063997662481"
"8231","15153","15144","7","15151","117946","3323.750625","0.043208758124999996","2.2165354501875065E7","288.1496085243731"
"8232","15151","15144","4","15148","117950","3323.0924999999997","0.04320020249999999","2.2168677594375066E7","288.19280872687307"
"8233","15148","15140","8","15148","117958","3323.0924999999997","0.04320020249999999","2.2172000686875068E7","288.23600892937304"
"8234","15148","15146","5","15151","117963","3323.750625","0.043208758124999996","2.2175324437500067E7","288.27921768749803"
"8235","15151","15144","5","15149","117968","3323.3118750000003","0.043203054375","2.2178647749375068E7","288.32242074187303"
"8236","15149","15147","3","15150","117971","3323.53125","0.043205906249999995","2.2181971280625068E7","288.36562664812305"
"8237","15150","15144","5","15149","117976","3323.3118750000003","0.043203054375","2.218529459250007E7","288.40882970249805"
"8238","15149","15144","2","15146","117978","3322.65375","0.04319449875","2.2188617246250067E7","288.45202420124804"
"8239","15146","15138","8","15146","117986","3322.65375","0.04319449875","2.2191939900000066E7","288.495218699998"
"8240","15146","15140","7","15147","117993","3322.8731249999996","0.04319735062499999","2.2195262773125067E7","288.538416050623"
"8241","15147","15146","3","15149","117996","3323.3118750000003","0.043203054375","2.2198586085000068E7","288.581619104998"
"8242","15149","15148","1","15149","117997","3323.3118750000003","0.043203054375","2.220190939687507E7","288.624822159373"
"8243","15149","15143","1","15144","117998","3322.215","0.043188795","2.220523161187507E7","288.668010954373"
"8244","15144","15140","6","15146","118004","3322.65375","0.04319449875","2.2208554265625067E7","288.711205453123"
"8245","15146","15141","9","15150","118013","3323.53125","0.043205906249999995","2.2211877796875067E7","288.754411359373"
"8246","15150","15141","9","15150","118022","3323.53125","0.043205906249999995","2.2215201328125067E7","288.79761726562305"
"8247","15150","15143","6","15149","118028","3323.3118750000003","0.043203054375","2.2218524640000068E7","288.84082031999804"
"8248","15149","15142","8","15150","118036","3323.53125","0.043205906249999995","2.2221848171250068E7","288.88402622624807"
"8249","15150","15143","3","15146","118039","3322.65375","0.04319449875","2.2225170825000066E7","288.92722072499805"
"8250","15146","15137","5","15142","118044","3321.77625","0.04318309124999999","2.2228492601250067E7","288.97040381624805"
"8251","15142","15138","4","15142","118048","3321.77625","0.04318309124999999","2.223181437750007E7","289.01358690749805"
"8252","15142","15138","2","15140","118050","3321.3375","0.0431773875","2.2235135715000067E7","289.05676429499806"
"8253","15140","15137","7","15144","118057","3322.215","0.043188795","2.2238457930000067E7","289.09995308999805"
"8254","15144","15141","9","15150","118066","3323.53125","0.043205906249999995","2.2241781461250067E7","289.1431589962481"
"8255","15150","15148","9","15157","118075","3325.066874999999","0.04322586937499998","2.2245106528125066E7","289.1863848656231"
"8256","15157","15154","4","15158","118079","3325.2862499999997","0.04322872124999999","2.2248431814375065E7","289.2296135868731"
"8257","15158","15152","6","15158","118085","3325.2862499999997","0.04322872124999999","2.2251757100625064E7","289.2728423081231"
"8258","15158","15150","7","15157","118092","3325.066874999999","0.04322586937499998","2.2255082167500064E7","289.3160681774981"
"8259","15157","15152","3","15155","118095","3324.628125","0.043220165625","2.2258406795625065E7","289.35928834312307"
"8260","15155","15154","8","15162","118103","3326.1637499999997","0.043240128749999995","2.2261732959375065E7","289.4025284718731"
"8261","15162","15159","2","15161","118105","3325.944375","0.043237276875","2.2265058903750066E7","289.4457657487481"
"8262","15161","15154","8","15162","118113","3326.1637499999997","0.043240128749999995","2.2268385067500066E7","289.48900587749813"
"8263","15162","15153","2","15155","118115","3324.628125","0.043220165625","2.2271709695625067E7","289.5322260431231"
"8264","15155","15150","5","15155","118120","3324.628125","0.043220165625","2.2275034323750068E7","289.5754462087481"
"8265","15155","15149","3","15152","118123","3323.97","0.04321161","2.2278358293750066E7","289.6186578187481"
"8266","15152","15151","7","15158","118130","3325.2862499999997","0.04322872124999999","2.2281683580000065E7","289.6618865399981"
"8267","15158","15155","1","15156","118131","3324.8475000000003","0.0432230175","2.2285008427500065E7","289.7051095574981"
"8268","15156","15148","3","15151","118134","3323.750625","0.043208758124999996","2.2288332178125065E7","289.74831831562307"
"8269","15151","15144","9","15153","118143","3324.189375","0.043214461875","2.2291656367500063E7","289.79153277749805"
"8270","15153","15150","4","15154","118147","3324.4087500000005","0.04321731375000001","2.2294980776250064E7","289.83475009124805"
"8271","15154","15146","7","15153","118154","3324.189375","0.043214461875","2.2298304965625063E7","289.87796455312304"
"8272","15153","15147","7","15154","118161","3324.4087500000005","0.04321731375000001","2.2301629374375064E7","289.92118186687304"
"8273","15154","15147","5","15152","118166","3323.97","0.04321161","2.2304953344375063E7","289.96439347687306"
"8274","15152","15146","4","15150","118170","3323.53125","0.043205906249999995","2.2308276875625063E7","290.0075993831231"
"8275","15150","15142","5","15147","118175","3322.8731249999996","0.04319735062499999","2.2311599748750065E7","290.0507967337481"
"8276","15147","15143","2","15145","118177","3322.434375","0.043191646874999996","2.2314922183125064E7","290.0939883806231"
"8277","15145","15142","5","15147","118182","3322.8731249999996","0.04319735062499999","2.2318245056250066E7","290.1371857312481"
"8278","15147","15145","6","15151","118188","3323.750625","0.043208758124999996","2.2321568806875065E7","290.1803944893731"
"8279","15151","15142","5","15147","118193","3322.8731249999996","0.04319735062499999","2.2324891680000067E7","290.2235918399981"
"8280","15147","15144","6","15150","118199","3323.53125","0.043205906249999995","2.2328215211250067E7","290.26679774624813"
"8281","15150","15146","5","15151","118204","3323.750625","0.043208758124999996","2.2331538961875066E7","290.3100065043731"
"8282","15151","15147","6","15153","118210","3324.189375","0.043214461875","2.2334863151250064E7","290.3532209662481"
"8283","15153","15150","2","15152","118212","3323.97","0.04321161","2.2338187121250063E7","290.3964325762481"
"8284","15152","15149","8","15157","118220","3325.066874999999","0.04322586937499998","2.2341512188125063E7","290.43965844562314"
"8285","15157","15152","6","15158","118226","3325.2862499999997","0.04322872124999999","2.234483747437506E7","290.4828871668731"
"8286","15158","15157","5","15162","118231","3326.1637499999997","0.043240128749999995","2.2348163638125062E7","290.52612729562316"
"8287","15162","15157","5","15162","118236","3326.1637499999997","0.043240128749999995","2.2351489801875062E7","290.5693674243732"
"8288","15162","15160","5","15165","118241","3326.821875","0.043248684375","2.235481662375006E7","290.61261610874817"
"8289","15165","15164","1","15165","118242","3326.821875","0.043248684375","2.235814344562506E7","290.65586479312316"
"8290","15165","15156","7","15163","118249","3326.383125","0.043242980624999997","2.236146982875006E7","290.69910777374815"
"8291","15163","15154","5","15159","118254","3325.505625","0.04323157312499999","2.2364795334375057E7","290.74233934687317"
"8292","15159","15158","2","15160","118256","3325.725","0.04323442499999999","2.236812105937506E7","290.78557377187315"
"8293","15160","15159","5","15164","118261","3326.6025","0.0432458325","2.2371447661875058E7","290.82881960437317"
"8294","15164","15156","7","15163","118268","3326.383125","0.043242980624999997","2.2374774045000058E7","290.87206258499816"
"8295","15163","15158","6","15164","118274","3326.6025","0.0432458325","2.2378100647500057E7","290.9153084174982"
"8296","15164","15157","7","15164","118281","3326.6025","0.0432458325","2.2381427250000056E7","290.9585542499982"
"8297","15164","15159","6","15165","118287","3326.821875","0.043248684375","2.2384754071875054E7","291.0018029343732"
"8298","15165","15162","7","15169","118294","3327.699375","0.043260091875","2.2388081771250054E7","291.0450630262482"
"8299","15169","15168","3","15171","118297","3328.138125","0.043265795625","2.2391409909375053E7","291.08832882187323"
"8300","15171","15169","4","15173","118301","3328.5768749999997","0.043271499374999994","2.2394738486250054E7","291.13160032124824"
"8301","15173","15172","4","15176","118305","3329.235","0.043280055","2.2398067721250053E7","291.17488037624827"
"8302","15176","15167","4","15171","118309","3328.138125","0.043265795625","2.2401395859375052E7","291.2181461718733"
"8303","15171","15165","7","15172","118316","3328.3574999999996","0.04326864749999999","2.2404724216875054E7","291.2614148193733"
"8304","15172","15168","3","15171","118319","3328.138125","0.043265795625","2.2408052355000053E7","291.3046806149983"
"8305","15171","15162","3","15165","118322","3326.821875","0.043248684375","2.241137917687505E7","291.3479292993733"
"8306","15165","15161","8","15169","118330","3327.699375","0.043260091875","2.241470687625005E7","291.3911893912483"
"8307","15169","15164","2","15166","118332","3327.04125","0.04325153625","2.2418033917500053E7","291.4344409274983"
"8308","15166","15161","8","15169","118340","3327.699375","0.043260091875","2.2421361616875052E7","291.47770101937334"
"8309","15169","15166","8","15174","118348","3328.7962500000003","0.04327435125","2.2424690413125053E7","291.5209753706233"
"8310","15174","15166","3","15169","118351","3327.699375","0.043260091875","2.2428018112500053E7","291.56423546249835"
"8311","15169","15165","6","15171","118357","3328.138125","0.043265795625","2.243134625062505E7","291.60750125812336"
"8312","15171","15165","6","15171","118363","3328.138125","0.043265795625","2.243467438875005E7","291.6507670537484"
"8313","15171","15166","3","15169","118366","3327.699375","0.043260091875","2.243800208812505E7","291.6940271456234"
"8314","15169","15164","8","15172","118374","3328.3574999999996","0.04326864749999999","2.244133044562505E7","291.7372957931234"
"8315","15172","15170","3","15173","118377","3328.5768749999997","0.043271499374999994","2.2444659022500053E7","291.7805672924984"
"8316","15173","15170","7","15177","118384","3329.454375","0.04328290687499999","2.244798847687505E7","291.8238501993734"
"8317","15177","15170","3","15173","118387","3328.5768749999997","0.043271499374999994","2.2451317053750053E7","291.8671216987484"
"8318","15173","15170","2","15172","118389","3328.3574999999996","0.04326864749999999","2.2454645411250055E7","291.9103903462484"
"8319","15172","15163","5","15168","118394","3327.48","0.043257239999999995","2.2457972891250055E7","291.9536475862484"
"8320","15168","15159","3","15162","118397","3326.1637499999997","0.043240128749999995","2.2461299055000056E7","291.9968877149984"
"8321","15162","15157","8","15165","118405","3326.821875","0.043248684375","2.2464625876875054E7","292.0401363993734"
"8322","15165","15158","5","15163","118410","3326.383125","0.043242980624999997","2.2467952260000054E7","292.0833793799984"
"8323","15163","15154","4","15158","118414","3325.2862499999997","0.04322872124999999","2.2471277546250053E7","292.1266081012484"
"8324","15158","15155","9","15164","118423","3326.6025","0.0432458325","2.247460414875005E7","292.1698539337484"
"8325","15164","15163","7","15170","118430","3327.91875","0.04326294375","2.247793206750005E7","292.2131168774984"
"8326","15170","15166","6","15172","118436","3328.3574999999996","0.04326864749999999","2.2481260425000053E7","292.2563855249984"
"8327","15172","15165","8","15173","118444","3328.5768749999997","0.043271499374999994","2.2484589001875054E7","292.2996570243734"
"8328","15173","15164","5","15169","118449","3327.699375","0.043260091875","2.2487916701250054E7","292.34291711624843"
"8329","15169","15165","4","15169","118453","3327.699375","0.043260091875","2.2491244400625054E7","292.38617720812346"
"8330","15169","15162","1","15163","118454","3326.383125","0.043242980624999997","2.2494570783750053E7","292.42942018874845"
"8331","15163","15155","6","15161","118460","3325.944375","0.043237276875","2.2497896728125054E7","292.47265746562346"
"8332","15161","15152","5","15157","118465","3325.066874999999","0.04322586937499998","2.2501221795000054E7","292.5158833349985"
"8333","15157","15148","3","15151","118468","3323.750625","0.043208758124999996","2.2504545545625053E7","292.55909209312347"
"8334","15151","15144","1","15145","118469","3322.434375","0.043191646874999996","2.2507867980000053E7","292.6022837399985"
"8335","15145","15138","1","15139","118470","3321.118125","0.043174535624999996","2.251118909812505E7","292.64545827562347"
"8336","15139","15136","7","15143","118477","3321.995625","0.043185943125","2.2514511093750052E7","292.6886442187485"
"8337","15143","15140","3","15143","118480","3321.995625","0.043185943125","2.2517833089375053E7","292.7318301618735"
"8338","15143","15140","7","15147","118487","3322.8731249999996","0.04319735062499999","2.2521155962500054E7","292.7750275124985"
"8339","15147","15144","2","15146","118489","3322.65375","0.04319449875","2.2524478616250053E7","292.8182220112485"
"8340","15146","15145","1","15146","118490","3322.65375","0.04319449875","2.252780127000005E7","292.8614165099985"
"8341","15146","15137","8","15145","118498","3322.434375","0.043191646874999996","2.253112370437505E7","292.9046081568735"
"8342","15145","15142","5","15147","118503","3322.8731249999996","0.04319735062499999","2.2534446577500053E7","292.9478055074985"
"8343","15147","15144","5","15149","118508","3323.3118750000003","0.043203054375","2.2537769889375053E7","292.9910085618735"
"8344","15149","15146","8","15154","118516","3324.4087500000005","0.04321731375000001","2.2541094298125055E7","293.0342258756235"
"8345","15154","15151","2","15153","118518","3324.189375","0.043214461875","2.2544418487500053E7","293.0774403374985"
"8346","15153","15152","1","15153","118519","3324.189375","0.043214461875","2.254774267687505E7","293.1206547993735"
"8347","15153","15147","2","15149","118521","3323.3118750000003","0.043203054375","2.255106598875005E7","293.1638578537485"
"8348","15149","15143","5","15148","118526","3323.0924999999997","0.04320020249999999","2.2554389081250053E7","293.20705805624846"
"8349","15148","15147","4","15151","118530","3323.750625","0.043208758124999996","2.2557712831875052E7","293.25026681437345"
"8350","15151","15146","6","15152","118536","3323.97","0.04321161","2.256103680187505E7","293.29347842437346"
"8351","15152","15144","7","15151","118543","3323.750625","0.043208758124999996","2.256436055250005E7","293.33668718249845"
"8352","15151","15145","5","15150","118548","3323.53125","0.043205906249999995","2.256768408375005E7","293.3798930887485"
"8353","15150","15142","7","15149","118555","3323.3118750000003","0.043203054375","2.257100739562505E7","293.4230961431235"
"8354","15149","15140","9","15149","118564","3323.3118750000003","0.043203054375","2.257433070750005E7","293.4662991974985"
"8355","15149","15140","7","15147","118571","3322.8731249999996","0.04319735062499999","2.2577653580625053E7","293.5094965481235"
"8356","15147","15142","5","15147","118576","3322.8731249999996","0.04319735062499999","2.2580976453750055E7","293.5526938987485"
"8357","15147","15145","4","15149","118580","3323.3118750000003","0.043203054375","2.2584299765625056E7","293.5958969531235"
"8358","15149","15147","2","15149","118582","3323.3118750000003","0.043203054375","2.2587623077500056E7","293.6391000074985"
"8359","15149","15144","9","15153","118591","3324.189375","0.043214461875","2.2590947266875055E7","293.68231446937347"
"8360","15153","15151","3","15154","118594","3324.4087500000005","0.04321731375000001","2.2594271675625056E7","293.7255317831235"
"8361","15154","15148","5","15153","118599","3324.189375","0.043214461875","2.2597595865000054E7","293.76874624499845"
"8362","15153","15150","4","15154","118603","3324.4087500000005","0.04321731375000001","2.2600920273750056E7","293.81196355874846"
"8363","15154","15146","8","15154","118611","3324.4087500000005","0.04321731375000001","2.2604244682500057E7","293.85518087249847"
"8364","15154","15150","7","15157","118618","3325.066874999999","0.04322586937499998","2.2607569749375056E7","293.8984067418735"
"8365","15157","15155","2","15157","118620","3325.066874999999","0.04322586937499998","2.2610894816250056E7","293.9416326112485"
"8366","15157","15154","2","15156","118622","3324.8475000000003","0.0432230175","2.2614219663750056E7","293.9848556287485"
"8367","15156","15151","2","15153","118624","3324.189375","0.043214461875","2.2617543853125054E7","294.0280700906235"
"8368","15153","15151","6","15157","118630","3325.066874999999","0.04322586937499998","2.2620868920000054E7","294.0712959599985"
"8369","15157","15151","9","15160","118639","3325.725","0.04323442499999999","2.2624194645000055E7","294.1145303849985"
"8370","15160","15151","1","15152","118640","3323.97","0.04321161","2.2627518615000054E7","294.1577419949985"
"8371","15152","15149","2","15151","118642","3323.750625","0.043208758124999996","2.2630842365625054E7","294.2009507531235"
"8372","15151","15146","8","15154","118650","3324.4087500000005","0.04321731375000001","2.2634166774375055E7","294.2441680668735"
"8373","15154","15148","7","15155","118657","3324.628125","0.043220165625","2.2637491402500056E7","294.2873882324985"
"8374","15155","15151","4","15155","118661","3324.628125","0.043220165625","2.2640816030625056E7","294.33060839812345"
"8375","15155","15152","3","15155","118664","3324.628125","0.043220165625","2.2644140658750057E7","294.3738285637484"
"8376","15155","15153","1","15154","118665","3324.4087500000005","0.04321731375000001","2.264746506750006E7","294.4170458774984"
"8377","15154","15150","4","15154","118669","3324.4087500000005","0.04321731375000001","2.265078947625006E7","294.46026319124843"
"8378","15154","15145","7","15152","118676","3323.97","0.04321161","2.265411344625006E7","294.50347480124844"
"8379","15152","15148","4","15152","118680","3323.97","0.04321161","2.2657437416250058E7","294.54668641124846"
"8380","15152","15147","7","15154","118687","3324.4087500000005","0.04321731375000001","2.266076182500006E7","294.58990372499846"
"8381","15154","15149","9","15158","118696","3325.2862499999997","0.04322872124999999","2.2664087111250058E7","294.63313244624845"
"8382","15158","15154","5","15159","118701","3325.505625","0.04323157312499999","2.2667412616875056E7","294.67636401937347"
"8383","15159","15152","7","15159","118708","3325.505625","0.04323157312499999","2.2670738122500055E7","294.7195955924985"
"8384","15159","15153","7","15160","118715","3325.725","0.04323442499999999","2.2674063847500056E7","294.76283001749846"
"8385","15160","15158","3","15161","118718","3325.944375","0.043237276875","2.2677389791875057E7","294.80606729437346"
"8386","15161","15154","4","15158","118722","3325.2862499999997","0.04322872124999999","2.2680715078125056E7","294.84929601562345"
"8387","15158","15154","4","15158","118726","3325.2862499999997","0.04322872124999999","2.2684040364375055E7","294.89252473687344"
"8388","15158","15151","5","15156","118731","3324.8475000000003","0.0432230175","2.2687365211875055E7","294.93574775437344"
"8389","15156","15155","1","15156","118732","3324.8475000000003","0.0432230175","2.2690690059375055E7","294.97897077187343"
"8390","15156","15147","5","15152","118737","3323.97","0.04321161","2.2694014029375054E7","295.02218238187345"
"8391","15152","15143","7","15150","118744","3323.53125","0.043205906249999995","2.2697337560625054E7","295.0653882881235"
"8392","15150","15142","4","15146","118748","3322.65375","0.04319449875","2.2700660214375053E7","295.10858278687346"
"8393","15146","15143","4","15147","118752","3322.8731249999996","0.04319735062499999","2.2703983087500054E7","295.15178013749846"
"8394","15147","15146","4","15150","118756","3323.53125","0.043205906249999995","2.2707306618750054E7","295.1949860437485"
"8395","15150","15148","9","15157","118765","3325.066874999999","0.04322586937499998","2.2710631685625054E7","295.2382119131235"
"8396","15157","15156","9","15165","118774","3326.821875","0.043248684375","2.2713958507500052E7","295.2814605974985"
"8397","15165","15162","8","15170","118782","3327.91875","0.04326294375","2.271728642625005E7","295.3247235412485"
"8398","15170","15166","5","15171","118787","3328.138125","0.043265795625","2.272061456437505E7","295.3679893368735"
"8399","15171","15166","9","15175","118796","3329.015625","0.043277203125","2.272394358000005E7","295.4112665399985"
"8400","15175","15169","8","15177","118804","3329.454375","0.04328290687499999","2.272727303437505E7","295.4545494468735"
"8401","15177","15177","50000","65177","168804","14298.204375","0.185876656875","2.2741571238750048E7","295.6404261037485"
"8402","65177","65176","6","65182","168810","14299.301249999999","0.18589091624999998","2.2755870540000048E7","295.8263170199985"
"8403","65182","65180","3","65183","168813","14299.520625","0.18589376812499997","2.2770170060625046E7","296.0122107881235"
"8404","65183","65175","9","65184","168822","14299.74","0.18589661999999998","2.2784469800625045E7","296.1981074081235"
"8405","65184","65181","6","65187","168828","14300.398125","0.18590517562499997","2.2798770198750045E7","296.38401258374853"
"8406","65187","65185","8","65193","168836","14301.714375","0.18592228687499998","2.2813071913125046E7","296.5699348706235"
"8407","65193","65188","2","65190","168838","14301.05625","0.18591373125","2.2827372969375044E7","296.75584860187354"
"8408","65190","65186","6","65192","168844","14301.494999999999","0.18591943499999997","2.2841674464375045E7","296.94176803687355"
"8409","65192","65184","9","65193","168853","14301.714375","0.18592228687499998","2.2855976178750046E7","297.12769032374854"
"8410","65193","65185","3","65188","168856","14300.617499999998","0.18590802749999996","2.2870276796250045E7","297.3135983512485"
"8411","65188","65183","8","65191","168864","14301.275625000002","0.185916583125","2.2884578071875047E7","297.4995149343735"
"8412","65191","65189","3","65192","168867","14301.494999999999","0.18591943499999997","2.2898879566875048E7","297.6854343693735"
"8413","65192","65191","6","65197","168873","14302.591875","0.18593369437499999","2.291318215875005E7","297.87136806374855"
"8414","65197","65190","8","65198","168881","14302.811249999999","0.18593654624999997","2.292748497000005E7","298.05730460999854"
"8415","65198","65196","8","65204","168889","14304.1275","0.1859536575","2.2941789097500052E7","298.24325826749856"
"8416","65204","65201","6","65207","168895","14304.785624999999","0.18596221312499997","2.295609388312505E7","298.42922048062354"
"8417","65207","65198","4","65202","168899","14303.68875","0.18594795374999998","2.297039757187505E7","298.6151684343735"
"8418","65202","65196","9","65205","168908","14304.346875","0.18595650937499997","2.298470191875005E7","298.8011249437485"
"8419","65205","65199","2","65201","168910","14303.469375","0.185945101875","2.299900538812505E7","298.9870700456235"
"8420","65201","65195","2","65197","168912","14302.591875","0.18593369437499999","2.3013307980000053E7","299.17300373999853"
"8421","65197","65190","8","65198","168920","14302.811249999999","0.18593654624999997","2.3027610791250054E7","299.3589402862485"
"8422","65198","65194","7","65201","168927","14303.469375","0.185945101875","2.3041914260625053E7","299.54488538812353"
"8423","65201","65199","6","65205","168933","14304.346875","0.18595650937499997","2.3056218607500054E7","299.7308418974985"
"8424","65205","65204","1","65205","168934","14304.346875","0.18595650937499997","2.3070522954375055E7","299.9167984068735"
"8425","65205","65204","5","65209","168939","14305.224375","0.18596791687499997","2.3084828178750053E7","300.1027663237485"
"8426","65209","65204","2","65206","168941","14304.56625","0.18595936124999998","2.3099132745000053E7","300.2887256849985"
"8427","65206","65200","2","65202","168943","14303.68875","0.18594795374999998","2.3113436433750052E7","300.47467363874847"
"8428","65202","65201","7","65208","168950","14305.005","0.18596506499999998","2.312774143875005E7","300.6606387037485"
"8429","65208","65207","1","65208","168951","14305.005","0.18596506499999998","2.314204644375005E7","300.8466037687485"
"8430","65208","65205","9","65214","168960","14306.32125","0.18598217625","2.315635276500005E7","301.03258594499846"
"8431","65214","65206","8","65214","168968","14306.32125","0.18598217625","2.3170659086250048E7","301.21856812124844"
"8432","65214","65207","8","65215","168976","14306.540625","0.18598502812499998","2.3184965626875047E7","301.40455314937344"
"8433","65215","65209","7","65216","168983","14306.760000000002","0.18598788000000002","2.319927238687505E7","301.59054102937347"
"8434","65216","65207","9","65216","168992","14306.760000000002","0.18598788000000002","2.321357914687505E7","301.7765289093735"
"8435","65216","65211","9","65220","169001","14307.6375","0.1859992875","2.322788678437505E7","301.9625281968735"
"8436","65220","65216","6","65222","169007","14308.07625","0.18600499125","2.324219486062505E7","302.1485331881235"
"8437","65222","65216","9","65225","169016","14308.734375","0.186013546875","2.325650359500005E7","302.3345467349985"
"8438","65225","65218","2","65220","169018","14307.6375","0.1859992875","2.327081123250005E7","302.52054602249854"
"8439","65220","65214","5","65219","169023","14307.418125","0.18599643562499998","2.328511865062505E7","302.7065424581235"
"8440","65219","65218","7","65225","169030","14308.734375","0.186013546875","2.329942738500005E7","302.89255600499854"
"8441","65225","65219","8","65227","169038","14309.173125","0.186019250625","2.331373655812505E7","303.07857525562355"
"8442","65227","65225","2","65227","169040","14309.173125","0.186019250625","2.3328045731250048E7","303.26459450624856"
"8443","65227","65219","4","65223","169044","14308.295624999999","0.18600784312499996","2.334235402687505E7","303.4506023493736"
"8444","65223","65222","9","65231","169053","14310.050625","0.186030658125","2.335666407750005E7","303.6366330074986"
"8445","65231","65229","7","65236","169060","14311.1475","0.1860449175","2.337097522500005E7","303.8226779249986"
"8446","65236","65228","2","65230","169062","14309.83125","0.18602780624999998","2.338528505625005E7","304.0087057312486"
"8447","65230","65222","6","65228","169068","14309.392499999996","0.18602210249999995","2.339959444875005E7","304.1947278337486"
"8448","65228","65222","6","65228","169074","14309.392499999996","0.18602210249999995","2.3413903841250047E7","304.38074993624855"
"8449","65228","65225","2","65227","169076","14309.173125","0.186019250625","2.3428213014375046E7","304.56676918687356"
"8450","65227","65222","2","65224","169078","14308.515000000001","0.186010695","2.3442521529375046E7","304.75277988187355"
"8451","65224","65217","6","65223","169084","14308.295624999999","0.18600784312499996","2.3456829825000048E7","304.9387877249986"
"8452","65223","65214","3","65217","169087","14306.979374999999","0.18599073187499998","2.347113680437505E7","305.12477845687357"
"8453","65217","65212","7","65219","169094","14307.418125","0.18599643562499998","2.348544422250005E7","305.31077489249856"
"8454","65219","65210","6","65216","169100","14306.760000000002","0.18598788000000002","2.349975098250005E7","305.4967627724986"
"8455","65216","65207","3","65210","169103","14305.44375","0.18597076875","2.351405642625005E7","305.6827335412486"
"8456","65210","65208","9","65217","169112","14306.979374999999","0.18599073187499998","2.3528363405625053E7","305.8687242731236"
"8457","65217","65211","8","65219","169120","14307.418125","0.18599643562499998","2.3542670823750053E7","306.05472070874856"
"8458","65219","65213","3","65216","169123","14306.760000000002","0.18598788000000002","2.3556977583750054E7","306.2407085887486"
"8459","65216","65210","3","65213","169126","14306.101874999998","0.18597932437499998","2.3571283685625054E7","306.4266879131236"
"8460","65213","65209","9","65218","169135","14307.19875","0.18599358375","2.3585590884375054E7","306.6126814968736"
"8461","65218","65217","6","65223","169141","14308.295624999999","0.18600784312499996","2.3599899180000056E7","306.79868933999865"
"8462","65223","65214","8","65222","169149","14308.07625","0.18600499125","2.3614207256250057E7","306.98469433124865"
"8463","65222","65221","8","65229","169157","14309.611875","0.186024954375","2.362851686812506E7","307.17071928562365"
"8464","65229","65221","2","65223","169159","14308.295624999999","0.18600784312499996","2.364282516375006E7","307.3567271287487"
"8465","65223","65214","5","65219","169164","14307.418125","0.18599643562499998","2.365713258187506E7","307.54272356437366"
"8466","65219","65214","1","65215","169165","14306.540625","0.18598502812499998","2.367143912250006E7","307.72870859249866"
"8467","65215","65206","7","65213","169172","14306.101874999998","0.18597932437499998","2.3685745224375058E7","307.9146879168737"
"8468","65213","65204","3","65207","169175","14304.785624999999","0.18596221312499997","2.3700050010000058E7","308.10065012999866"
"8469","65207","65198","3","65201","169178","14303.469375","0.185945101875","2.3714353479375057E7","308.28659523187366"
"8470","65201","65196","4","65200","169182","14303.25","0.18594224999999998","2.3728656729375057E7","308.47253748187364"
"8471","65200","65192","6","65198","169188","14302.811249999999","0.18593654624999997","2.3742959540625058E7","308.65847402812363"
"8472","65198","65189","6","65195","169194","14302.153125","0.185927990625","2.3757261693750057E7","308.8444020187486"
"8473","65195","65194","7","65201","169201","14303.469375","0.185945101875","2.3771565163125057E7","309.0303471206236"
"8474","65201","65195","8","65203","169209","14303.908124999996","0.18595080562499994","2.3785869071250055E7","309.2162979262486"
"8475","65203","65202","9","65211","169218","14305.663125","0.18597362062499997","2.3800174734375056E7","309.40227154687364"
"8476","65211","65209","3","65212","169221","14305.8825","0.1859764725","2.3814480616875056E7","309.5882480193736"
"8477","65212","65210","8","65218","169229","14307.19875","0.18599358375","2.3828787815625057E7","309.77424160312364"
"8478","65218","65216","9","65225","169238","14308.734375","0.186013546875","2.3843096550000057E7","309.96025514999866"
"8479","65225","65224","9","65233","169247","14310.489375","0.18603636187499997","2.3857407039375056E7","310.14629151187364"
"8480","65233","65225","3","65228","169250","14309.392499999996","0.18602210249999995","2.3871716431875054E7","310.3323136143736"
"8481","65228","65220","3","65223","169253","14308.295624999999","0.18600784312499996","2.3886024727500055E7","310.51832145749864"
"8482","65223","65214","1","65215","169254","14306.540625","0.18598502812499998","2.3900331268125053E7","310.70430648562365"
"8483","65215","65209","3","65212","169257","14305.8825","0.1859764725","2.3914637150625054E7","310.89028295812363"
"8484","65212","65203","2","65205","169259","14304.346875","0.18595650937499997","2.3928941497500055E7","311.0762394674986"
"8485","65205","65198","3","65201","169262","14303.469375","0.185945101875","2.3943244966875054E7","311.26218456937363"
"8486","65201","65195","8","65203","169270","14303.908124999996","0.18595080562499994","2.3957548875000052E7","311.4481353749986"
"8487","65203","65196","8","65204","169278","14304.1275","0.1859536575","2.3971853002500053E7","311.63408903249865"
"8488","65204","65199","2","65201","169280","14303.469375","0.185945101875","2.3986156471875053E7","311.82003413437366"
"8489","65201","65194","4","65198","169284","14302.811249999999","0.18593654624999997","2.4000459283125054E7","312.00597068062365"
"8490","65198","65197","2","65199","169286","14303.030625000001","0.18593939812500002","2.4014762313750055E7","312.19191007874866"
"8491","65199","65190","6","65196","169292","14302.372500000001","0.1859308425","2.4029064686250053E7","312.37784092124866"
"8492","65196","65193","8","65201","169300","14303.469375","0.185945101875","2.4043368155625053E7","312.56378602312367"
"8493","65201","65192","5","65197","169305","14302.591875","0.18593369437499999","2.4057670747500055E7","312.7497197174987"
"8494","65197","65188","3","65191","169308","14301.275625000002","0.185916583125","2.4071972023125056E7","312.9356363006237"
"8495","65191","65185","1","65186","169309","14300.17875","0.18590232375","2.4086272201875057E7","313.12153862437367"
"8496","65186","65178","9","65187","169318","14300.398125","0.18590517562499997","2.4100572600000057E7","313.3074437999987"
"8497","65187","65179","7","65186","169325","14300.17875","0.18590232375","2.411487277875006E7","313.49334612374867"
"8498","65186","65179","9","65188","169334","14300.617499999998","0.18590802749999996","2.4129173396250058E7","313.67925415124864"
"8499","65188","65179","1","65180","169335","14298.8625","0.18588521249999998","2.414347225875006E7","313.86513936374865"
"8500","65180","65175","6","65181","169341","14299.081875","0.185888064375","2.415777134062506E7","314.05102742812363"
"8501","65181","65174","6","65180","169347","14298.8625","0.18588521249999998","2.417207020312506E7","314.23691264062364"
"8502","65180","65178","9","65187","169356","14300.398125","0.18590517562499997","2.418637060125006E7","314.42281781624865"
"8503","65187","65184","6","65190","169362","14301.05625","0.18591373125","2.420067165750006E7","314.6087315474987"
"8504","65190","65187","2","65189","169364","14300.836875","0.185910879375","2.4214972494375058E7","314.7946424268737"
"8505","65189","65181","6","65187","169370","14300.398125","0.18590517562499997","2.4229272892500058E7","314.9805476024987"
"8506","65187","65183","2","65185","169372","14299.959375","0.185899471875","2.424357285187506E7","315.1664470743737"
"8507","65185","65177","4","65181","169376","14299.081875","0.185888064375","2.425787193375006E7","315.3523351387487"
"8508","65181","65180","6","65186","169382","14300.17875","0.18590232375","2.427217211250006E7","315.53823746249867"
"8509","65186","65185","1","65186","169383","14300.17875","0.18590232375","2.428647229125006E7","315.72413978624866"
"8510","65186","65180","1","65181","169384","14299.081875","0.185888064375","2.430077137312506E7","315.91002785062364"
"8511","65181","65175","7","65182","169391","14299.301249999999","0.18589091624999998","2.431507067437506E7","316.09591876687364"
"8512","65182","65175","1","65176","169392","14297.985","0.185873805","2.432936865937506E7","316.28179257187367"
"8513","65176","65171","7","65178","169399","14298.423749999996","0.18587950874999995","2.434366708312506E7","316.4676720806237"
"8514","65178","65169","2","65171","169401","14296.888125000001","0.185859545625","2.4357963971250057E7","316.6535316262487"
"8515","65171","65166","7","65173","169408","14297.326874999999","0.18586524937499999","2.437226129812506E7","316.8393968756237"
"8516","65173","65172","5","65177","169413","14298.204375","0.185876656875","2.4386559502500057E7","317.0252735324987"
"8517","65177","65173","8","65181","169421","14299.081875","0.185888064375","2.4400858584375057E7","317.2111615968737"
"8518","65181","65179","6","65185","169427","14299.959375","0.185899471875","2.441515854375006E7","317.3970610687487"
"8519","65185","65180","8","65188","169435","14300.617499999998","0.18590802749999996","2.442945916125006E7","317.5829690962487"
"8520","65188","65180","1","65181","169436","14299.081875","0.185888064375","2.444375824312506E7","317.76885716062367"
"8521","65181","65174","3","65177","169439","14298.204375","0.185876656875","2.4458056447500058E7","317.95473381749866"
"8522","65177","65176","5","65181","169444","14299.081875","0.185888064375","2.4472355529375058E7","318.14062188187364"
"8523","65181","65180","7","65187","169451","14300.398125","0.18590517562499997","2.4486655927500058E7","318.32652705749865"
"8524","65187","65181","8","65189","169459","14300.836875","0.185910879375","2.4500956764375057E7","318.51243793687365"
"8525","65189","65182","5","65187","169464","14300.398125","0.18590517562499997","2.4515257162500057E7","318.69834311249866"
"8526","65187","65184","5","65189","169469","14300.836875","0.185910879375","2.4529557999375056E7","318.88425399187366"
"8527","65189","65186","8","65194","169477","14301.93375","0.18592513875","2.4543859933125056E7","319.07017913062367"
"8528","65194","65190","2","65192","169479","14301.494999999999","0.18591943499999997","2.4558161428125057E7","319.2560985656237"
"8529","65192","65188","3","65191","169482","14301.275625000002","0.185916583125","2.457246270375006E7","319.4420151487487"
"8530","65191","65187","6","65193","169488","14301.714375","0.18592228687499998","2.458676441812506E7","319.62793743562366"
"8531","65193","65187","7","65194","169495","14301.93375","0.18592513875","2.460106635187506E7","319.8138625743737"
"8532","65194","65185","9","65194","169504","14301.93375","0.18592513875","2.461536828562506E7","319.9997877131237"
"8533","65194","65192","7","65199","169511","14303.030625000001","0.18593939812500002","2.462967131625006E7","320.1857271112487"
"8534","65199","65190","9","65199","169520","14303.030625000001","0.18593939812500002","2.464397434687506E7","320.3716665093737"
"8535","65199","65195","2","65197","169522","14302.591875","0.18593369437499999","2.4658276938750062E7","320.55760020374873"
"8536","65197","65191","2","65193","169524","14301.714375","0.18592228687499998","2.4672578653125063E7","320.7435224906237"
"8537","65193","65185","4","65189","169528","14300.836875","0.185910879375","2.468687949000006E7","320.9294333699987"
"8538","65189","65188","7","65195","169535","14302.153125","0.185927990625","2.470118164312506E7","321.1153613606237"
"8539","65195","65188","6","65194","169541","14301.93375","0.18592513875","2.471548357687506E7","321.3012864993737"
"8540","65194","65192","2","65194","169543","14301.93375","0.18592513875","2.472978551062506E7","321.4872116381237"
"8541","65194","65193","8","65201","169551","14303.469375","0.185945101875","2.474408898000006E7","321.6731567399987"
"8542","65201","65192","4","65196","169555","14302.372500000001","0.1859308425","2.475839135250006E7","321.8590875824987"
"8543","65196","65187","2","65189","169557","14300.836875","0.185910879375","2.4772692189375058E7","322.0449984618737"
"8544","65189","65188","1","65189","169558","14300.836875","0.185910879375","2.4786993026250057E7","322.2309093412487"
"8545","65189","65188","6","65194","169564","14301.93375","0.18592513875","2.4801294960000057E7","322.4168344799987"
"8546","65194","65186","3","65189","169567","14300.836875","0.185910879375","2.4815595796875056E7","322.6027453593737"
"8547","65189","65185","2","65187","169569","14300.398125","0.18590517562499997","2.4829896195000056E7","322.78865053499874"
"8548","65187","65185","8","65193","169577","14301.714375","0.18592228687499998","2.4844197909375057E7","322.9745728218737"
"8549","65193","65188","6","65194","169583","14301.93375","0.18592513875","2.4858499843125056E7","323.16049796062373"
"8550","65194","65193","4","65197","169587","14302.591875","0.18593369437499999","2.487280243500006E7","323.34643165499875"
"8551","65197","65196","1","65197","169588","14302.591875","0.18593369437499999","2.488710502687506E7","323.5323653493738"
"8552","65197","65189","4","65193","169592","14301.714375","0.18592228687499998","2.490140674125006E7","323.71828763624876"
"8553","65193","65192","2","65194","169594","14301.93375","0.18592513875","2.491570867500006E7","323.90421277499877"
"8554","65194","65187","3","65190","169597","14301.05625","0.18591373125","2.493000973125006E7","324.0901265062488"
"8555","65190","65185","4","65189","169601","14300.836875","0.185910879375","2.4944310568125058E7","324.2760373856238"
"8556","65189","65184","4","65188","169605","14300.617499999998","0.18590802749999996","2.4958611185625058E7","324.4619454131238"
"8557","65188","65185","7","65192","169612","14301.494999999999","0.18591943499999997","2.497291268062506E7","324.6478648481238"
"8558","65192","65188","5","65193","169617","14301.714375","0.18592228687499998","2.498721439500006E7","324.8337871349988"
"8559","65193","65189","3","65192","169620","14301.494999999999","0.18591943499999997","2.500151589000006E7","325.0197065699988"
"8560","65192","65183","9","65192","169629","14301.494999999999","0.18591943499999997","2.501581738500006E7","325.2056260049988"
"8561","65192","65189","6","65195","169635","14302.153125","0.185927990625","2.503011953812506E7","325.3915539956238"
"8562","65195","65188","8","65196","169643","14302.372500000001","0.1859308425","2.504442191062506E7","325.5774848381238"
"8563","65196","65189","1","65190","169644","14301.05625","0.18591373125","2.5058722966875058E7","325.7633985693738"
"8564","65190","65189","7","65196","169651","14302.372500000001","0.1859308425","2.5073025339375056E7","325.9493294118738"
"8565","65196","65188","3","65191","169654","14301.275625000002","0.185916583125","2.5087326615000058E7","326.1352459949988"
"8566","65191","65187","9","65196","169663","14302.372500000001","0.1859308425","2.5101628987500057E7","326.3211768374988"
"8567","65196","65193","7","65200","169670","14303.25","0.18594224999999998","2.5115932237500057E7","326.5071190874988"
"8568","65200","65199","5","65204","169675","14304.1275","0.1859536575","2.5130236365000058E7","326.6930727449988"
"8569","65204","65202","1","65203","169676","14303.908124999996","0.18595080562499994","2.5144540273125056E7","326.8790235506238"
"8570","65203","65202","7","65209","169683","14305.224375","0.18596791687499997","2.5158845497500055E7","327.06499146749877"
"8571","65209","65205","6","65211","169689","14305.663125","0.18597362062499997","2.5173151160625055E7","327.2509650881238"
"8572","65211","65204","5","65209","169694","14305.224375","0.18596791687499997","2.5187456385000054E7","327.43693300499876"
"8573","65209","65204","6","65210","169700","14305.44375","0.18597076875","2.5201761828750055E7","327.62290377374876"
"8574","65210","65203","9","65212","169709","14305.8825","0.1859764725","2.5216067711250056E7","327.80888024624875"
"8575","65212","65210","2","65212","169711","14305.8825","0.1859764725","2.5230373593750056E7","327.99485671874874"
"8576","65212","65210","5","65215","169716","14306.540625","0.18598502812499998","2.5244680134375054E7","328.18084174687374"
"8577","65215","65208","3","65211","169719","14305.663125","0.18597362062499997","2.5258985797500055E7","328.36681536749876"
"8578","65211","65203","5","65208","169724","14305.005","0.18596506499999998","2.5273290802500054E7","328.55278043249876"
"8579","65208","65205","2","65207","169726","14304.785624999999","0.18596221312499997","2.5287595588125054E7","328.73874264562374"
"8580","65207","65206","5","65211","169731","14305.663125","0.18597362062499997","2.5301901251250055E7","328.92471626624877"
"8581","65211","65202","3","65205","169734","14304.346875","0.18595650937499997","2.5316205598125055E7","329.11067277562375"
"8582","65205","65202","5","65207","169739","14304.785624999999","0.18596221312499997","2.5330510383750055E7","329.29663498874874"
"8583","65207","65199","1","65200","169740","14303.25","0.18594224999999998","2.5344813633750055E7","329.4825772387487"
"8584","65200","65195","9","65204","169749","14304.1275","0.1859536575","2.5359117761250056E7","329.66853089624874"
"8585","65204","65201","1","65202","169750","14303.68875","0.18594795374999998","2.5373421450000055E7","329.8544788499987"
"8586","65202","65194","2","65196","169752","14302.372500000001","0.1859308425","2.5387723822500054E7","330.0404096924987"
"8587","65196","65192","4","65196","169756","14302.372500000001","0.1859308425","2.5402026195000052E7","330.2263405349987"
"8588","65196","65187","2","65189","169758","14300.836875","0.185910879375","2.541632703187505E7","330.4122514143737"
"8589","65189","65182","7","65189","169765","14300.836875","0.185910879375","2.543062786875005E7","330.5981622937487"
"8590","65189","65182","5","65187","169770","14300.398125","0.18590517562499997","2.544492826687505E7","330.7840674693737"
"8591","65187","65180","9","65189","169779","14300.836875","0.185910879375","2.545922910375005E7","330.9699783487487"
"8592","65189","65188","5","65193","169784","14301.714375","0.18592228687499998","2.547353081812505E7","331.1559006356237"
"8593","65193","65191","4","65195","169788","14302.153125","0.185927990625","2.548783297125005E7","331.3418286262487"
"8594","65195","65190","4","65194","169792","14301.93375","0.18592513875","2.550213490500005E7","331.5277537649987"
"8595","65194","65186","4","65190","169796","14301.05625","0.18591373125","2.5516435961250048E7","331.7136674962487"
"8596","65190","65186","7","65193","169803","14301.714375","0.18592228687499998","2.553073767562505E7","331.8995897831237"
"8597","65193","65189","2","65191","169805","14301.275625000002","0.185916583125","2.554503895125005E7","332.0855063662487"
"8598","65191","65188","9","65197","169814","14302.591875","0.18593369437499999","2.5559341543125052E7","332.2714400606237"
"8599","65197","65190","2","65192","169816","14301.494999999999","0.18591943499999997","2.5573643038125053E7","332.45735949562373"
"8600","65192","65191","3","65194","169819","14301.93375","0.18592513875","2.5587944971875053E7","332.64328463437374"
"8601","65194","65191","1","65192","169820","14301.494999999999","0.18591943499999997","2.5602246466875054E7","332.82920406937376"
"8602","65192","65191","5","65196","169825","14302.372500000001","0.1859308425","2.5616548839375053E7","333.01513491187376"
"8603","65196","65195","8","65203","169833","14303.908124999996","0.18595080562499994","2.563085274750005E7","333.20108571749876"
"8604","65203","65194","7","65201","169840","14303.469375","0.185945101875","2.564515621687505E7","333.38703081937376"
"8605","65201","65193","7","65200","169847","14303.25","0.18594224999999998","2.565945946687505E7","333.57297306937375"
"8606","65200","65191","9","65200","169856","14303.25","0.18594224999999998","2.567376271687505E7","333.7589153193737"
"8607","65200","65192","3","65195","169859","14302.153125","0.185927990625","2.568806487000005E7","333.9448433099987"
"8608","65195","65190","4","65194","169863","14301.93375","0.18592513875","2.570236680375005E7","334.1307684487487"
"8609","65194","65187","7","65194","169870","14301.93375","0.18592513875","2.571666873750005E7","334.3166935874987"
"8610","65194","65192","2","65194","169872","14301.93375","0.18592513875","2.573097067125005E7","334.5026187262487"
"8611","65194","65187","6","65193","169878","14301.714375","0.18592228687499998","2.574527238562505E7","334.6885410131237"
"8612","65193","65192","1","65193","169879","14301.714375","0.18592228687499998","2.575957410000005E7","334.8744632999987"
"8613","65193","65192","6","65198","169885","14302.811249999999","0.18593654624999997","2.577387691125005E7","335.0603998462487"
"8614","65198","65193","7","65200","169892","14303.25","0.18594224999999998","2.578818016125005E7","335.24634209624867"
"8615","65200","65193","1","65194","169893","14301.93375","0.18592513875","2.580248209500005E7","335.4322672349987"
"8616","65194","65192","5","65197","169898","14302.591875","0.18593369437499999","2.5816784686875053E7","335.6182009293737"
"8617","65197","65190","4","65194","169902","14301.93375","0.18592513875","2.5831086620625053E7","335.8041260681237"
"8618","65194","65192","1","65193","169903","14301.714375","0.18592228687499998","2.5845388335000053E7","335.9900483549987"
"8619","65193","65190","4","65194","169907","14301.93375","0.18592513875","2.5859690268750053E7","336.1759734937487"
"8620","65194","65192","2","65194","169909","14301.93375","0.18592513875","2.5873992202500053E7","336.3618986324987"
"8621","65194","65190","5","65195","169914","14302.153125","0.185927990625","2.5888294355625052E7","336.5478266231237"
"8622","65195","65193","7","65200","169921","14303.25","0.18594224999999998","2.5902597605625052E7","336.73376887312367"
"8623","65200","65198","7","65205","169928","14304.346875","0.18595650937499997","2.5916901952500053E7","336.91972538249865"
"8624","65205","65200","3","65203","169931","14303.908124999996","0.18595080562499994","2.593120586062505E7","337.10567618812365"
"8625","65203","65202","4","65206","169935","14304.56625","0.18595936124999998","2.594551042687505E7","337.29163554937367"
"8626","65206","65198","8","65206","169943","14304.56625","0.18595936124999998","2.595981499312505E7","337.4775949106237"
"8627","65206","65199","1","65200","169944","14303.25","0.18594224999999998","2.597411824312505E7","337.66353716062366"
"8628","65200","65191","2","65193","169946","14301.714375","0.18592228687499998","2.598841995750005E7","337.84945944749865"
"8629","65193","65186","3","65189","169949","14300.836875","0.185910879375","2.600272079437505E7","338.03537032687365"
"8630","65189","65187","6","65193","169955","14301.714375","0.18592228687499998","2.601702250875005E7","338.22129261374863"
"8631","65193","65189","2","65191","169957","14301.275625000002","0.185916583125","2.6031323784375053E7","338.4072091968736"
"8632","65191","65190","1","65191","169958","14301.275625000002","0.185916583125","2.6045625060000055E7","338.5931257799986"
"8633","65191","65185","9","65194","169967","14301.93375","0.18592513875","2.6059926993750054E7","338.7790509187486"
"8634","65194","65186","1","65187","169968","14300.398125","0.18590517562499997","2.6074227391875055E7","338.96495609437363"
"8635","65187","65184","3","65187","169971","14300.398125","0.18590517562499997","2.6088527790000055E7","339.15086126999864"
"8636","65187","65182","6","65188","169977","14300.617499999998","0.18590802749999996","2.6102828407500055E7","339.3367692974986"
"8637","65188","65184","1","65185","169978","14299.959375","0.185899471875","2.6117128366875056E7","339.52266876937364"
"8638","65185","65180","7","65187","169985","14300.398125","0.18590517562499997","2.6131428765000056E7","339.70857394499865"
"8639","65187","65178","2","65180","169987","14298.8625","0.18588521249999998","2.6145727627500057E7","339.89445915749866"
"8640","65180","65176","4","65180","169991","14298.8625","0.18588521249999998","2.6160026490000058E7","340.08034436999867"
"8641","65180","65172","2","65174","169993","14297.546250000001","0.18586810125","2.617432403625006E7","340.26621247124865"
"8642","65174","65169","7","65176","170000","14297.985","0.185873805","2.6188622021250058E7","340.4520862762487"
"8643","65176","65173","5","65178","170005","14298.423749999996","0.18587950874999995","2.6202920445000056E7","340.6379657849987"
"8644","65178","65174","4","65178","170009","14298.423749999996","0.18587950874999995","2.6217218868750054E7","340.8238452937487"
"8645","65178","65176","1","65177","170010","14298.204375","0.185876656875","2.6231517073125053E7","341.0097219506237"
"8646","65177","65174","6","65180","170016","14298.8625","0.18588521249999998","2.6245815935625054E7","341.1956071631237"
"8647","65180","65175","8","65183","170024","14299.520625","0.18589376812499997","2.6260115456250053E7","341.38150093124875"
"8648","65183","65179","5","65184","170029","14299.74","0.18589661999999998","2.627441519625005E7","341.56739755124875"
"8649","65184","65180","2","65182","170031","14299.301249999999","0.18589091624999998","2.628871449750005E7","341.75328846749875"
"8650","65182","65177","9","65186","170040","14300.17875","0.18590232375","2.630301467625005E7","341.93919079124873"
"8651","65186","65185","6","65191","170046","14301.275625000002","0.185916583125","2.6317315951875053E7","342.1251073743737"
"8652","65191","65187","8","65195","170054","14302.153125","0.185927990625","2.6331618105000053E7","342.3110353649987"
"8653","65195","65190","5","65195","170059","14302.153125","0.185927990625","2.634592025812505E7","342.4969633556237"
"8654","65195","65192","5","65197","170064","14302.591875","0.18593369437499999","2.6360222850000054E7","342.6828970499987"
"8655","65197","65193","2","65195","170066","14302.153125","0.185927990625","2.6374525003125053E7","342.8688250406237"
"8656","65195","65191","4","65195","170070","14302.153125","0.185927990625","2.6388827156250052E7","343.05475303124865"
"8657","65195","65193","2","65195","170072","14302.153125","0.185927990625","2.640312930937505E7","343.2406810218736"
"8658","65195","65189","1","65190","170073","14301.05625","0.18591373125","2.641743036562505E7","343.42659475312365"
"8659","65190","65185","8","65193","170081","14301.714375","0.18592228687499998","2.643173208000005E7","343.61251703999864"
"8660","65193","65192","2","65194","170083","14301.93375","0.18592513875","2.644603401375005E7","343.79844217874864"
"8661","65194","65187","6","65193","170089","14301.714375","0.18592228687499998","2.646033572812505E7","343.9843644656236"
"8662","65193","65185","2","65187","170091","14300.398125","0.18590517562499997","2.647463612625005E7","344.17026964124864"
"8663","65187","65184","7","65191","170098","14301.275625000002","0.185916583125","2.6488937401875053E7","344.35618622437363"
"8664","65191","65187","4","65191","170102","14301.275625000002","0.185916583125","2.6503238677500054E7","344.5421028074986"
"8665","65191","65188","7","65195","170109","14302.153125","0.185927990625","2.6517540830625053E7","344.7280307981236"
"8666","65195","65190","7","65197","170116","14302.591875","0.18593369437499999","2.6531843422500055E7","344.9139644924986"
"8667","65197","65195","3","65198","170119","14302.811249999999","0.18593654624999997","2.6546146233750056E7","345.0999010387486"
"8668","65198","65194","1","65195","170120","14302.153125","0.185927990625","2.6560448386875056E7","345.2858290293736"
"8669","65195","65192","1","65193","170121","14301.714375","0.18592228687499998","2.6574750101250056E7","345.4717513162486"
"8670","65193","65189","3","65192","170124","14301.494999999999","0.18591943499999997","2.6589051596250057E7","345.6576707512486"
"8671","65192","65186","1","65187","170125","14300.398125","0.18590517562499997","2.6603351994375058E7","345.8435759268736"
"8672","65187","65186","9","65195","170134","14302.153125","0.185927990625","2.6617654147500057E7","346.0295039174986"
"8673","65195","65187","5","65192","170139","14301.494999999999","0.18591943499999997","2.6631955642500058E7","346.2154233524986"
"8674","65192","65186","6","65192","170145","14301.494999999999","0.18591943499999997","2.664625713750006E7","346.4013427874986"
"8675","65192","65186","5","65191","170150","14301.275625000002","0.185916583125","2.666055841312506E7","346.5872593706236"
"8676","65191","65183","5","65188","170155","14300.617499999998","0.18590802749999996","2.667485903062506E7","346.7731673981236"
"8677","65188","65179","3","65182","170158","14299.301249999999","0.18589091624999998","2.668915833187506E7","346.9590583143736"
"8678","65182","65174","7","65181","170165","14299.081875","0.185888064375","2.670345741375006E7","347.14494637874856"
"8679","65181","65176","3","65179","170168","14298.643125","0.185882360625","2.671775605687506E7","347.33082873937354"
"8680","65179","65177","1","65178","170169","14298.423749999996","0.18587950874999995","2.673205448062506E7","347.51670824812356"
"8681","65178","65176","7","65183","170176","14299.520625","0.18589376812499997","2.674635400125006E7","347.7026020162486"
"8682","65183","65177","5","65182","170181","14299.301249999999","0.18589091624999998","2.6760653302500058E7","347.8884929324986"
"8683","65182","65180","5","65185","170186","14299.959375","0.185899471875","2.677495326187506E7","348.0743924043736"
"8684","65185","65183","1","65184","170187","14299.74","0.18589661999999998","2.6789253001875058E7","348.2602890243736"
"8685","65184","65175","3","65178","170190","14298.423749999996","0.18587950874999995","2.6803551425625056E7","348.4461685331236"
"8686","65178","65173","5","65178","170195","14298.423749999996","0.18587950874999995","2.6817849849375054E7","348.63204804187365"
"8687","65178","65174","1","65175","170196","14297.765625","0.185870953125","2.6832147615000054E7","348.81791899499865"
"8688","65175","65167","9","65176","170205","14297.985","0.185873805","2.6846445600000054E7","349.0037927999987"
"8689","65176","65173","8","65181","170213","14299.081875","0.185888064375","2.6860744681875054E7","349.18968086437366"
"8690","65181","65180","2","65182","170215","14299.301249999999","0.18589091624999998","2.6875043983125053E7","349.37557178062366"
"8691","65182","65178","1","65179","170216","14298.643125","0.185882360625","2.6889342626250055E7","349.56145414124865"
"8692","65179","65172","3","65175","170219","14297.765625","0.185870953125","2.6903640391875055E7","349.74732509437365"
"8693","65175","65170","9","65179","170228","14298.643125","0.185882360625","2.6917939035000056E7","349.93320745499864"
"8694","65179","65170","5","65175","170233","14297.765625","0.185870953125","2.6932236800625056E7","350.11907840812364"
"8695","65175","65170","4","65174","170237","14297.546250000001","0.18586810125","2.6946534346875057E7","350.3049465093736"
"8696","65174","65168","9","65177","170246","14298.204375","0.185876656875","2.6960832551250055E7","350.4908231662486"
"8697","65177","65172","2","65174","170248","14297.546250000001","0.18586810125","2.6975130097500056E7","350.6766912674986"
"8698","65174","65171","1","65172","170249","14297.1075","0.1858623975","2.6989427205000058E7","350.8625536649986"
"8699","65172","65170","1","65171","170250","14296.888125000001","0.185859545625","2.7003724093125056E7","351.0484132106236"
"8700","65171","65169","4","65173","170254","14297.326874999999","0.18586524937499999","2.7018021420000058E7","351.2342784599986"
"8701","65173","65170","3","65173","170257","14297.326874999999","0.18586524937499999","2.703231874687506E7","351.42014370937363"
"8702","65173","65164","4","65168","170261","14296.23","0.18585099","2.704661497687506E7","351.60599469937364"
"8703","65168","65166","8","65174","170269","14297.546250000001","0.18586810125","2.706091252312506E7","351.7918628006236"
"8704","65174","65167","2","65169","170271","14296.449375","0.18585384187499998","2.707520897250006E7","351.9777166424986"
"8705","65169","65166","5","65171","170276","14296.888125000001","0.185859545625","2.708950586062506E7","352.1635761881236"
"8706","65171","65163","8","65171","170284","14296.888125000001","0.185859545625","2.7103802748750057E7","352.34943573374863"
"8707","65171","65163","8","65171","170292","14296.888125000001","0.185859545625","2.7118099636875056E7","352.53529527937366"
"8708","65171","65170","9","65179","170301","14298.643125","0.185882360625","2.7132398280000057E7","352.72117763999864"
"8709","65179","65177","2","65179","170303","14298.643125","0.185882360625","2.714669692312506E7","352.90706000062363"
"8710","65179","65175","5","65180","170308","14298.8625","0.18588521249999998","2.716099578562506E7","353.09294521312364"
"8711","65180","65179","3","65182","170311","14299.301249999999","0.18589091624999998","2.717529508687506E7","353.27883612937364"
"8712","65182","65175","3","65178","170314","14298.423749999996","0.18587950874999995","2.7189593510625057E7","353.46471563812366"
"8713","65178","65171","5","65176","170319","14297.985","0.185873805","2.7203891495625056E7","353.6505894431237"
"8714","65176","65167","2","65169","170321","14296.449375","0.18585384187499998","2.7218187945000056E7","353.83644328499867"
"8715","65169","65163","1","65164","170322","14295.3525","0.1858395825","2.7232483297500055E7","354.0222828674987"
"8716","65164","65163","4","65167","170326","14296.010624999999","0.18584813812499998","2.7246779308125056E7","354.20813100562367"
"8717","65167","65162","9","65171","170335","14296.888125000001","0.185859545625","2.7261076196250055E7","354.3939905512487"
"8718","65171","65168","2","65170","170337","14296.66875","0.18585669375","2.7275372865000054E7","354.5798472449987"
"8719","65170","65162","4","65166","170341","14295.791250000002","0.18584528625000002","2.7289668656250056E7","354.7656925312487"
"8720","65166","65163","4","65167","170345","14296.010624999999","0.18584813812499998","2.7303964666875057E7","354.9515406693737"
"8721","65167","65164","8","65172","170353","14297.1075","0.1858623975","2.731826177437506E7","355.1374030668737"
"8722","65172","65168","8","65176","170361","14297.985","0.185873805","2.7332559759375058E7","355.3232768718737"
"8723","65176","65167","5","65172","170366","14297.1075","0.1858623975","2.734685686687506E7","355.5091392693737"
"8724","65172","65167","1","65168","170367","14296.23","0.18585099","2.736115309687506E7","355.6949902593737"
"8725","65168","65162","1","65163","170368","14295.133124999998","0.18583673062499997","2.737544823000006E7","355.8808269899987"
"8726","65163","65159","7","65166","170375","14295.791250000002","0.18584528625000002","2.738974402125006E7","356.0666722762487"
"8727","65166","65160","9","65169","170384","14296.449375","0.18585384187499998","2.740404047062506E7","356.2525261181237"
"8728","65169","65164","7","65171","170391","14296.888125000001","0.185859545625","2.741833735875006E7","356.4383856637487"
"8729","65171","65169","8","65177","170399","14298.204375","0.185876656875","2.743263556312506E7","356.6242623206237"
"8730","65177","65171","7","65178","170406","14298.423749999996","0.18587950874999995","2.7446933986875057E7","356.8101418293737"
"8731","65178","65172","7","65179","170413","14298.643125","0.185882360625","2.746123263000006E7","356.9960241899987"
"8732","65179","65173","4","65177","170417","14298.204375","0.185876656875","2.7475530834375057E7","357.1819008468737"
"8733","65177","65170","4","65174","170421","14297.546250000001","0.18586810125","2.7489828380625058E7","357.3677689481237"
"8734","65174","65168","7","65175","170428","14297.765625","0.185870953125","2.7504126146250058E7","357.5536399012487"
"8735","65175","65167","2","65169","170430","14296.449375","0.18585384187499998","2.7518422595625058E7","357.73949374312366"
"8736","65169","65161","5","65166","170435","14295.791250000002","0.18584528625000002","2.753271838687506E7","357.9253390293737"
"8737","65166","65160","7","65167","170442","14296.010624999999","0.18584813812499998","2.754701439750006E7","358.11118716749866"
"8738","65167","65160","9","65169","170451","14296.449375","0.18585384187499998","2.756131084687506E7","358.29704100937363"
"8739","65169","65166","4","65170","170455","14296.66875","0.18585669375","2.757560751562506E7","358.4828977031236"
"8740","65170","65164","2","65166","170457","14295.791250000002","0.18584528625000002","2.758990330687506E7","358.66874298937364"
"8741","65166","65158","9","65167","170466","14296.010624999999","0.18584813812499998","2.7604199317500062E7","358.8545911274986"
"8742","65167","65162","5","65167","170471","14296.010624999999","0.18584813812499998","2.7618495328125063E7","359.0404392656236"
"8743","65167","65165","4","65169","170475","14296.449375","0.18585384187499998","2.7632791777500063E7","359.2262931074986"
"8744","65169","65161","5","65166","170480","14295.791250000002","0.18584528625000002","2.7647087568750065E7","359.4121383937486"
"8745","65166","65159","6","65165","170486","14295.571875","0.18584243437499998","2.7661383140625063E7","359.5979808281236"
"8746","65165","65160","5","65165","170491","14295.571875","0.18584243437499998","2.767567871250006E7","359.7838232624986"
"8747","65165","65156","7","65163","170498","14295.133124999998","0.18583673062499997","2.768997384562506E7","359.96965999312357"
"8748","65163","65154","4","65158","170502","14294.03625","0.18582247124999998","2.770426788187506E7","360.15548246437356"
"8749","65158","65155","5","65160","170507","14294.475","0.18582817499999998","2.7718562356875062E7","360.34131063937355"
"8750","65160","65159","9","65168","170516","14296.23","0.18585099","2.7732858586875062E7","360.52716162937355"
"8751","65168","65161","7","65168","170523","14296.23","0.18585099","2.7747154816875063E7","360.71301261937356"
"8752","65168","65164","3","65167","170526","14296.010624999999","0.18584813812499998","2.7761450827500064E7","360.89886075749854"
"8753","65167","65160","1","65161","170527","14294.694375","0.18583102687499997","2.7775745521875065E7","361.08469178437355"
"8754","65161","65160","6","65166","170533","14295.791250000002","0.18584528625000002","2.7790041313125066E7","361.27053707062356"
"8755","65166","65164","6","65170","170539","14296.66875","0.18585669375","2.7804337981875066E7","361.45639376437356"
"8756","65170","65165","2","65167","170541","14296.010624999999","0.18584813812499998","2.7818633992500067E7","361.64224190249854"
"8757","65167","65160","8","65168","170549","14296.23","0.18585099","2.7832930222500067E7","361.82809289249855"
"8758","65168","65167","5","65172","170554","14297.1075","0.1858623975","2.784722733000007E7","362.01395528999853"
"8759","65172","65169","6","65175","170560","14297.765625","0.185870953125","2.786152509562507E7","362.19982624312354"
"8760","65175","65167","5","65172","170565","14297.1075","0.1858623975","2.787582220312507E7","362.3856886406235"
"8761","65172","65163","5","65168","170570","14296.23","0.18585099","2.789011843312507E7","362.57153963062353"
"8762","65168","65164","8","65172","170578","14297.1075","0.1858623975","2.7904415540625073E7","362.7574020281235"
"8763","65172","65163","8","65171","170586","14296.888125000001","0.185859545625","2.791871242875007E7","362.94326157374854"
"8764","65171","65167","9","65176","170595","14297.985","0.185873805","2.793301041375007E7","363.1291353787486"
"8765","65176","65174","5","65179","170600","14298.643125","0.185882360625","2.7947309056875072E7","363.31501773937356"
"8766","65179","65178","6","65184","170606","14299.74","0.18589661999999998","2.796160879687507E7","363.50091435937355"
"8767","65184","65176","2","65178","170608","14298.423749999996","0.18587950874999995","2.797590722062507E7","363.6867938681236"
"8768","65178","65172","7","65179","170615","14298.643125","0.185882360625","2.799020586375007E7","363.87267622874856"
"8769","65179","65175","4","65179","170619","14298.643125","0.185882360625","2.800450450687507E7","364.05855858937355"
"8770","65179","65174","5","65179","170624","14298.643125","0.185882360625","2.8018803150000073E7","364.24444094999853"
"8771","65179","65173","8","65181","170632","14299.081875","0.185888064375","2.8033102231875073E7","364.4303290143735"
"8772","65181","65172","7","65179","170639","14298.643125","0.185882360625","2.8047400875000075E7","364.6162113749985"
"8773","65179","65175","9","65184","170648","14299.74","0.18589661999999998","2.8061700615000073E7","364.8021079949985"
"8774","65184","65181","5","65186","170653","14300.17875","0.18590232375","2.8076000793750074E7","364.9880103187485"
"8775","65186","65179","2","65181","170655","14299.081875","0.185888064375","2.8090299875625074E7","365.17389838312346"
"8776","65181","65175","9","65184","170664","14299.74","0.18589661999999998","2.8104599615625072E7","365.35979500312345"
"8777","65184","65177","8","65185","170672","14299.959375","0.185899471875","2.8118899575000074E7","365.54569447499847"
"8778","65185","65178","5","65183","170677","14299.520625","0.18589376812499997","2.8133199095625073E7","365.7315882431235"
"8779","65183","65181","2","65183","170679","14299.520625","0.18589376812499997","2.814749861625007E7","365.9174820112485"
"8780","65183","65175","1","65176","170680","14297.985","0.185873805","2.816179660125007E7","366.10335581624855"
"8781","65176","65170","2","65172","170682","14297.1075","0.1858623975","2.8176093708750073E7","366.28921821374854"
"8782","65172","65163","5","65168","170687","14296.23","0.18585099","2.8190389938750073E7","366.47506920374855"
"8783","65168","65160","7","65167","170694","14296.010624999999","0.18584813812499998","2.8204685949375074E7","366.6609173418735"
"8784","65167","65163","4","65167","170698","14296.010624999999","0.18584813812499998","2.8218981960000075E7","366.8467654799985"
"8785","65167","65164","7","65171","170705","14296.888125000001","0.185859545625","2.8233278848125074E7","367.03262502562353"
"8786","65171","65164","7","65171","170712","14296.888125000001","0.185859545625","2.8247575736250073E7","367.21848457124855"
"8787","65171","65170","9","65179","170721","14298.643125","0.185882360625","2.8261874379375074E7","367.40436693187354"
"8788","65179","65174","9","65183","170730","14299.520625","0.18589376812499997","2.8276173900000073E7","367.59026069999857"
"8789","65183","65174","6","65180","170736","14298.8625","0.18588521249999998","2.8290472762500074E7","367.7761459124986"
"8790","65180","65172","9","65181","170745","14299.081875","0.185888064375","2.8304771844375074E7","367.96203397687356"
"8791","65181","65172","1","65173","170746","14297.326874999999","0.18586524937499999","2.8319069171250075E7","368.14789922624857"
"8792","65173","65166","9","65175","170755","14297.765625","0.185870953125","2.8333366936875075E7","368.3337701793736"
"8793","65175","65167","5","65172","170760","14297.1075","0.1858623975","2.8347664044375077E7","368.51963257687356"
"8794","65172","65166","5","65171","170765","14296.888125000001","0.185859545625","2.8361960932500076E7","368.7054921224986"
"8795","65171","65165","5","65170","170770","14296.66875","0.18585669375","2.8376257601250075E7","368.8913488162486"
"8796","65170","65169","9","65178","170779","14298.423749999996","0.18587950874999995","2.8390556025000073E7","369.0772283249986"
"8797","65178","65173","5","65178","170784","14298.423749999996","0.18587950874999995","2.840485444875007E7","369.2631078337486"
"8798","65178","65175","9","65184","170793","14299.74","0.18589661999999998","2.841915418875007E7","369.4490044537486"
"8799","65184","65179","3","65182","170796","14299.301249999999","0.18589091624999998","2.843345349000007E7","369.6348953699986"
"8800","65182","65178","1","65179","170797","14298.643125","0.185882360625","2.844775213312507E7","369.8207777306236"
"8801","65179","65172","4","65176","170801","14297.985","0.185873805","2.846205011812507E7","370.00665153562363"
"8802","65176","65171","3","65174","170804","14297.546250000001","0.18586810125","2.847634766437507E7","370.1925196368736"
"8803","65174","65165","2","65167","170806","14296.010624999999","0.18584813812499998","2.849064367500007E7","370.3783677749986"
"8804","65167","65165","4","65169","170810","14296.449375","0.18585384187499998","2.850494012437507E7","370.56422161687357"
"8805","65169","65164","3","65167","170813","14296.010624999999","0.18584813812499998","2.8519236135000072E7","370.75006975499855"
"8806","65167","65164","9","65173","170822","14297.326874999999","0.18586524937499999","2.8533533461875074E7","370.93593500437356"
"8807","65173","65170","1","65171","170823","14296.888125000001","0.185859545625","2.8547830350000072E7","371.1217945499986"
"8808","65171","65166","2","65168","170825","14296.23","0.18585099","2.8562126580000073E7","371.3076455399986"
"8809","65168","65165","3","65168","170828","14296.23","0.18585099","2.8576422810000073E7","371.4934965299986"
"8810","65168","65160","1","65161","170829","14294.694375","0.18583102687499997","2.8590717504375074E7","371.6793275568736"
"8811","65161","65160","2","65162","170831","14294.91375","0.18583387875","2.8605012418125074E7","371.8651614356236"
"8812","65162","65160","9","65169","170840","14296.449375","0.18585384187499998","2.8619308867500074E7","372.05101527749855"
"8813","65169","65163","5","65168","170845","14296.23","0.18585099","2.8633605097500075E7","372.23686626749856"
"8814","65168","65161","2","65163","170847","14295.133124999998","0.18583673062499997","2.8647900230625074E7","372.42270299812355"
"8815","65163","65158","9","65167","170856","14296.010624999999","0.18584813812499998","2.8662196241250075E7","372.60855113624854"
"8816","65167","65163","3","65166","170859","14295.791250000002","0.18584528625000002","2.8676492032500077E7","372.79439642249855"
"8817","65166","65160","5","65165","170864","14295.571875","0.18584243437499998","2.8690787604375076E7","372.98023885687354"
"8818","65165","65163","8","65171","170872","14296.888125000001","0.185859545625","2.8705084492500074E7","373.16609840249856"
"8819","65171","65166","3","65169","170875","14296.449375","0.18585384187499998","2.8719380941875074E7","373.35195224437354"
"8820","65169","65161","4","65165","170879","14295.571875","0.18584243437499998","2.8733676513750073E7","373.5377946787485"
"8821","65165","65160","4","65164","170883","14295.3525","0.1858395825","2.874797186625007E7","373.72363426124855"
"8822","65164","65155","5","65160","170888","14294.475","0.18582817499999998","2.8762266341250073E7","373.90946243624853"
"8823","65160","65152","7","65159","170895","14294.255625","0.185825323125","2.877656059687507E7","374.09528775937355"
"8824","65159","65155","1","65156","170896","14293.5975","0.18581676749999998","2.879085419437507E7","374.28110452687355"
"8825","65156","65152","1","65153","170897","14292.939374999996","0.18580821187499993","2.880514713375007E7","374.46691273874853"
"8826","65153","65144","7","65151","170904","14292.500625","0.185802508125","2.881943963437507E7","374.6527152468735"
"8827","65151","65147","9","65156","170913","14293.5975","0.18581676749999998","2.883373323187507E7","374.8385320143735"
"8828","65156","65152","9","65161","170922","14294.694375","0.18583102687499997","2.884802792625007E7","375.02436304124853"
"8829","65161","65153","6","65159","170928","14294.255625","0.185825323125","2.886232218187507E7","375.21018836437355"
"8830","65159","65154","3","65157","170931","14293.816874999999","0.18581961937499997","2.887661599875007E7","375.3960079837486"
"8831","65157","65153","9","65162","170940","14294.91375","0.18583387875","2.889091091250007E7","375.58184186249855"
"8832","65162","65156","9","65165","170949","14295.571875","0.18584243437499998","2.8905206484375067E7","375.76768429687354"
"8833","65165","65156","2","65158","170951","14294.03625","0.18582247124999998","2.8919500520625066E7","375.95350676812353"
"8834","65158","65149","6","65155","170957","14293.378125","0.185813915625","2.8933793898750067E7","376.1393206837485"
"8835","65155","65150","6","65156","170963","14293.5975","0.18581676749999998","2.8948087496250067E7","376.3251374512485"
"8836","65156","65150","1","65151","170964","14292.500625","0.185802508125","2.8962379996875066E7","376.5109399593735"
"8837","65151","65149","8","65157","170972","14293.816874999999","0.18581961937499997","2.8976673813750066E7","376.6967595787485"
"8838","65157","65148","2","65150","170974","14292.28125","0.18579965625","2.8990966095000066E7","376.88255923499855"
"8839","65150","65145","8","65153","170982","14292.939374999996","0.18580821187499993","2.9005259034375064E7","377.06836744687354"
"8840","65153","65145","3","65148","170985","14291.842499999999","0.18579395249999997","2.9019550876875065E7","377.2541613993735"
"8841","65148","65141","6","65147","170991","14291.623125","0.18579110062499998","2.9033842500000067E7","377.4399524999985"
"8842","65147","65141","5","65146","170996","14291.403750000001","0.18578824875","2.9048133903750066E7","377.6257407487485"
"8843","65146","65138","1","65139","170997","14289.868125","0.185768285625","2.9062423771875065E7","377.8115090343735"
"8844","65139","65134","3","65137","171000","14289.429375","0.18576258187499997","2.9076713201250065E7","377.9972716162485"
"8845","65137","65136","8","65144","171008","14290.965","0.185782545","2.9091004166250065E7","378.1830541612485"
"8846","65144","65139","7","65146","171015","14291.403750000001","0.18578824875","2.9105295570000064E7","378.3688424099985"
"8847","65146","65140","6","65146","171021","14291.403750000001","0.18578824875","2.9119586973750062E7","378.55463065874847"
"8848","65146","65141","8","65149","171029","14292.061875000001","0.185796804375","2.9133879035625063E7","378.74042746312347"
"8849","65149","65148","8","65156","171037","14293.5975","0.18581676749999998","2.9148172633125063E7","378.92624423062347"
"8850","65156","65152","5","65157","171042","14293.816874999999","0.18581961937499997","2.9162466450000063E7","379.1120638499985"
"8851","65157","65155","2","65157","171044","14293.816874999999","0.18581961937499997","2.9176760266875062E7","379.2978834693735"
"8852","65157","65149","6","65155","171050","14293.378125","0.185813915625","2.9191053645000063E7","379.4836973849985"
"8853","65155","65152","3","65155","171053","14293.378125","0.185813915625","2.9205347023125064E7","379.66951130062347"
"8854","65155","65147","5","65152","171058","14292.72","0.18580535999999997","2.9219639743125062E7","379.8553166606235"
"8855","65152","65143","9","65152","171067","14292.72","0.18580535999999997","2.923393246312506E7","380.0411220206235"
"8856","65152","65149","3","65152","171070","14292.72","0.18580535999999997","2.924822518312506E7","380.2269273806235"
"8857","65152","65148","3","65151","171073","14292.500625","0.185802508125","2.926251768375006E7","380.4127298887485"
"8858","65151","65142","1","65143","171074","14290.745625","0.18577969312499998","2.927680842937506E7","380.59850958187354"
"8859","65143","65134","1","65135","171075","14288.990625","0.185756878125","2.929109742000006E7","380.78426645999855"
"8860","65135","65133","1","65134","171076","14288.77125","0.18575402624999998","2.930538619125006E7","380.97002048624853"
"8861","65134","65125","2","65127","171078","14287.235625","0.185734063125","2.931967342687506E7","381.1557545493735"
"8862","65127","65125","8","65133","171086","14288.551875","0.18575117437499997","2.9333961978750058E7","381.3415057237485"
"8863","65133","65130","7","65137","171093","14289.429375","0.18576258187499997","2.9348251408125058E7","381.5272683056235"
"8864","65137","65135","9","65144","171102","14290.965","0.185782545","2.9362542373125058E7","381.7130508506235"
"8865","65144","65139","8","65147","171110","14291.623125","0.18579110062499998","2.937683399625006E7","381.8988419512485"
"8866","65147","65144","6","65150","171116","14292.28125","0.18579965625","2.939112627750006E7","382.08464160749855"
"8867","65150","65148","4","65152","171120","14292.72","0.18580535999999997","2.940541899750006E7","382.2704469674986"
"8868","65152","65147","8","65155","171128","14293.378125","0.185813915625","2.941971237562506E7","382.45626088312355"
"8869","65155","65146","9","65155","171137","14293.378125","0.185813915625","2.943400575375006E7","382.6420747987485"
"8870","65155","65146","5","65151","171142","14292.500625","0.185802508125","2.944829825437506E7","382.8278773068735"
"8871","65151","65142","9","65151","171151","14292.500625","0.185802508125","2.946259075500006E7","383.0136798149985"
"8872","65151","65150","8","65158","171159","14294.03625","0.18582247124999998","2.9476884791250058E7","383.1995022862485"
"8873","65158","65151","7","65158","171166","14294.03625","0.18582247124999998","2.9491178827500056E7","383.3853247574985"
"8874","65158","65156","2","65158","171168","14294.03625","0.18582247124999998","2.9505472863750055E7","383.5711472287485"
"8875","65158","65151","1","65152","171169","14292.72","0.18580535999999997","2.9519765583750054E7","383.7569525887485"
"8876","65152","65151","7","65158","171176","14294.03625","0.18582247124999998","2.9534059620000053E7","383.9427750599985"
"8877","65158","65150","5","65155","171181","14293.378125","0.185813915625","2.9548352998125054E7","384.1285889756235"
"8878","65155","65153","5","65158","171186","14294.03625","0.18582247124999998","2.9562647034375053E7","384.31441144687346"
"8879","65158","65149","4","65153","171190","14292.939374999996","0.18580821187499993","2.957693997375005E7","384.50021965874845"
"8880","65153","65148","8","65156","171198","14293.5975","0.18581676749999998","2.959123357125005E7","384.68603642624845"
"8881","65156","65153","1","65154","171199","14293.15875","0.18581106375","2.9605526730000053E7","384.87184748999846"
"8882","65154","65153","7","65160","171206","14294.475","0.18582817499999998","2.9619821205000054E7","385.05767566499844"
"8883","65160","65153","9","65162","171215","14294.91375","0.18583387875","2.9634116118750054E7","385.2435095437484"
"8884","65162","65160","9","65169","171224","14296.449375","0.18585384187499998","2.9648412568125054E7","385.4293633856234"
"8885","65169","65165","8","65173","171232","14297.326874999999","0.18586524937499999","2.9662709895000055E7","385.6152286349984"
"8886","65173","65172","2","65174","171234","14297.546250000001","0.18586810125","2.9677007441250056E7","385.8010967362484"
"8887","65174","65168","5","65173","171239","14297.326874999999","0.18586524937499999","2.9691304768125057E7","385.9869619856234"
"8888","65173","65169","8","65177","171247","14298.204375","0.185876656875","2.9705602972500056E7","386.1728386424984"
"8889","65177","65170","7","65177","171254","14298.204375","0.185876656875","2.9719901176875055E7","386.3587152993734"
"8890","65177","65174","5","65179","171259","14298.643125","0.185882360625","2.9734199820000056E7","386.5445976599984"
"8891","65179","65175","9","65184","171268","14299.74","0.18589661999999998","2.9748499560000055E7","386.73049427999837"
"8892","65184","65182","7","65189","171275","14300.836875","0.185910879375","2.9762800396875054E7","386.91640515937337"
"8893","65189","65184","2","65186","171277","14300.17875","0.18590232375","2.9777100575625055E7","387.10230748312335"
"8894","65186","65181","9","65190","171286","14301.05625","0.18591373125","2.9791401631875053E7","387.2882212143734"
"8895","65190","65181","2","65183","171288","14299.520625","0.18589376812499997","2.9805701152500052E7","387.4741149824984"
"8896","65183","65177","1","65178","171289","14298.423749999996","0.18587950874999995","2.981999957625005E7","387.6599944912484"
"8897","65178","65172","1","65173","171290","14297.326874999999","0.18586524937499999","2.983429690312505E7","387.84585974062344"
"8898","65173","65166","6","65172","171296","14297.1075","0.1858623975","2.9848594010625053E7","388.0317221381234"
"8899","65172","65168","6","65174","171302","14297.546250000001","0.18586810125","2.9862891556875054E7","388.2175902393734"
"8900","65174","65166","8","65174","171310","14297.546250000001","0.18586810125","2.9877189103125054E7","388.4034583406234"
"8901","65174","65168","9","65177","171319","14298.204375","0.185876656875","2.9891487307500053E7","388.5893349974984"
"8902","65177","65168","8","65176","171327","14297.985","0.185873805","2.9905785292500053E7","388.7752088024984"
"8903","65176","65167","1","65168","171328","14296.23","0.18585099","2.9920081522500053E7","388.9610597924984"
"8904","65168","65164","8","65172","171336","14297.1075","0.1858623975","2.9934378630000055E7","389.1469221899984"
"8905","65172","65165","1","65166","171337","14295.791250000002","0.18584528625000002","2.9948674421250056E7","389.3327674762484"
"8906","65166","65159","2","65161","171339","14294.694375","0.18583102687499997","2.9962969115625057E7","389.5185985031234"
"8907","65161","65158","4","65162","171343","14294.91375","0.18583387875","2.9977264029375058E7","389.7044323818734"
"8908","65162","65161","2","65163","171345","14295.133124999998","0.18583673062499997","2.9991559162500057E7","389.8902691124984"
"8909","65163","65158","9","65167","171354","14296.010624999999","0.18584813812499998","3.000585517312506E7","390.0761172506234"
"8910","65167","65166","8","65174","171362","14297.546250000001","0.18586810125","3.002015271937506E7","390.26198535187336"
"8911","65174","65167","4","65171","171366","14296.888125000001","0.185859545625","3.0034449607500058E7","390.4478448974984"
"8912","65171","65168","6","65174","171372","14297.546250000001","0.18586810125","3.004874715375006E7","390.63371299874836"
"8913","65174","65165","3","65168","171375","14296.23","0.18585099","3.006304338375006E7","390.81956398874837"
"8914","65168","65163","6","65169","171381","14296.449375","0.18585384187499998","3.007733983312506E7","391.00541783062334"
"8915","65169","65161","2","65163","171383","14295.133124999998","0.18583673062499997","3.009163496625006E7","391.19125456124834"
"8916","65163","65159","5","65164","171388","14295.3525","0.1858395825","3.0105930318750057E7","391.37709414374837"
"8917","65164","65161","1","65162","171389","14294.91375","0.18583387875","3.0120225232500058E7","391.56292802249834"
"8918","65162","65157","2","65159","171391","14294.255625","0.185825323125","3.0134519488125056E7","391.74875334562336"
"8919","65159","65151","5","65156","171396","14293.5975","0.18581676749999998","3.0148813085625056E7","391.93457011312336"
"8920","65156","65149","4","65153","171400","14292.939374999996","0.18580821187499993","3.0163106025000054E7","392.12037832499834"
"8921","65153","65151","5","65156","171405","14293.5975","0.18581676749999998","3.0177399622500055E7","392.30619509249834"
"8922","65156","65153","2","65155","171407","14293.378125","0.185813915625","3.0191693000625055E7","392.4920090081233"
"8923","65155","65147","6","65153","171413","14292.939374999996","0.18580821187499993","3.0205985940000053E7","392.6778172199983"
"8924","65153","65146","4","65150","171417","14292.28125","0.18579965625","3.0220278221250053E7","392.86361687624833"
"8925","65150","65147","6","65153","171423","14292.939374999996","0.18580821187499993","3.023457116062505E7","393.0494250881233"
"8926","65153","65148","1","65149","171424","14292.061875000001","0.185796804375","3.0248863222500052E7","393.2352218924983"
"8927","65149","65143","1","65144","171425","14290.965","0.185782545","3.0263154187500052E7","393.4210044374983"
"8928","65144","65142","2","65144","171427","14290.965","0.185782545","3.0277445152500052E7","393.6067869824983"
"8929","65144","65137","6","65143","171433","14290.745625","0.18577969312499998","3.0291735898125052E7","393.79256667562333"
"8930","65143","65137","9","65146","171442","14291.403750000001","0.18578824875","3.030602730187505E7","393.9783549243733"
"8931","65146","65140","8","65148","171450","14291.842499999999","0.18579395249999997","3.0320319144375052E7","394.1641488768733"
"8932","65148","65140","2","65142","171452","14290.526249999999","0.18577684124999996","3.0334609670625053E7","394.3499257181233"
"8933","65142","65137","2","65139","171454","14289.868125","0.185768285625","3.0348899538750052E7","394.5356940037483"
"8934","65139","65136","8","65144","171462","14290.965","0.185782545","3.0363190503750052E7","394.7214765487483"
"8935","65144","65143","7","65150","171469","14292.28125","0.18579965625","3.0377482785000052E7","394.9072762049983"
"8936","65150","65144","4","65148","171473","14291.842499999999","0.18579395249999997","3.0391774627500053E7","395.0930701574983"
"8937","65148","65143","9","65152","171482","14292.72","0.18580535999999997","3.0406067347500052E7","395.2788755174983"
"8938","65152","65150","1","65151","171483","14292.500625","0.185802508125","3.042035984812505E7","395.4646780256233"
"8939","65151","65150","7","65157","171490","14293.816874999999","0.18581961937499997","3.043465366500005E7","395.6504976449983"
"8940","65157","65153","2","65155","171492","14293.378125","0.185813915625","3.0448947043125052E7","395.8363115606233"
"8941","65155","65146","4","65150","171496","14292.28125","0.18579965625","3.0463239324375052E7","396.0221112168733"
"8942","65150","65146","2","65148","171498","14291.842499999999","0.18579395249999997","3.0477531166875053E7","396.2079051693733"
"8943","65148","65146","4","65150","171502","14292.28125","0.18579965625","3.0491823448125053E7","396.39370482562333"
"8944","65150","65142","9","65151","171511","14292.500625","0.185802508125","3.0506115948750053E7","396.5795073337483"
"8945","65151","65144","4","65148","171515","14291.842499999999","0.18579395249999997","3.0520407791250054E7","396.7653012862483"
"8946","65148","65147","5","65152","171520","14292.72","0.18580535999999997","3.0534700511250053E7","396.9511066462483"
"8947","65152","65150","6","65156","171526","14293.5975","0.18581676749999998","3.0548994108750053E7","397.1369234137483"
"8948","65156","65155","2","65157","171528","14293.816874999999","0.18581961937499997","3.0563287925625052E7","397.32274303312334"
"8949","65157","65155","8","65163","171536","14295.133124999998","0.18583673062499997","3.0577583058750052E7","397.50857976374834"
"8950","65163","65160","8","65168","171544","14296.23","0.18585099","3.0591879288750052E7","397.69443075374835"
"8951","65168","65161","4","65165","171548","14295.571875","0.18584243437499998","3.060617486062505E7","397.88027318812334"
"8952","65165","65157","4","65161","171552","14294.694375","0.18583102687499997","3.062046955500005E7","398.06610421499835"
"8953","65161","65155","7","65162","171559","14294.91375","0.18583387875","3.0634764468750052E7","398.2519380937483"
"8954","65162","65157","3","65160","171562","14294.475","0.18582817499999998","3.0649058943750054E7","398.4377662687483"
"8955","65160","65151","8","65159","171570","14294.255625","0.185825323125","3.0663353199375052E7","398.6235915918733"
"8956","65159","65153","3","65156","171573","14293.5975","0.18581676749999998","3.0677646796875052E7","398.8094083593733"
"8957","65156","65147","5","65152","171578","14292.72","0.18580535999999997","3.069193951687505E7","398.99521371937334"
"8958","65152","65151","2","65153","171580","14292.939374999996","0.18580821187499993","3.070623245625005E7","399.1810219312483"
"8959","65153","65148","6","65154","171586","14293.15875","0.18581106375","3.072052561500005E7","399.36683299499833"
"8960","65154","65145","3","65148","171589","14291.842499999999","0.18579395249999997","3.073481745750005E7","399.5526269474983"
"8961","65148","65144","1","65145","171590","14291.184375","0.185785396875","3.074910864187505E7","399.73841234437333"
"8962","65145","65139","3","65142","171593","14290.526249999999","0.18577684124999996","3.0763399168125052E7","399.92418918562333"
"8963","65142","65138","1","65139","171594","14289.868125","0.185768285625","3.077768903625005E7","400.1099574712483"
"8964","65139","65131","1","65132","171595","14288.332499999999","0.18574832249999998","3.079197736875005E7","400.2957057937483"
"8965","65132","65128","1","65129","171596","14287.674375","0.185739766875","3.0806265043125052E7","400.4814455606233"
"8966","65129","65123","1","65124","171597","14286.577500000001","0.1857255075","3.0820551620625053E7","400.6671710681233"
"8967","65124","65116","2","65118","171599","14285.26125","0.18570839625","3.0834836881875053E7","400.8528794643733"
"8968","65118","65109","1","65110","171600","14283.50625","0.18568558124999998","3.0849120388125055E7","401.03856504562333"
"8969","65110","65104","5","65109","171605","14283.286875","0.185682729375","3.0863403675000053E7","401.22424777499833"
"8970","65109","65101","9","65110","171614","14283.50625","0.18568558124999998","3.0877687181250054E7","401.40993335624836"
"8971","65110","65106","3","65109","171617","14283.286875","0.185682729375","3.0891970468125053E7","401.59561608562336"
"8972","65109","65107","5","65112","171622","14283.945","0.18569128499999998","3.0906254413125053E7","401.7813073706234"
"8973","65112","65105","8","65113","171630","14284.164374999998","0.18569413687499997","3.0920538577500053E7","401.96700150749837"
"8974","65113","65105","4","65109","171634","14283.286875","0.185682729375","3.093482186437505E7","402.15268423687337"
"8975","65109","65108","6","65114","171640","14284.38375","0.18569698874999999","3.094910624812505E7","402.3383812256234"
"8976","65114","65108","9","65117","171649","14285.041874999999","0.18570554437499998","3.096339129000005E7","402.5240867699984"
"8977","65117","65112","9","65121","171658","14285.919375000001","0.185716951875","3.097767720937505E7","402.7098037218734"
"8978","65121","65112","3","65115","171661","14284.603125","0.18569984062499997","3.099196181250005E7","402.8955035624984"
"8979","65115","65113","3","65116","171664","14284.822500000002","0.18570269250000002","3.100624663500005E7","403.0812062549984"
"8980","65116","65113","3","65116","171667","14284.822500000002","0.18570269250000002","3.102053145750005E7","403.2669089474984"
"8981","65116","65111","2","65113","171669","14284.164374999998","0.18569413687499997","3.103481562187505E7","403.4526030843734"
"8982","65113","65105","3","65108","171672","14283.0675","0.18567987749999998","3.104909868937505E7","403.63828296187336"
"8983","65108","65105","1","65106","171673","14282.62875","0.18567417374999998","3.106338131812505E7","403.82395713562335"
"8984","65106","65100","6","65106","171679","14282.62875","0.18567417374999998","3.107766394687505E7","404.00963130937333"
"8985","65106","65104","7","65111","171686","14283.725625","0.18568843312499997","3.109194767250005E7","404.1953197424983"
"8986","65111","65107","6","65113","171692","14284.164374999998","0.18569413687499997","3.110623183687505E7","404.3810138793733"
"8987","65113","65110","1","65111","171693","14283.725625","0.18568843312499997","3.1120515562500052E7","404.5667023124983"
"8988","65111","65106","4","65110","171697","14283.50625","0.18568558124999998","3.1134799068750054E7","404.75238789374833"
"8989","65110","65107","6","65113","171703","14284.164374999998","0.18569413687499997","3.1149083233125053E7","404.9380820306233"
"8990","65113","65110","2","65112","171705","14283.945","0.18569128499999998","3.1163367178125054E7","405.12377331562334"
"8991","65112","65109","4","65113","171709","14284.164374999998","0.18569413687499997","3.1177651342500053E7","405.3094674524983"
"8992","65113","65107","6","65113","171715","14284.164374999998","0.18569413687499997","3.1191935506875053E7","405.4951615893733"
"8993","65113","65110","2","65112","171717","14283.945","0.18569128499999998","3.1206219451875053E7","405.68085287437333"
"8994","65112","65107","4","65111","171721","14283.725625","0.18568843312499997","3.1220503177500054E7","405.8665413074983"
"8995","65111","65107","1","65108","171722","14283.0675","0.18567987749999998","3.1234786245000053E7","406.0522211849983"
"8996","65108","65099","5","65104","171727","14282.19","0.18566847","3.1249068435000055E7","406.2378896549983"
"8997","65104","65098","2","65100","171729","14281.3125","0.1856570625","3.1263349747500055E7","406.4235467174983"
"8998","65100","65093","4","65097","171733","14280.654375","0.18564850687499998","3.1277630401875056E7","406.6091952243733"
"8999","65097","65092","3","65095","171736","14280.215625","0.185642803125","3.1291910617500056E7","406.7948380274983"
"9000","65095","65089","5","65094","171741","14279.99625","0.18563995125","3.1306190613750055E7","406.9804779787483"
"9001","65094","65093","4","65097","171745","14280.654375","0.18564850687499998","3.1320471268125057E7","407.1661264856233"
"9002","65097","65096","8","65104","171753","14282.19","0.18566847","3.133475345812506E7","407.3517949556233"
"9003","65104","65102","4","65106","171757","14282.62875","0.18567417374999998","3.134903608687506E7","407.5374691293733"
"9004","65106","65104","1","65105","171758","14282.409375","0.185671321875","3.136331849625006E7","407.7231404512483"
"9005","65105","65100","2","65102","171760","14281.75125","0.18566276624999997","3.137760024750006E7","407.9088032174983"
"9006","65102","65094","1","65095","171761","14280.215625","0.185642803125","3.1391880463125058E7","408.0944460206233"
"9007","65095","65092","2","65094","171763","14279.99625","0.18563995125","3.1406160459375057E7","408.2800859718733"
"9008","65094","65085","5","65090","171768","14279.11875","0.18562854374999999","3.1420439578125056E7","408.4657145156233"
"9009","65090","65087","1","65088","171769","14278.679999999998","0.18562283999999996","3.1434718258125056E7","408.6513373556233"
"9010","65088","65087","6","65093","171775","14279.776875","0.18563709937499998","3.1448998035000056E7","408.8369744549983"
"9011","65093","65085","6","65091","171781","14279.338125000002","0.18563139562500003","3.1463277373125058E7","409.02260585062334"
"9012","65091","65090","2","65092","171783","14279.557499999999","0.1856342475","3.147755693062506E7","409.2082400981233"
"9013","65092","65088","6","65094","171789","14279.99625","0.18563995125","3.149183692687506E7","409.3938800493733"
"9014","65094","65093","7","65100","171796","14281.3125","0.1856570625","3.150611823937506E7","409.5795371118733"
"9015","65100","65093","6","65099","171802","14281.093125000001","0.185654210625","3.152039933250006E7","409.7651913224983"
"9016","65099","65097","2","65099","171804","14281.093125000001","0.185654210625","3.153468042562506E7","409.9508455331233"
"9017","65099","65098","1","65099","171805","14281.093125000001","0.185654210625","3.154896151875006E7","410.1364997437483"
"9018","65099","65095","5","65100","171810","14281.3125","0.1856570625","3.156324283125006E7","410.3221568062483"
"9019","65100","65099","8","65107","171818","14282.848124999999","0.18567702562499996","3.157752567937506E7","410.5078338318733"
"9020","65107","65099","1","65100","171819","14281.3125","0.1856570625","3.159180699187506E7","410.6934908943733"
"9021","65100","65093","2","65095","171821","14280.215625","0.185642803125","3.160608720750006E7","410.87913369749833"
"9022","65095","65094","2","65096","171823","14280.435000000001","0.185645655","3.1620367642500058E7","411.0647793524983"
"9023","65096","65087","6","65093","171829","14279.776875","0.18563709937499998","3.163464741937506E7","411.2504164518733"
"9024","65093","65084","1","65085","171830","14278.021875","0.185614284375","3.164892544125006E7","411.4360307362483"
"9025","65085","65083","8","65091","171838","14279.338125000002","0.18563139562500003","3.166320477937506E7","411.62166213187334"
"9026","65091","65083","1","65084","171839","14277.8025","0.18561143249999998","3.167748258187506E7","411.80727356437336"
"9027","65084","65075","2","65077","171841","14276.266875","0.18559146937499998","3.169175884875006E7","411.9928650337484"
"9028","65077","65069","1","65070","171842","14274.73125","0.18557150625","3.1706033580000058E7","412.1784365399984"
"9029","65070","65069","6","65075","171848","14275.828125","0.18558576562499998","3.1720309408125058E7","412.3640223056234"
"9030","65075","65071","4","65075","171852","14275.828125","0.18558576562499998","3.1734585236250058E7","412.5496080712484"
"9031","65075","65066","2","65068","171854","14274.2925","0.1855658025","3.174885952875006E7","412.73517387374835"
"9032","65068","65066","7","65073","171861","14275.389374999999","0.18558006187499998","3.176313491812506E7","412.92075393562334"
"9033","65073","65065","7","65072","171868","14275.17","0.18557721","3.177741008812506E7","413.10633114562336"
"9034","65072","65063","1","65064","171869","14273.415","0.185554395","3.179168350312506E7","413.29188554062335"
"9035","65064","65061","5","65066","171874","14273.853750000002","0.18556009875","3.1805957356875062E7","413.47744563937334"
"9036","65066","65060","4","65064","171878","14273.415","0.185554395","3.182023077187506E7","413.66300003437334"
"9037","65064","65063","2","65065","171880","14273.634375","0.18555724687499997","3.183450440625006E7","413.84855728124836"
"9038","65065","65057","8","65065","171888","14273.634375","0.18555724687499997","3.1848778040625058E7","414.0341145281234"
"9039","65065","65064","2","65066","171890","14273.853750000002","0.18556009875","3.186305189437506E7","414.21967462687337"
"9040","65066","65062","5","65067","171895","14274.073124999999","0.18556295062499997","3.187732596750006E7","414.4052375774984"
"9041","65067","65064","8","65072","171903","14275.17","0.18557721","3.1891601137500063E7","414.5908147874984"
"9042","65072","65066","3","65069","171906","14274.511875","0.185568654375","3.1905875649375062E7","414.7763834418734"
"9043","65069","65061","8","65069","171914","14274.511875","0.185568654375","3.1920150161250062E7","414.9619520962484"
"9044","65069","65065","5","65070","171919","14274.73125","0.18557150625","3.193442489250006E7","415.14752360249844"
"9045","65070","65065","3","65068","171922","14274.2925","0.1855658025","3.1948699185000062E7","415.3330894049984"
"9046","65068","65066","1","65067","171923","14274.073124999999","0.18556295062499997","3.1962973258125063E7","415.51865235562343"
"9047","65067","65063","2","65065","171925","14273.634375","0.18555724687499997","3.197724689250006E7","415.70420960249845"
"9048","65065","65059","8","65067","171933","14274.073124999999","0.18556295062499997","3.1991520965625063E7","415.88977255312346"
"9049","65067","65060","4","65064","171937","14273.415","0.185554395","3.200579438062506E7","416.07532694812346"
"9050","65064","65062","6","65068","171943","14274.2925","0.1855658025","3.2020068673125062E7","416.26089275062344"
"9051","65068","65062","3","65065","171946","14273.634375","0.18555724687499997","3.203434230750006E7","416.44644999749846"
"9052","65065","65058","8","65066","171954","14273.853750000002","0.18556009875","3.2048616161250062E7","416.63201009624845"
"9053","65066","65062","7","65069","171961","14274.511875","0.185568654375","3.2062890673125062E7","416.81757875062345"
"9054","65069","65066","4","65070","171965","14274.73125","0.18557150625","3.207716540437506E7","417.0031502568735"
"9055","65070","65062","3","65065","171968","14273.634375","0.18555724687499997","3.209143903875006E7","417.1887075037485"
"9056","65065","65064","6","65070","171974","14274.73125","0.18557150625","3.210571377000006E7","417.37427900999853"
"9057","65070","65068","5","65073","171979","14275.389374999999","0.18558006187499998","3.211998915937506E7","417.5598590718735"
"9058","65073","65064","8","65072","171987","14275.17","0.18557721","3.2134264329375062E7","417.74543628187354"
"9059","65072","65070","8","65078","171995","14276.486249999996","0.18559432124999994","3.214854081562506E7","417.93103060312353"
"9060","65078","65071","8","65079","172003","14276.705625","0.185597173125","3.216281752125006E7","418.11662777624855"
"9061","65079","65078","6","65084","172009","14277.8025","0.18561143249999998","3.217709532375006E7","418.3022392087486"
"9062","65084","65078","2","65080","172011","14276.925","0.18560002499999997","3.219137224875006E7","418.48783923374856"
"9063","65080","65074","1","65075","172012","14275.828125","0.18558576562499998","3.220564807687506E7","418.67342499937354"
"9064","65075","65066","5","65071","172017","14274.950625000001","0.185574358125","3.221992302750006E7","418.85899935749853"
"9065","65071","65067","8","65075","172025","14275.828125","0.18558576562499998","3.223419885562506E7","419.0445851231235"
"9066","65075","65070","9","65079","172034","14276.705625","0.185597173125","3.224847556125006E7","419.23018229624853"
"9067","65079","65074","6","65080","172040","14276.925","0.18560002499999997","3.226275248625006E7","419.4157823212485"
"9068","65080","65079","7","65086","172047","14278.24125","0.18561713624999998","3.2277030727500062E7","419.60139945749853"
"9069","65086","65083","7","65090","172054","14279.11875","0.18562854374999999","3.229130984625006E7","419.78702800124853"
"9070","65090","65084","6","65090","172060","14279.11875","0.18562854374999999","3.230558896500006E7","419.97265654499853"
"9071","65090","65081","4","65085","172064","14278.021875","0.185614284375","3.231986698687506E7","420.1582708293735"
"9072","65085","65084","2","65086","172066","14278.24125","0.18561713624999998","3.233414522812506E7","420.34388796562354"
"9073","65086","65079","5","65084","172071","14277.8025","0.18561143249999998","3.234842303062506E7","420.52949939812356"
"9074","65084","65079","5","65084","172076","14277.8025","0.18561143249999998","3.236270083312506E7","420.7151108306236"
"9075","65084","65083","4","65087","172080","14278.460625","0.185619988125","3.237697929375006E7","420.90073081874857"
"9076","65087","65078","5","65083","172085","14277.583125","0.185608580625","3.2391256876875058E7","421.08633939937357"
"9077","65083","65074","6","65080","172091","14276.925","0.18560002499999997","3.240553380187506E7","421.27193942437356"
"9078","65080","65074","6","65080","172097","14276.925","0.18560002499999997","3.241981072687506E7","421.45753944937354"
"9079","65080","65074","3","65077","172100","14276.266875","0.18559146937499998","3.2434086993750058E7","421.64313091874857"
"9080","65077","65070","6","65076","172106","14276.0475","0.1855886175","3.2448363041250058E7","421.82871953624857"
"9081","65076","65069","2","65071","172108","14274.950625000001","0.185574358125","3.2462637991875056E7","422.01429389437357"
"9082","65071","65068","7","65075","172115","14275.828125","0.18558576562499998","3.2476913820000056E7","422.19987965999854"
"9083","65075","65067","8","65075","172123","14275.828125","0.18558576562499998","3.2491189648125056E7","422.3854654256235"
"9084","65075","65073","3","65076","172126","14276.0475","0.1855886175","3.2505465695625056E7","422.5710540431235"
"9085","65076","65068","8","65076","172134","14276.0475","0.1855886175","3.2519741743125055E7","422.7566426606235"
"9086","65076","65067","3","65070","172137","14274.73125","0.18557150625","3.2534016474375054E7","422.94221416687355"
"9087","65070","65064","1","65065","172138","14273.634375","0.18555724687499997","3.2548290108750053E7","423.1277714137486"
"9088","65065","65061","1","65062","172139","14272.97625","0.18554869124999998","3.2562563085000053E7","423.3133201049986"
"9089","65062","65057","5","65062","172144","14272.97625","0.18554869124999998","3.2576836061250053E7","423.4988687962486"
"9090","65062","65054","7","65061","172151","14272.756875","0.18554583937499997","3.2591108818125054E7","423.68441463562357"
"9091","65061","65056","2","65058","172153","14272.09875","0.18553728374999998","3.2605380916875053E7","423.8699519193736"
"9092","65058","65051","1","65052","172154","14270.7825","0.18552017249999997","3.2619651699375052E7","424.0554720918736"
"9093","65052","65045","2","65047","172156","14269.685625","0.18550591312499998","3.2633921385000054E7","424.24097800499857"
"9094","65047","65043","3","65046","172159","14269.466250000001","0.18550306125000002","3.2648190851250052E7","424.4264810662486"
"9095","65046","65040","2","65042","172161","14268.588749999999","0.18549165374999999","3.2662459440000053E7","424.61197271999856"
"9096","65042","65038","2","65040","172163","14268.15","0.18548594999999998","3.2676727590000052E7","424.79745866999855"
"9097","65040","65031","6","65037","172169","14267.491875","0.185477394375","3.2690995081875052E7","424.9829360643736"
"9098","65037","65032","2","65034","172171","14266.83375","0.18546883874999998","3.270526191562505E7","425.1684049031236"
"9099","65034","65030","6","65036","172177","14267.2725","0.18547454249999998","3.271952918812505E7","425.3538794456236"
"9100","65036","65027","5","65032","172182","14266.394999999999","0.18546313499999997","3.273379558312505E7","425.5393425806236"
"9101","65032","65023","1","65024","172183","14264.640000000001","0.18544032","3.274806022312505E7","425.7247829006236"
"9102","65024","65022","8","65030","172191","14265.95625","0.18545743124999997","3.2762326179375052E7","425.9102403318736"
"9103","65030","65028","9","65037","172200","14267.491875","0.185477394375","3.2776593671250053E7","426.0957177262486"
"9104","65037","65035","3","65038","172203","14267.711249999998","0.18548024624999998","3.2790861382500052E7","426.2811979724986"
"9105","65038","65034","8","65042","172211","14268.588749999999","0.18549165374999999","3.2805129971250053E7","426.4666896262486"
"9106","65042","65035","2","65037","172213","14267.491875","0.185477394375","3.2819397463125054E7","426.6521670206236"
"9107","65037","65030","8","65038","172221","14267.711249999998","0.18548024624999998","3.2833665174375053E7","426.8376472668736"
"9108","65038","65030","8","65038","172229","14267.711249999998","0.18548024624999998","3.2847932885625053E7","427.0231275131236"
"9109","65038","65031","9","65040","172238","14268.15","0.18548594999999998","3.286220103562505E7","427.2086134631236"
"9110","65040","65034","3","65037","172241","14267.491875","0.185477394375","3.2876468527500052E7","427.3940908574986"
"9111","65037","65029","5","65034","172246","14266.83375","0.18546883874999998","3.289073536125005E7","427.5795596962486"
"9112","65034","65028","4","65032","172250","14266.394999999999","0.18546313499999997","3.290500175625005E7","427.76502283124864"
"9113","65032","65023","3","65026","172253","14265.07875","0.18544602375","3.291926683500005E7","427.95046885499863"
"9114","65026","65019","6","65025","172259","14264.859375","0.18544317187499998","3.293353169437505E7","428.13591202687365"
"9115","65025","65017","1","65018","172260","14263.32375","0.18542320874999998","3.294779501812505E7","428.3213352356237"
"9116","65018","65011","6","65017","172266","14263.104374999999","0.18542035687499997","3.296205812250005E7","428.5067555924987"
"9117","65017","65014","1","65015","172267","14262.665625","0.185414653125","3.297632078812505E7","428.6921702456237"
"9118","65015","65013","5","65018","172272","14263.32375","0.18542320874999998","3.299058411187505E7","428.8775934543737"
"9119","65018","65013","4","65017","172276","14263.104374999999","0.18542035687499997","3.300484721625005E7","429.0630138112487"
"9120","65017","65008","3","65011","172279","14261.788125","0.185403245625","3.301910900437505E7","429.24841705687373"
"9121","65011","65005","4","65009","172283","14261.349375","0.185397541875","3.303337035375005E7","429.4338145987487"
"9122","65009","65005","2","65007","172285","14260.910624999999","0.18539183812499996","3.304763126437505E7","429.6192064368737"
"9123","65007","65002","5","65007","172290","14260.910624999999","0.18539183812499996","3.306189217500005E7","429.8045982749987"
"9124","65007","65002","8","65010","172298","14261.56875","0.18540039375","3.307615374375005E7","429.9899986687487"
"9125","65010","65004","2","65006","172300","14260.69125","0.18538898625","3.309041443500005E7","430.1753876549987"
"9126","65006","65003","4","65007","172304","14260.910624999999","0.18539183812499996","3.310467534562505E7","430.3607794931237"
"9127","65007","65001","3","65004","172307","14260.2525","0.1853832825","3.311893559812505E7","430.5461627756237"
"9128","65004","65002","6","65008","172313","14261.13","0.18539468999999997","3.313319672812505E7","430.7315574656237"
"9129","65008","65003","2","65005","172315","14260.471875","0.18538613437499998","3.314745720000005E7","430.9169435999987"
"9130","65005","64999","8","65007","172323","14260.910624999999","0.18539183812499996","3.316171811062505E7","431.1023354381237"
"9131","65007","65001","1","65002","172324","14259.81375","0.18537757875","3.317597792437505E7","431.2877130168737"
"9132","65002","65001","5","65006","172329","14260.69125","0.18538898625","3.319023861562505E7","431.4731020031237"
"9133","65006","65002","6","65008","172335","14261.13","0.18539468999999997","3.320449974562505E7","431.6584966931237"
"9134","65008","65007","8","65015","172343","14262.665625","0.185414653125","3.3218762411250047E7","431.8439113462487"
"9135","65015","65014","4","65018","172347","14263.32375","0.18542320874999998","3.3233025735000048E7","432.02933455499874"
"9136","65018","65009","6","65015","172353","14262.665625","0.185414653125","3.3247288400625046E7","432.21474920812375"
"9137","65015","65014","4","65018","172357","14263.32375","0.18542320874999998","3.3261551724375047E7","432.4001724168738"
"9138","65018","65016","1","65017","172358","14263.104374999999","0.18542035687499997","3.3275814828750048E7","432.5855927737488"
"9139","65017","65008","7","65015","172365","14262.665625","0.185414653125","3.3290077494375046E7","432.7710074268738"
"9140","65015","65011","8","65019","172373","14263.543125","0.185426060625","3.3304341037500046E7","432.95643348749877"
"9141","65019","65016","3","65019","172376","14263.543125","0.185426060625","3.3318604580625046E7","433.14185954812376"
"9142","65019","65013","4","65017","172380","14263.104374999999","0.18542035687499997","3.3332867685000047E7","433.32727990499876"
"9143","65017","65016","3","65019","172383","14263.543125","0.185426060625","3.3347131228125047E7","433.51270596562375"
"9144","65019","65016","3","65019","172386","14263.543125","0.185426060625","3.3361394771250047E7","433.69813202624874"
"9145","65019","65013","1","65014","172387","14262.44625","0.18541180125","3.3375657217500046E7","433.8835438274987"
"9146","65014","65010","3","65013","172390","14262.226874999998","0.18540894937499997","3.3389919444375046E7","434.06895277687374"
"9147","65013","65010","6","65016","172396","14262.885000000002","0.185417505","3.3404182329375047E7","434.2543702818737"
"9148","65016","65013","6","65019","172402","14263.543125","0.185426060625","3.3418445872500047E7","434.4397963424987"
"9149","65019","65011","4","65015","172406","14262.665625","0.185414653125","3.3432708538125046E7","434.6252109956237"
"9150","65015","65014","6","65020","172412","14263.7625","0.1854289125","3.3446972300625045E7","434.81063990812373"
"9151","65020","65011","2","65013","172414","14262.226874999998","0.18540894937499997","3.3461234527500045E7","434.99604885749875"
"9152","65013","65004","2","65006","172416","14260.69125","0.18538898625","3.3475495218750045E7","435.18143784374877"
"9153","65006","65002","2","65004","172418","14260.2525","0.1853832825","3.3489755471250046E7","435.3668211262488"
"9154","65004","65002","4","65006","172422","14260.69125","0.18538898625","3.3504016162500046E7","435.5522101124988"
"9155","65006","64998","3","65001","172425","14259.594375","0.185374726875","3.3518275756875046E7","435.7375848393738"
"9156","65001","64997","2","64999","172427","14259.155625000001","0.185369023125","3.3532534912500046E7","435.92295386249884"
"9157","64999","64997","6","65003","172433","14260.033124999996","0.18538043062499995","3.3546794945625044E7","436.10833429312385"
"9158","65003","64996","3","64999","172436","14259.155625000001","0.185369023125","3.3561054101250045E7","436.29370331624887"
"9159","64999","64997","5","65002","172441","14259.81375","0.18537757875","3.3575313915000044E7","436.47908089499884"
"9160","65002","65001","8","65009","172449","14261.349375","0.185397541875","3.3589575264375046E7","436.6644784368738"
"9161","65009","65008","7","65015","172456","14262.665625","0.185414653125","3.3603837930000044E7","436.84989308999883"
"9162","65015","65010","6","65016","172462","14262.885000000002","0.185417505","3.361810081500004E7","437.0353105949988"
"9163","65016","65009","4","65013","172466","14262.226874999998","0.18540894937499997","3.363236304187504E7","437.2207195443738"
"9164","65013","65004","3","65007","172469","14260.910624999999","0.18539183812499996","3.3646623952500045E7","437.4061113824988"
"9165","65007","65001","2","65003","172471","14260.033124999996","0.18538043062499995","3.366088398562504E7","437.5914918131238"
"9166","65003","64994","2","64996","172473","14258.497500000001","0.18536046750000001","3.3675142483125046E7","437.7768522806238"
"9167","64996","64990","1","64991","172474","14257.400625000002","0.18534620812500002","3.3689399883750044E7","437.9621984887488"
"9168","64991","64983","9","64992","172483","14257.619999999999","0.18534905999999998","3.370365750375004E7","438.14754754874883"
"9169","64992","64991","8","64999","172491","14259.155625000001","0.185369023125","3.371791665937504E7","438.33291657187385"
"9170","64999","64997","3","65000","172494","14259.375","0.185371875","3.373217603437504E7","438.51828844687384"
"9171","65000","64998","1","64999","172495","14259.155625000001","0.185369023125","3.374643519000004E7","438.70365746999886"
"9172","64999","64991","8","64999","172503","14259.155625000001","0.185369023125","3.376069434562504E7","438.8890264931239"
"9173","64999","64992","7","64999","172510","14259.155625000001","0.185369023125","3.377495350125004E7","439.0743955162489"
"9174","64999","64992","8","65000","172518","14259.375","0.185371875","3.378921287625004E7","439.2597673912489"
"9175","65000","64992","4","64996","172522","14258.497500000001","0.18536046750000001","3.3803471373750046E7","439.4451278587489"
"9176","64996","64990","4","64994","172526","14258.05875","0.18535476374999998","3.381772943250005E7","439.6304826224989"
"9177","64994","64992","9","65001","172535","14259.594375","0.185374726875","3.383198902687505E7","439.8158573493739"
"9178","65001","64997","6","65003","172541","14260.033124999996","0.18538043062499995","3.384624906000005E7","440.0012377799989"
"9179","65003","64999","8","65007","172549","14260.910624999999","0.18539183812499996","3.386050997062505E7","440.1866296181239"
"9180","65007","65006","5","65011","172554","14261.788125","0.185403245625","3.387477175875005E7","440.3720328637489"
"9181","65011","65002","3","65005","172557","14260.471875","0.18538613437499998","3.388903223062505E7","440.5574189981239"
"9182","65005","64996","4","65000","172561","14259.375","0.185371875","3.390329160562505E7","440.7427908731239"
"9183","65000","64999","2","65001","172563","14259.594375","0.185374726875","3.391755120000005E7","440.9281655999989"
"9184","65001","64997","4","65001","172567","14259.594375","0.185374726875","3.393181079437505E7","441.11354032687393"
"9185","65001","64992","4","64996","172571","14258.497500000001","0.18536046750000001","3.394606929187505E7","441.29890079437394"
"9186","64996","64990","2","64992","172573","14257.619999999999","0.18534905999999998","3.396032691187505E7","441.48424985437396"
"9187","64992","64987","7","64994","172580","14258.05875","0.18535476374999998","3.397458497062505E7","441.66960461812397"
"9188","64994","64986","3","64989","172583","14256.961875","0.185340504375","3.398884193250005E7","441.854945122499"
"9189","64989","64984","1","64985","172584","14256.084375","0.185329096875","3.400309801687505E7","442.040274219374"
"9190","64985","64979","2","64981","172586","14255.206875","0.18531768937499998","3.401735322375005E7","442.225591908749"
"9191","64981","64976","5","64981","172591","14255.206875","0.18531768937499998","3.4031608430625044E7","442.41090959812396"
"9192","64981","64974","8","64982","172599","14255.426249999999","0.18532054124999997","3.404586385687505E7","442.596230139374"
"9193","64982","64973","9","64982","172608","14255.426249999999","0.18532054124999997","3.406011928312505E7","442.781550680624"
"9194","64982","64974","7","64981","172615","14255.206875","0.18531768937499998","3.407437449000005E7","442.96686836999896"
"9195","64981","64980","4","64984","172619","14255.865","0.18532624499999997","3.408863035500005E7","443.15219461499896"
"9196","64984","64978","3","64981","172622","14255.206875","0.18531768937499998","3.4102885561875045E7","443.33751230437394"
"9197","64981","64979","5","64984","172627","14255.865","0.18532624499999997","3.411714142687505E7","443.52283854937394"
"9198","64984","64982","6","64988","172633","14256.742499999998","0.18533765249999998","3.413139816937505E7","443.7081762018739"
"9199","64988","64986","2","64988","172635","14256.742499999998","0.18533765249999998","3.414565491187505E7","443.8935138543739"
"9200","64988","64982","5","64987","172640","14256.523125","0.185334800625","3.415991143500005E7","444.0788486549989"
"9201","64987","64979","9","64988","172649","14256.742499999998","0.18533765249999998","3.417416817750005E7","444.2641863074989"
"9202","64988","64982","3","64985","172652","14256.084375","0.185329096875","3.418842426187505E7","444.4495154043739"
"9203","64985","64982","5","64987","172657","14256.523125","0.185334800625","3.420268078500005E7","444.63485020499894"
"9204","64987","64982","8","64990","172665","14257.18125","0.18534335624999998","3.421693796625005E7","444.8201935612489"
"9205","64990","64989","2","64991","172667","14257.400625000002","0.18534620812500002","3.4231195366875045E7","445.0055397693739"
"9206","64991","64987","5","64992","172672","14257.619999999999","0.18534905999999998","3.424545298687504E7","445.19088882937393"
"9207","64992","64984","3","64987","172675","14256.523125","0.185334800625","3.425970951000004E7","445.37622362999895"
"9208","64987","64985","7","64992","172682","14257.619999999999","0.18534905999999998","3.427396713000004E7","445.56157268999897"
"9209","64992","64988","4","64992","172686","14257.619999999999","0.18534905999999998","3.428822475000004E7","445.746921749999"
"9210","64992","64990","4","64994","172690","14258.05875","0.18535476374999998","3.430248280875004E7","445.932276513749"
"9211","64994","64987","6","64993","172696","14257.839375","0.18535191187499997","3.431674064812504E7","446.117628425624"
"9212","64993","64987","5","64992","172701","14257.619999999999","0.18534905999999998","3.4330998268125035E7","446.302977485624"
"9213","64992","64991","5","64996","172706","14258.497500000001","0.18536046750000001","3.434525676562504E7","446.488337953124"
"9214","64996","64993","4","64997","172710","14258.716875","0.185363319375","3.435951548250004E7","446.67370127249904"
"9215","64997","64993","5","64998","172715","14258.936249999999","0.18536617124999996","3.437377441875004E7","446.85906744374904"
"9216","64998","64995","4","64999","172719","14259.155625000001","0.185369023125","3.438803357437504E7","447.04443646687406"
"9217","64999","64992","5","64997","172724","14258.716875","0.185363319375","3.440229229125004E7","447.2297997862491"
"9218","64997","64995","9","65004","172733","14260.2525","0.1853832825","3.441655254375004E7","447.4151830687491"
"9219","65004","64996","5","65001","172738","14259.594375","0.185374726875","3.443081213812504E7","447.6005577956241"
"9220","65001","64996","9","65005","172747","14260.471875","0.18538613437499998","3.444507261000004E7","447.7859439299991"
"9221","65005","65003","9","65012","172756","14262.0075","0.18540609749999998","3.445933461750004E7","447.9713500274991"
"9222","65012","65010","8","65018","172764","14263.32375","0.18542320874999998","3.447359794125003E7","448.15677323624914"
"9223","65018","65014","4","65018","172768","14263.32375","0.18542320874999998","3.448786126500003E7","448.34219644499916"
"9224","65018","65013","4","65017","172772","14263.104374999999","0.18542035687499997","3.450212436937503E7","448.52761680187416"
"9225","65017","65008","4","65012","172776","14262.0075","0.18540609749999998","3.451638637687503E7","448.71302289937415"
"9226","65012","65010","4","65014","172780","14262.44625","0.18541180125","3.453064882312503E7","448.89843470062414"
"9227","65014","65012","6","65018","172786","14263.32375","0.18542320874999998","3.4544912146875024E7","449.08385790937416"
"9228","65018","65017","2","65019","172788","14263.543125","0.185426060625","3.455917569000003E7","449.26928396999915"
"9229","65019","65011","3","65014","172791","14262.44625","0.18541180125","3.457343813625003E7","449.45469577124913"
"9230","65014","65012","8","65020","172799","14263.7625","0.1854289125","3.458770189875003E7","449.64012468374915"
"9231","65020","65013","6","65019","172805","14263.543125","0.185426060625","3.460196544187503E7","449.82555074437414"
"9232","65019","65017","3","65020","172808","14263.7625","0.1854289125","3.4616229204375036E7","450.01097965687416"
"9233","65020","65016","4","65020","172812","14263.7625","0.1854289125","3.463049296687504E7","450.19640856937417"
"9234","65020","65019","4","65023","172816","14264.420624999999","0.18543746812499998","3.464475738750004E7","450.38184603749914"
"9235","65023","65022","8","65030","172824","14265.95625","0.18545743124999997","3.465902334375004E7","450.5673034687491"
"9236","65030","65024","8","65032","172832","14266.394999999999","0.18546313499999997","3.467328973875004E7","450.75276660374914"
"9237","65032","65024","1","65025","172833","14264.859375","0.18544317187499998","3.468755459812504E7","450.93820977562416"
"9238","65025","65017","9","65026","172842","14265.07875","0.18544602375","3.470181967687504E7","451.12365579937415"
"9239","65026","65025","1","65026","172843","14265.07875","0.18544602375","3.471608475562504E7","451.30910182312414"
"9240","65026","65018","2","65020","172845","14263.7625","0.1854289125","3.473034851812504E7","451.49453073562415"
"9241","65020","65015","3","65018","172848","14263.32375","0.18542320874999998","3.474461184187504E7","451.6799539443742"
"9242","65018","65012","5","65017","172853","14263.104374999999","0.18542035687499997","3.475887494625004E7","451.8653743012492"
"9243","65017","65012","1","65013","172854","14262.226874999998","0.18540894937499997","3.4773137173125036E7","452.0507832506242"
"9244","65013","65010","7","65017","172861","14263.104374999999","0.18542035687499997","3.478740027750003E7","452.2362036074992"
"9245","65017","65016","8","65024","172869","14264.640000000001","0.18544032","3.4801664917500034E7","452.4216439274992"
"9246","65024","65017","4","65021","172873","14263.981875000001","0.185431764375","3.481592889937504E7","452.6070756918742"
"9247","65021","65012","3","65015","172876","14262.665625","0.185414653125","3.4830191565000035E7","452.7924903449992"
"9248","65015","65009","5","65014","172881","14262.44625","0.18541180125","3.4844454011250034E7","452.97790214624916"
"9249","65014","65009","5","65014","172886","14262.44625","0.18541180125","3.485871645750003E7","453.16331394749915"
"9250","65014","65007","6","65013","172892","14262.226874999998","0.18540894937499997","3.487297868437503E7","453.34872289687416"
"9251","65013","65011","9","65020","172901","14263.7625","0.1854289125","3.4887242446875036E7","453.5341518093742"
"9252","65020","65014","8","65022","172909","14264.20125","0.18543461625","3.490150664812504E7","453.7195864256242"
"9253","65022","65013","5","65018","172914","14263.32375","0.18542320874999998","3.4915769971875034E7","453.9050096343742"
"9254","65018","65010","7","65017","172921","14263.104374999999","0.18542035687499997","3.493003307625003E7","454.0904299912492"
"9255","65017","65010","7","65017","172928","14263.104374999999","0.18542035687499997","3.494429618062503E7","454.2758503481242"
"9256","65017","65010","9","65019","172937","14263.543125","0.185426060625","3.495855972375003E7","454.4612764087492"
"9257","65019","65016","6","65022","172943","14264.20125","0.18543461625","3.4972823925000034E7","454.6467110249992"
"9258","65022","65021","4","65025","172947","14264.859375","0.18544317187499998","3.4987088784375034E7","454.8321541968742"
"9259","65025","65018","2","65020","172949","14263.7625","0.1854289125","3.500135254687504E7","455.01758310937424"
"9260","65020","65014","3","65017","172952","14263.104374999999","0.18542035687499997","3.5015615651250035E7","455.20300346624924"
"9261","65017","65011","6","65017","172958","14263.104374999999","0.18542035687499997","3.502987875562503E7","455.38842382312424"
"9262","65017","65013","3","65016","172961","14262.885000000002","0.185417505","3.504414164062503E7","455.5738413281242"
"9263","65016","65009","6","65015","172967","14262.665625","0.185414653125","3.505840430625003E7","455.7592559812492"
"9264","65015","65007","3","65010","172970","14261.56875","0.18540039375","3.507266587500003E7","455.9446563749992"
"9265","65010","65001","6","65007","172976","14260.910624999999","0.18539183812499996","3.508692678562503E7","456.1300482131242"
"9266","65007","64999","2","65001","172978","14259.594375","0.185374726875","3.510118638000003E7","456.3154229399992"
"9267","65001","65000","9","65009","172987","14261.349375","0.185397541875","3.5115447729375035E7","456.5008204818742"
"9268","65009","65001","3","65004","172990","14260.2525","0.1853832825","3.512970798187503E7","456.6862037643742"
"9269","65004","64998","5","65003","172995","14260.033124999996","0.18538043062499995","3.514396801500003E7","456.87158419499923"
"9270","65003","64995","9","65004","173004","14260.2525","0.1853832825","3.515822826750003E7","457.05696747749926"
"9271","65004","64998","5","65003","173009","14260.033124999996","0.18538043062499995","3.5172488300625026E7","457.24234790812426"
"9272","65003","64998","7","65005","173016","14260.471875","0.18538613437499998","3.518674877250002E7","457.42773404249925"
"9273","65005","65003","2","65005","173018","14260.471875","0.18538613437499998","3.520100924437502E7","457.61312017687425"
"9274","65005","65002","7","65009","173025","14261.349375","0.185397541875","3.521527059375002E7","457.7985177187492"
"9275","65009","65005","6","65011","173031","14261.788125","0.185403245625","3.522953238187502E7","457.98392096437425"
"9276","65011","65007","9","65016","173040","14262.885000000002","0.185417505","3.524379526687502E7","458.1693384693742"
"9277","65016","65015","5","65020","173045","14263.7625","0.1854289125","3.5258059029375024E7","458.35476738187424"
"9278","65020","65017","5","65022","173050","14264.20125","0.18543461625","3.5272323230625026E7","458.54020199812425"
"9279","65022","65017","1","65018","173051","14263.32375","0.18542320874999998","3.528658655437502E7","458.72562520687427"
"9280","65018","65013","7","65020","173058","14263.7625","0.1854289125","3.5300850316875026E7","458.9110541193743"
"9281","65020","65013","8","65021","173066","14263.981875000001","0.185431764375","3.531511429875003E7","459.09648588374927"
"9282","65021","65014","4","65018","173070","14263.32375","0.18542320874999998","3.5329377622500025E7","459.2819090924993"
"9283","65018","65013","3","65016","173073","14262.885000000002","0.185417505","3.534364050750002E7","459.46732659749927"
"9284","65016","65011","8","65019","173081","14263.543125","0.185426060625","3.5357904050625026E7","459.65275265812426"
"9285","65019","65010","5","65015","173086","14262.665625","0.185414653125","3.5372166716250025E7","459.83816731124926"
"9286","65015","65010","7","65017","173093","14263.104374999999","0.18542035687499997","3.538642982062502E7","460.02358766812426"
"9287","65017","65016","1","65017","173094","14263.104374999999","0.18542035687499997","3.540069292500002E7","460.20900802499926"
"9288","65017","65010","1","65011","173095","14261.788125","0.185403245625","3.541495471312502E7","460.3944112706243"
"9289","65011","65006","8","65014","173103","14262.44625","0.18541180125","3.542921715937502E7","460.5798230718743"
"9290","65014","65011","7","65018","173110","14263.32375","0.18542320874999998","3.5443480483125016E7","460.7652462806243"
"9291","65018","65015","4","65019","173114","14263.543125","0.185426060625","3.545774402625002E7","460.9506723412493"
"9292","65019","65012","6","65018","173120","14263.32375","0.18542320874999998","3.547200735000002E7","461.1360955499993"
"9293","65018","65011","5","65016","173125","14262.885000000002","0.185417505","3.5486270235000014E7","461.3215130549993"
"9294","65016","65015","8","65023","173133","14264.420624999999","0.18543746812499998","3.5500534655625015E7","461.50695052312426"
"9295","65023","65020","2","65022","173135","14264.20125","0.18543461625","3.551479885687502E7","461.69238513937427"
"9296","65022","65020","7","65027","173142","14265.298125","0.18544887562499998","3.5529064155000016E7","461.8778340149993"
"9297","65027","65024","3","65027","173145","14265.298125","0.18544887562499998","3.5543329453125015E7","462.0632828906243"
"9298","65027","65020","4","65024","173149","14264.640000000001","0.18544032","3.5557594093125015E7","462.2487232106243"
"9299","65024","65017","3","65020","173152","14263.7625","0.1854289125","3.557185785562502E7","462.4341521231243"
"9300","65020","65015","6","65021","173158","14263.981875000001","0.185431764375","3.558612183750002E7","462.6195838874993"
"9301","65021","65016","6","65022","173164","14264.20125","0.18543461625","3.560038603875002E7","462.8050185037493"
"9302","65022","65015","2","65017","173166","14263.104374999999","0.18542035687499997","3.561464914312502E7","462.9904388606243"
"9303","65017","65012","3","65015","173169","14262.665625","0.185414653125","3.562891180875002E7","463.1758535137493"
"9304","65015","65010","9","65019","173178","14263.543125","0.185426060625","3.564317535187502E7","463.3612795743743"
"9305","65019","65015","9","65024","173187","14264.640000000001","0.18544032","3.565743999187502E7","463.5467198943743"
"9306","65024","65016","2","65018","173189","14263.32375","0.18542320874999998","3.567170331562502E7","463.7321431031243"
"9307","65018","65011","1","65012","173190","14262.0075","0.18540609749999998","3.568596532312502E7","463.9175492006243"
"9308","65012","65009","4","65013","173194","14262.226874999998","0.18540894937499997","3.570022755000002E7","464.1029581499993"
"9309","65013","65007","6","65013","173200","14262.226874999998","0.18540894937499997","3.571448977687502E7","464.28836709937434"
"9310","65013","65012","4","65016","173204","14262.885000000002","0.185417505","3.572875266187502E7","464.4737846043743"
"9311","65016","65014","8","65022","173212","14264.20125","0.18543461625","3.574301686312502E7","464.6592192206243"
"9312","65022","65021","5","65026","173217","14265.07875","0.18544602375","3.575728194187502E7","464.8446652443743"
"9313","65026","65025","6","65031","173223","14266.175625","0.185460283125","3.5771548117500015E7","465.0301255274993"
"9314","65031","65022","3","65025","173226","14264.859375","0.18544317187499998","3.5785812976875015E7","465.21556869937433"
"9315","65025","65017","7","65024","173233","14264.640000000001","0.18544032","3.5800077616875015E7","465.4010090193743"
"9316","65024","65022","9","65031","173242","14266.175625","0.185460283125","3.581434379250001E7","465.5864693024993"
"9317","65031","65026","2","65028","173244","14265.517499999996","0.18545172749999994","3.582860931000001E7","465.7719210299993"
"9318","65028","65024","2","65026","173246","14265.07875","0.18544602375","3.584287438875001E7","465.9573670537493"
"9319","65026","65017","6","65023","173252","14264.420624999999","0.18543746812499998","3.585713880937501E7","466.14280452187427"
"9320","65023","65016","5","65021","173257","14263.981875000001","0.185431764375","3.587140279125001E7","466.32823628624925"
"9321","65021","65016","4","65020","173261","14263.7625","0.1854289125","3.5885666553750016E7","466.51366519874927"
"9322","65020","65015","4","65019","173265","14263.543125","0.185426060625","3.589993009687502E7","466.69909125937426"
"9323","65019","65013","5","65018","173270","14263.32375","0.18542320874999998","3.5914193420625016E7","466.8845144681243"
"9324","65018","65013","2","65015","173272","14262.665625","0.185414653125","3.5928456086250015E7","467.0699291212493"
"9325","65015","65008","5","65013","173277","14262.226874999998","0.18540894937499997","3.5942718313125014E7","467.2553380706243"
"9326","65013","65008","8","65016","173285","14262.885000000002","0.185417505","3.595698119812501E7","467.4407555756243"
"9327","65016","65007","8","65015","173293","14262.665625","0.185414653125","3.597124386375001E7","467.6261702287493"
"9328","65015","65006","5","65011","173298","14261.788125","0.185403245625","3.598550565187501E7","467.8115734743743"
"9329","65011","65004","6","65010","173304","14261.56875","0.18540039375","3.599976722062501E7","467.9969738681243"
"9330","65010","65006","4","65010","173308","14261.56875","0.18540039375","3.6014028789375015E7","468.1823742618743"
"9331","65010","65008","3","65011","173311","14261.788125","0.185403245625","3.6028290577500015E7","468.36777750749934"
"9332","65011","65005","6","65011","173317","14261.788125","0.185403245625","3.604255236562502E7","468.55318075312437"
"9333","65011","65004","7","65011","173324","14261.788125","0.185403245625","3.605681415375002E7","468.7385839987494"
"9334","65011","65006","9","65015","173333","14262.665625","0.185414653125","3.6071076819375016E7","468.9239986518744"
"9335","65015","65011","3","65014","173336","14262.44625","0.18541180125","3.6085339265625015E7","469.1094104531244"
"9336","65014","65005","9","65014","173345","14262.44625","0.18541180125","3.6099601711875014E7","469.29482225437437"
"9337","65014","65007","3","65010","173348","14261.56875","0.18540039375","3.6113863280625015E7","469.48022264812437"
"9338","65010","65003","5","65008","173353","14261.13","0.18539468999999997","3.612812441062502E7","469.6656173381244"
"9339","65008","65004","5","65009","173358","14261.349375","0.185397541875","3.614238576000002E7","469.85101487999935"
"9340","65009","65004","5","65009","173363","14261.349375","0.185397541875","3.615664710937502E7","470.03641242187433"
"9341","65009","65005","5","65010","173368","14261.56875","0.18540039375","3.6170908678125024E7","470.22181281562433"
"9342","65010","65005","7","65012","173375","14262.0075","0.18540609749999998","3.6185170685625024E7","470.4072189131243"
"9343","65012","65004","2","65006","173377","14260.69125","0.18538898625","3.619943137687502E7","470.59260789937434"
"9344","65006","65000","6","65006","173383","14260.69125","0.18538898625","3.621369206812502E7","470.77799688562436"
"9345","65006","64999","3","65002","173386","14259.81375","0.18537757875","3.6227951881875016E7","470.96337446437434"
"9346","65002","64995","4","64999","173390","14259.155625000001","0.185369023125","3.624221103750002E7","471.14874348749936"
"9347","64999","64998","3","65001","173393","14259.594375","0.185374726875","3.6256470631875016E7","471.33411821437437"
"9348","65001","64994","1","64995","173394","14258.278125","0.185357615625","3.627072891000002E7","471.51947582999935"
"9349","64995","64990","8","64998","173402","14258.936249999999","0.18536617124999996","3.628498784625002E7","471.70484200124935"
"9350","64998","64995","5","65000","173407","14259.375","0.185371875","3.629924722125002E7","471.89021387624933"
"9351","65000","64995","7","65002","173414","14259.81375","0.18537757875","3.631350703500002E7","472.0755914549993"
"9352","65002","64994","1","64995","173415","14258.278125","0.185357615625","3.632776531312502E7","472.2609490706243"
"9353","64995","64994","1","64995","173416","14258.278125","0.185357615625","3.6342023591250025E7","472.4463066862493"
"9354","64995","64987","8","64995","173424","14258.278125","0.185357615625","3.635628186937503E7","472.63166430187425"
"9355","64995","64989","6","64995","173430","14258.278125","0.185357615625","3.637054014750003E7","472.81702191749923"
"9356","64995","64989","6","64995","173436","14258.278125","0.185357615625","3.638479842562503E7","473.0023795331242"
"9357","64995","64988","6","64994","173442","14258.05875","0.18535476374999998","3.639905648437504E7","473.1877342968742"
"9358","64994","64990","4","64994","173446","14258.05875","0.18535476374999998","3.641331454312504E7","473.37308906062424"
"9359","64994","64990","3","64993","173449","14257.839375","0.18535191187499997","3.642757238250004E7","473.5584409724992"
"9360","64993","64989","2","64991","173451","14257.400625000002","0.18534620812500002","3.6441829783125035E7","473.7437871806242"
"9361","64991","64983","3","64986","173454","14256.30375","0.18533194874999998","3.645608608687504E7","473.9291191293742"
"9362","64986","64983","6","64989","173460","14256.961875","0.185340504375","3.6470343048750035E7","474.1144596337492"
"9363","64989","64981","4","64985","173464","14256.084375","0.185329096875","3.648459913312504E7","474.29978873062424"
"9364","64985","64977","6","64983","173470","14255.645625","0.18532339312499999","3.649885477875004E7","474.4851121237492"
"9365","64983","64981","7","64988","173477","14256.742499999998","0.18533765249999998","3.651311152125004E7","474.6704497762492"
"9366","64988","64979","2","64981","173479","14255.206875","0.18531768937499998","3.6527366728125036E7","474.8557674656242"
"9367","64981","64973","1","64974","173480","14253.671250000001","0.18529772625000002","3.654162039937504E7","475.04106519187417"
"9368","64974","64965","2","64967","173482","14252.135624999999","0.18527776312499997","3.655587253500003E7","475.22634295499915"
"9369","64967","64965","8","64973","173490","14253.451874999999","0.18529487437499997","3.6570125986875035E7","475.4116378293742"
"9370","64973","64972","3","64975","173493","14253.890625","0.18530057812499998","3.6584379877500035E7","475.5969384074992"
"9371","64975","64973","8","64981","173501","14255.206875","0.18531768937499998","3.659863508437503E7","475.78225609687416"
"9372","64981","64978","8","64986","173509","14256.30375","0.18533194874999998","3.661289138812503E7","475.96758804562415"
"9373","64986","64980","4","64984","173513","14255.865","0.18532624499999997","3.6627147253125034E7","476.15291429062415"
"9374","64984","64979","4","64983","173517","14255.645625","0.18532339312499999","3.664140289875004E7","476.3382376837491"
"9375","64983","64980","3","64983","173520","14255.645625","0.18532339312499999","3.665565854437504E7","476.5235610768741"
"9376","64983","64978","5","64983","173525","14255.645625","0.18532339312499999","3.666991419000004E7","476.7088844699991"
"9377","64983","64980","4","64984","173529","14255.865","0.18532624499999997","3.6684170055000044E7","476.8942107149991"
"9378","64984","64975","1","64976","173530","14254.11","0.18530343","3.6698424165000044E7","477.07951414499905"
"9379","64976","64967","4","64971","173534","14253.013125000001","0.185289170625","3.6712677178125046E7","477.2648033156241"
"9380","64971","64962","9","64971","173543","14253.013125000001","0.185289170625","3.672693019125005E7","477.4500924862491"
"9381","64971","64962","8","64970","173551","14252.79375","0.18528631874999998","3.674118298500005E7","477.6353788049991"
"9382","64970","64968","8","64976","173559","14254.11","0.18530343","3.675543709500005E7","477.8206822349991"
"9383","64976","64974","5","64979","173564","14254.768125","0.185311985625","3.676969186312505E7","478.0059942206241"
"9384","64979","64975","9","64984","173573","14255.865","0.18532624499999997","3.678394772812505E7","478.1913204656241"
"9385","64984","64975","5","64980","173578","14254.9875","0.18531483749999997","3.679820271562505E7","478.3766353031241"
"9386","64980","64979","5","64984","173583","14255.865","0.18532624499999997","3.681245858062505E7","478.5619615481241"
"9387","64984","64979","2","64981","173585","14255.206875","0.18531768937499998","3.6826713787500046E7","478.7472792374991"
"9388","64981","64972","8","64980","173593","14254.9875","0.18531483749999997","3.684096877500004E7","478.9325940749991"
"9389","64980","64979","3","64982","173596","14255.426249999999","0.18532054124999997","3.685522420125005E7","479.1179146162491"
"9390","64982","64981","8","64989","173604","14256.961875","0.185340504375","3.6869481163125046E7","479.3032551206241"
"9391","64989","64986","1","64987","173605","14256.523125","0.185334800625","3.6883737686250046E7","479.4885899212491"
"9392","64987","64983","5","64988","173610","14256.742499999998","0.18533765249999998","3.6897994428750046E7","479.6739275737491"
"9393","64988","64980","3","64983","173613","14255.645625","0.18532339312499999","3.691225007437505E7","479.8592509668741"
"9394","64983","64979","4","64983","173617","14255.645625","0.18532339312499999","3.692650572000005E7","480.04457435999905"
"9395","64983","64978","3","64981","173620","14255.206875","0.18531768937499998","3.694076092687505E7","480.22989204937403"
"9396","64981","64974","7","64981","173627","14255.206875","0.18531768937499998","3.6955016133750044E7","480.415209738749"
"9397","64981","64975","4","64979","173631","14254.768125","0.185311985625","3.696927090187504E7","480.600521724374"
"9398","64979","64975","1","64976","173632","14254.11","0.18530343","3.698352501187504E7","480.785825154374"
"9399","64976","64969","6","64975","173638","14253.890625","0.18530057812499998","3.699777890250004E7","480.971125732499"
"9400","64975","64966","1","64967","173639","14252.135624999999","0.18527776312499997","3.701203103812504E7","481.156403495624"
"9401","64967","64965","9","64974","173648","14253.671250000001","0.18529772625000002","3.702628470937504E7","481.34170122187396"
"9402","64974","64972","1","64973","173649","14253.451874999999","0.18529487437499997","3.704053816125004E7","481.526996096249"
"9403","64973","64970","7","64977","173656","14254.329375","0.18530628187499998","3.705479249062504E7","481.712302378124"
"9404","64977","64972","4","64976","173660","14254.11","0.18530343","3.706904660062504E7","481.89760580812396"
"9405","64976","64967","7","64974","173667","14253.671250000001","0.18529772625000002","3.708330027187504E7","482.08290353437394"
"9406","64974","64973","8","64981","173675","14255.206875","0.18531768937499998","3.7097555478750035E7","482.2682212237489"
"9407","64981","64976","9","64985","173684","14256.084375","0.185329096875","3.711181156312504E7","482.45355032062395"
"9408","64985","64981","5","64986","173689","14256.30375","0.18533194874999998","3.712606786687504E7","482.63888226937394"
"9409","64986","64984","4","64988","173693","14256.742499999998","0.18533765249999998","3.714032460937504E7","482.8242199218739"
"9410","64988","64979","1","64980","173694","14254.9875","0.18531483749999997","3.7154579596875034E7","483.00953475937393"
"9411","64980","64979","9","64988","173703","14256.742499999998","0.18533765249999998","3.7168836339375034E7","483.1948724118739"
"9412","64988","64986","6","64992","173709","14257.619999999999","0.18534905999999998","3.718309395937503E7","483.38022147187394"
"9413","64992","64986","9","64995","173718","14258.278125","0.185357615625","3.7197352237500034E7","483.5655790874989"
"9414","64995","64986","6","64992","173724","14257.619999999999","0.18534905999999998","3.721160985750003E7","483.75092814749894"
"9415","64992","64991","8","64999","173732","14259.155625000001","0.185369023125","3.722586901312503E7","483.93629717062396"
"9416","64999","64992","1","64993","173733","14257.839375","0.18535191187499997","3.724012685250003E7","484.12164908249895"
"9417","64993","64985","9","64994","173742","14258.05875","0.18535476374999998","3.725438491125003E7","484.30700384624896"
"9418","64994","64989","4","64993","173746","14257.839375","0.18535191187499997","3.726864275062503E7","484.49235575812395"
"9419","64993","64989","5","64994","173751","14258.05875","0.18535476374999998","3.728290080937503E7","484.67771052187396"
"9420","64994","64993","2","64995","173753","14258.278125","0.185357615625","3.7297159087500036E7","484.86306813749894"
"9421","64995","64991","6","64997","173759","14258.716875","0.185363319375","3.731141780437504E7","485.04843145687397"
"9422","64997","64994","9","65003","173768","14260.033124999996","0.18538043062499995","3.7325677837500036E7","485.233811887499"
"9423","65003","64997","6","65003","173774","14260.033124999996","0.18538043062499995","3.7339937870625034E7","485.419192318124"
"9424","65003","64995","6","65001","173780","14259.594375","0.185374726875","3.735419746500003E7","485.604567044999"
"9425","65001","64995","7","65002","173787","14259.81375","0.18537757875","3.736845727875003E7","485.78994462374897"
"9426","65002","64994","9","65003","173796","14260.033124999996","0.18538043062499995","3.738271731187503E7","485.97532505437397"
"9427","65003","64998","6","65004","173802","14260.2525","0.1853832825","3.739697756437503E7","486.160708336874"
"9428","65004","65001","4","65005","173806","14260.471875","0.18538613437499998","3.7411238036250025E7","486.346094471249"
"9429","65005","64996","4","65000","173810","14259.375","0.185371875","3.7425497411250025E7","486.531466346249"
"9430","65000","64997","9","65006","173819","14260.69125","0.18538898625","3.743975810250002E7","486.716855332499"
"9431","65006","65003","5","65008","173824","14261.13","0.18539468999999997","3.7454019232500024E7","486.902250022499"
"9432","65008","65001","9","65010","173833","14261.56875","0.18540039375","3.7468280801250026E7","487.087650416249"
"9433","65010","65009","1","65010","173834","14261.56875","0.18540039375","3.748254237000003E7","487.273050809999"
"9434","65010","65009","1","65010","173835","14261.56875","0.18540039375","3.749680393875003E7","487.458451203749"
"9435","65010","65003","3","65006","173838","14260.69125","0.18538898625","3.7511064630000025E7","487.643840189999"
"9436","65006","65000","3","65003","173841","14260.033124999996","0.18538043062499995","3.752532466312502E7","487.829220620624"
"9437","65003","65000","3","65003","173844","14260.033124999996","0.18538043062499995","3.753958469625002E7","488.01460105124903"
"9438","65003","64994","1","64995","173845","14258.278125","0.185357615625","3.7553842974375024E7","488.199958666874"
"9439","64995","64990","5","64995","173850","14258.278125","0.185357615625","3.756810125250003E7","488.385316282499"
"9440","64995","64987","7","64994","173857","14258.05875","0.18535476374999998","3.758235931125003E7","488.570671046249"
"9441","64994","64992","7","64999","173864","14259.155625000001","0.185369023125","3.759661846687503E7","488.756040069374"
"9442","64999","64992","3","64995","173867","14258.278125","0.185357615625","3.7610876745000035E7","488.941397684999"
"9443","64995","64993","6","64999","173873","14259.155625000001","0.185369023125","3.7625135900625035E7","489.126766708124"
"9444","64999","64990","5","64995","173878","14258.278125","0.185357615625","3.763939417875004E7","489.312124323749"
"9445","64995","64993","7","65000","173885","14259.375","0.185371875","3.765365355375004E7","489.497496198749"
"9446","65000","64995","8","65003","173893","14260.033124999996","0.18538043062499995","3.766791358687504E7","489.682876629374"
"9447","65003","64999","1","65000","173894","14259.375","0.185371875","3.768217296187504E7","489.868248504374"
"9448","65000","64998","5","65003","173899","14260.033124999996","0.18538043062499995","3.7696432995000035E7","490.053628934999"
"9449","65003","64994","5","64999","173904","14259.155625000001","0.185369023125","3.7710692150625035E7","490.238997958124"
"9450","64999","64993","3","64996","173907","14258.497500000001","0.18536046750000001","3.772495064812504E7","490.424358425624"
"9451","64996","64988","4","64992","173911","14257.619999999999","0.18534905999999998","3.7739208268125035E7","490.609707485624"
"9452","64992","64989","7","64996","173918","14258.497500000001","0.18536046750000001","3.775346676562504E7","490.79506795312403"
"9453","64996","64993","8","65001","173926","14259.594375","0.185374726875","3.776772636000004E7","490.98044267999904"
"9454","65001","64994","8","65002","173934","14259.81375","0.18537757875","3.7781986173750035E7","491.165820258749"
"9455","65002","64996","7","65003","173941","14260.033124999996","0.18538043062499995","3.779624620687503E7","491.351200689374"
"9456","65003","64997","5","65002","173946","14259.81375","0.18537757875","3.781050602062503E7","491.536578268124"
"9457","65002","64997","5","65002","173951","14259.81375","0.18537757875","3.782476583437503E7","491.721955846874"
"9458","65002","64997","9","65006","173960","14260.69125","0.18538898625","3.783902652562503E7","491.907344833124"
"9459","65006","65000","7","65007","173967","14260.910624999999","0.18539183812499996","3.785328743625003E7","492.092736671249"
"9460","65007","65002","1","65003","173968","14260.033124999996","0.18538043062499995","3.786754746937503E7","492.278117101874"
"9461","65003","64995","8","65003","173976","14260.033124999996","0.18538043062499995","3.788180750250003E7","492.463497532499"
"9462","65003","64999","9","65008","173985","14261.13","0.18539468999999997","3.789606863250003E7","492.648892222499"
"9463","65008","65004","2","65006","173987","14260.69125","0.18538898625","3.791032932375003E7","492.834281208749"
"9464","65006","65002","8","65010","173995","14261.56875","0.18540039375","3.792459089250003E7","493.019681602499"
"9465","65010","65006","1","65007","173996","14260.910624999999","0.18539183812499996","3.793885180312503E7","493.205073440624"
"9466","65007","64998","9","65007","174005","14260.910624999999","0.18539183812499996","3.7953112713750035E7","493.390465278749"
"9467","65007","65003","9","65012","174014","14262.0075","0.18540609749999998","3.7967374721250035E7","493.575871376249"
"9468","65012","65006","4","65010","174018","14261.56875","0.18540039375","3.798163629000004E7","493.761271769999"
"9469","65010","65007","6","65013","174024","14262.226874999998","0.18540894937499997","3.7995898516875036E7","493.946680719374"
"9470","65013","65004","5","65009","174029","14261.349375","0.185397541875","3.801015986625004E7","494.132078261249"
"9471","65009","65007","4","65011","174033","14261.788125","0.185403245625","3.802442165437504E7","494.317481506874"
"9472","65011","65009","3","65012","174036","14262.0075","0.18540609749999998","3.803868366187504E7","494.502887604374"
"9473","65012","65006","8","65014","174044","14262.44625","0.18541180125","3.805294610812504E7","494.688299405624"
"9474","65014","65008","8","65016","174052","14262.885000000002","0.185417505","3.806720899312504E7","494.87371691062395"
"9475","65016","65007","1","65008","174053","14261.13","0.18539468999999997","3.808147012312504E7","495.05911160062396"
"9476","65008","65001","1","65002","174054","14259.81375","0.18537757875","3.809572993687504E7","495.24448917937394"
"9477","65002","64996","7","65003","174061","14260.033124999996","0.18538043062499995","3.8109989970000036E7","495.42986960999895"
"9478","65003","64996","7","65003","174068","14260.033124999996","0.18538043062499995","3.8124250003125034E7","495.61525004062395"
"9479","65003","64999","6","65005","174074","14260.471875","0.18538613437499998","3.813851047500003E7","495.80063617499894"
"9480","65005","65002","2","65004","174076","14260.2525","0.1853832825","3.815277072750003E7","495.98601945749897"
"9481","65004","64995","2","64997","174078","14258.716875","0.185363319375","3.816702944437503E7","496.171382776874"
"9482","64997","64995","4","64999","174082","14259.155625000001","0.185369023125","3.818128860000003E7","496.356751799999"
"9483","64999","64992","1","64993","174083","14257.839375","0.18535191187499997","3.819554643937503E7","496.542103711874"
"9484","64993","64991","3","64994","174086","14258.05875","0.18535476374999998","3.820980449812503E7","496.727458475624"
"9485","64994","64991","7","64998","174093","14258.936249999999","0.18536617124999996","3.822406343437503E7","496.912824646874"
"9486","64998","64992","9","65001","174102","14259.594375","0.185374726875","3.823832302875003E7","497.098199373749"
"9487","65001","64994","9","65003","174111","14260.033124999996","0.18538043062499995","3.825258306187503E7","497.283579804374"
"9488","65003","64999","8","65007","174119","14260.910624999999","0.18539183812499996","3.826684397250003E7","497.468971642499"
"9489","65007","65003","3","65006","174122","14260.69125","0.18538898625","3.828110466375003E7","497.65436062874903"
"9490","65006","64998","4","65002","174126","14259.81375","0.18537757875","3.829536447750003E7","497.839738207499"
"9491","65002","65000","4","65004","174130","14260.2525","0.1853832825","3.830962473000003E7","498.02512148999904"
"9492","65004","65003","3","65006","174133","14260.69125","0.18538898625","3.832388542125002E7","498.21051047624906"
"9493","65006","65004","6","65010","174139","14261.56875","0.18540039375","3.8338146990000024E7","498.39591086999906"
"9494","65010","65003","8","65011","174147","14261.788125","0.185403245625","3.8352408778125025E7","498.5813141156241"
"9495","65011","65007","2","65009","174149","14261.349375","0.185397541875","3.836667012750003E7","498.76671165749906"
"9496","65009","65004","1","65005","174150","14260.471875","0.18538613437499998","3.8380930599375024E7","498.95209779187405"
"9497","65005","65000","4","65004","174154","14260.2525","0.1853832825","3.839519085187502E7","499.1374810743741"
"9498","65004","64995","7","65002","174161","14259.81375","0.18537757875","3.840945066562502E7","499.32285865312406"
"9499","65002","64995","3","64998","174164","14258.936249999999","0.18536617124999996","3.842370960187502E7","499.50822482437405"
"9500","64998","64992","3","64995","174167","14258.278125","0.185357615625","3.8437967880000025E7","499.69358243999903"
"9501","64995","64987","3","64990","174170","14257.18125","0.18534335624999998","3.845222506125002E7","499.878925796249"
"9502","64990","64984","4","64988","174174","14256.742499999998","0.18533765249999998","3.846648180375002E7","500.064263448749"
"9503","64988","64979","8","64987","174182","14256.523125","0.185334800625","3.848073832687502E7","500.249598249374"
"9504","64987","64983","4","64987","174186","14256.523125","0.185334800625","3.8494994850000024E7","500.434933049999"
"9505","64987","64980","8","64988","174194","14256.742499999998","0.18533765249999998","3.850925159250002E7","500.620270702499"
"9506","64988","64986","8","64994","174202","14258.05875","0.18535476374999998","3.852350965125003E7","500.805625466249"
"9507","64994","64992","5","64997","174207","14258.716875","0.185363319375","3.853776836812503E7","500.99098878562404"
"9508","64997","64994","5","64999","174212","14259.155625000001","0.185369023125","3.855202752375003E7","501.17635780874906"
"9509","64999","64994","8","65002","174220","14259.81375","0.18537757875","3.856628733750003E7","501.36173538749904"
"9510","65002","64994","6","65000","174226","14259.375","0.185371875","3.858054671250003E7","501.547107262499"
"9511","65000","64997","4","65001","174230","14259.594375","0.185374726875","3.859480630687503E7","501.73248198937404"
"9512","65001","64996","1","64997","174231","14258.716875","0.185363319375","3.860906502375003E7","501.91784530874907"
"9513","64997","64994","3","64997","174234","14258.716875","0.185363319375","3.862332374062503E7","502.1032086281241"
"9514","64997","64988","8","64996","174242","14258.497500000001","0.18536046750000001","3.863758223812503E7","502.2885690956241"
"9515","64996","64994","2","64996","174244","14258.497500000001","0.18536046750000001","3.8651840735625036E7","502.4739295631241"
"9516","64996","64994","3","64997","174247","14258.716875","0.185363319375","3.866609945250004E7","502.65929288249913"
"9517","64997","64991","3","64994","174250","14258.05875","0.18535476374999998","3.868035751125004E7","502.84464764624914"
"9518","64994","64985","6","64991","174256","14257.400625000002","0.18534620812500002","3.869461491187504E7","503.02999385437414"
"9519","64991","64983","4","64987","174260","14256.523125","0.185334800625","3.870887143500004E7","503.21532865499915"
"9520","64987","64985","8","64993","174268","14257.839375","0.18535191187499997","3.872312927437504E7","503.40068056687414"
"9521","64993","64992","7","64999","174275","14259.155625000001","0.185369023125","3.873738843000004E7","503.58604958999916"
"9522","64999","64992","2","64994","174277","14258.05875","0.18535476374999998","3.875164648875004E7","503.7714043537492"
"9523","64994","64992","6","64998","174283","14258.936249999999","0.18536617124999996","3.876590542500004E7","503.9567705249992"
"9524","64998","64990","3","64993","174286","14257.839375","0.18535191187499997","3.878016326437504E7","504.14212243687416"
"9525","64993","64986","5","64991","174291","14257.400625000002","0.18534620812500002","3.879442066500004E7","504.32746864499916"
"9526","64991","64983","8","64991","174299","14257.400625000002","0.18534620812500002","3.8808678065625034E7","504.51281485312415"
"9527","64991","64989","5","64994","174304","14258.05875","0.18535476374999998","3.882293612437504E7","504.69816961687417"
"9528","64994","64985","2","64987","174306","14256.523125","0.185334800625","3.883719264750004E7","504.8835044174992"
"9529","64987","64983","8","64991","174314","14257.400625000002","0.18534620812500002","3.8851450048125036E7","505.0688506256242"
"9530","64991","64988","4","64992","174318","14257.619999999999","0.18534905999999998","3.886570766812503E7","505.2541996856242"
"9531","64992","64991","4","64995","174322","14258.278125","0.185357615625","3.887996594625004E7","505.4395573012492"
"9532","64995","64986","9","64995","174331","14258.278125","0.185357615625","3.889422422437504E7","505.62491491687416"
"9533","64995","64990","8","64998","174339","14258.936249999999","0.18536617124999996","3.890848316062504E7","505.81028108812416"
"9534","64998","64992","1","64993","174340","14257.839375","0.18535191187499997","3.892274100000004E7","505.99563299999915"
"9535","64993","64992","3","64995","174343","14258.278125","0.185357615625","3.893699927812504E7","506.1809906156241"
"9536","64995","64991","5","64996","174348","14258.497500000001","0.18536046750000001","3.895125777562504E7","506.36635108312413"
"9537","64996","64995","6","65001","174354","14259.594375","0.185374726875","3.896551737000004E7","506.55172580999914"
"9538","65001","65000","6","65006","174360","14260.69125","0.18538898625","3.897977806125004E7","506.73711479624916"
"9539","65006","65000","7","65007","174367","14260.910624999999","0.18539183812499996","3.899403897187504E7","506.92250663437414"
"9540","65007","65004","7","65011","174374","14261.788125","0.185403245625","3.900830076000004E7","507.10790987999917"
"9541","65011","65004","5","65009","174379","14261.349375","0.185397541875","3.9022562109375045E7","507.29330742187415"
"9542","65009","65001","5","65006","174384","14260.69125","0.18538898625","3.903682280062504E7","507.47869640812416"
"9543","65006","65003","6","65009","174390","14261.349375","0.185397541875","3.905108415000004E7","507.66409394999914"
"9544","65009","65000","5","65005","174395","14260.471875","0.18538613437499998","3.906534462187504E7","507.84948008437414"
"9545","65005","65003","1","65004","174396","14260.2525","0.1853832825","3.907960487437504E7","508.03486336687416"
"9546","65004","65000","8","65008","174404","14261.13","0.18539468999999997","3.909386600437504E7","508.2202580568742"
"9547","65008","65004","9","65013","174413","14262.226874999998","0.18540894937499997","3.910812823125004E7","508.4056670062492"
"9548","65013","65007","5","65012","174418","14262.0075","0.18540609749999998","3.912239023875004E7","508.5910731037492"
"9549","65012","65009","8","65017","174426","14263.104374999999","0.18542035687499997","3.913665334312504E7","508.7764934606242"
"9550","65017","65013","9","65022","174435","14264.20125","0.18543461625","3.915091754437504E7","508.9619280768742"
"9551","65022","65021","4","65025","174439","14264.859375","0.18544317187499998","3.916518240375004E7","509.1473712487492"
"9552","65025","65017","8","65025","174447","14264.859375","0.18544317187499998","3.917944726312504E7","509.33281442062423"
"9553","65025","65017","3","65020","174450","14263.7625","0.1854289125","3.919371102562504E7","509.51824333312425"
"9554","65020","65015","3","65018","174453","14263.32375","0.18542320874999998","3.920797434937504E7","509.70366654187427"
"9555","65018","65017","6","65023","174459","14264.420624999999","0.18543746812499998","3.922223877000004E7","509.88910400999924"
"9556","65023","65022","8","65030","174467","14265.95625","0.18545743124999997","3.923650472625004E7","510.0745614412492"
"9557","65030","65028","4","65032","174471","14266.394999999999","0.18546313499999997","3.925077112125004E7","510.26002457624924"
"9558","65032","65029","4","65033","174475","14266.614375","0.185465986875","3.926503773562504E7","510.4454905631242"
"9559","65033","65030","8","65038","174483","14267.711249999998","0.18548024624999998","3.927930544687504E7","510.6309708093742"
"9560","65038","65036","7","65043","174490","14268.808125","0.18549450562499997","3.929357425500004E7","510.8164653149992"
"9561","65043","65035","2","65037","174492","14267.491875","0.185477394375","3.930784174687504E7","511.00194270937425"
"9562","65037","65035","6","65041","174498","14268.369375000002","0.18548880187500003","3.932211011625004E7","511.18743151124926"
"9563","65041","65033","4","65037","174502","14267.491875","0.185477394375","3.933637760812504E7","511.3729089056243"
"9564","65037","65036","5","65041","174507","14268.369375000002","0.18548880187500003","3.935064597750004E7","511.5583977074993"
"9565","65041","65036","7","65043","174514","14268.808125","0.18549450562499997","3.936491478562503E7","511.7438922131243"
"9566","65043","65036","5","65041","174519","14268.369375000002","0.18548880187500003","3.937918315500003E7","511.9293810149993"
"9567","65041","65033","1","65034","174520","14266.83375","0.18546883874999998","3.939344998875003E7","512.1148498537493"
"9568","65034","65027","4","65031","174524","14266.175625","0.185460283125","3.940771616437503E7","512.3003101368744"
"9569","65031","65029","1","65030","174525","14265.95625","0.18545743124999997","3.942198212062503E7","512.4857675681244"
"9570","65030","65029","2","65031","174527","14266.175625","0.185460283125","3.943624829625002E7","512.6712278512495"
"9571","65031","65029","6","65035","174533","14267.053125","0.185471690625","3.9450515349375024E7","512.8566995418745"
"9572","65035","65029","1","65030","174534","14265.95625","0.18545743124999997","3.946478130562502E7","513.0421569731245"
"9573","65030","65028","1","65029","174535","14265.736875","0.18545457937499998","3.947904704250002E7","513.2276115524995"
"9574","65029","65027","3","65030","174538","14265.95625","0.18545743124999997","3.9493312998750016E7","513.4130689837496"
"9575","65030","65029","5","65034","174543","14266.83375","0.18546883874999998","3.950757983250002E7","513.5985378224996"
"9576","65034","65030","4","65034","174547","14266.83375","0.18546883874999998","3.952184666625002E7","513.7840066612496"
"9577","65034","65032","3","65035","174550","14267.053125","0.185471690625","3.953611371937502E7","513.9694783518746"
"9578","65035","65026","1","65027","174551","14265.298125","0.18544887562499998","3.955037901750002E7","514.1549272274996"
"9579","65027","65023","7","65030","174558","14265.95625","0.18545743124999997","3.956464497375002E7","514.3403846587496"
"9580","65030","65023","7","65030","174565","14265.95625","0.18545743124999997","3.9578910930000015E7","514.5258420899996"
"9581","65030","65024","4","65028","174569","14265.517499999996","0.18545172749999994","3.959317644750001E7","514.7112938174996"
"9582","65028","65023","7","65030","174576","14265.95625","0.18545743124999997","3.960744240375001E7","514.8967512487496"
"9583","65030","65021","8","65029","174584","14265.736875","0.18545457937499998","3.962170814062501E7","515.0822058281246"
"9584","65029","65026","5","65031","174589","14266.175625","0.185460283125","3.9635974316250004E7","515.2676661112497"
"9585","65031","65025","7","65032","174596","14266.394999999999","0.18546313499999997","3.965024071125001E7","515.4531292462497"
"9586","65032","65023","2","65025","174598","14264.859375","0.18544317187499998","3.966450557062501E7","515.6385724181247"
"9587","65025","65017","3","65020","174601","14263.7625","0.1854289125","3.967876933312501E7","515.8240013306247"
"9588","65020","65016","8","65024","174609","14264.640000000001","0.18544032","3.969303397312501E7","516.0094416506247"
"9589","65024","65018","7","65025","174616","14264.859375","0.18544317187499998","3.970729883250001E7","516.1948848224997"
"9590","65025","65019","8","65027","174624","14265.298125","0.18544887562499998","3.972156413062501E7","516.3803336981247"
"9591","65027","65019","9","65028","174633","14265.517499999996","0.18545172749999994","3.973582964812501E7","516.5657854256247"
"9592","65028","65020","1","65021","174634","14263.981875000001","0.185431764375","3.975009363000001E7","516.7512171899997"
"9593","65021","65019","5","65024","174639","14264.640000000001","0.18544032","3.976435827000001E7","516.9366575099997"
"9594","65024","65016","7","65023","174646","14264.420624999999","0.18543746812499998","3.977862269062501E7","517.1220949781247"
"9595","65023","65022","4","65026","174650","14265.07875","0.18544602375","3.979288776937501E7","517.3075410018747"
"9596","65026","65017","1","65018","174651","14263.32375","0.18542320874999998","3.980715109312501E7","517.4929642106247"
"9597","65018","65014","9","65023","174660","14264.420624999999","0.18543746812499998","3.982141551375001E7","517.6784016787497"
"9598","65023","65018","2","65020","174662","14263.7625","0.1854289125","3.983567927625001E7","517.8638305912497"
"9599","65020","65016","4","65020","174666","14263.7625","0.1854289125","3.9849943038750015E7","518.0492595037497"
"9600","65020","65011","4","65015","174670","14262.665625","0.185414653125","3.986420570437501E7","518.2346741568747"
"9601","65015","65014","5","65019","174675","14263.543125","0.185426060625","3.987846924750002E7","518.4201002174997"
"9602","65019","65016","9","65025","174684","14264.859375","0.18544317187499998","3.989273410687502E7","518.6055433893747"
"9603","65025","65024","8","65032","174692","14266.394999999999","0.18546313499999997","3.990700050187502E7","518.7910065243747"
"9604","65032","65029","7","65036","174699","14267.2725","0.18547454249999998","3.992126777437502E7","518.9764810668746"
"9605","65036","65028","1","65029","174700","14265.736875","0.18545457937499998","3.993553351125002E7","519.1619356462496"
"9606","65029","65026","7","65033","174707","14266.614375","0.185465986875","3.994980012562502E7","519.3474016331246"
"9607","65033","65032","2","65034","174709","14266.83375","0.18546883874999998","3.9964066959375024E7","519.5328704718746"
"9608","65034","65030","6","65036","174715","14267.2725","0.18547454249999998","3.9978334231875025E7","519.7183450143746"
"9609","65036","65035","1","65036","174716","14267.2725","0.18547454249999998","3.9992601504375026E7","519.9038195568745"
"9610","65036","65029","8","65037","174724","14267.491875","0.185477394375","4.0006868996250026E7","520.0892969512495"
"9611","65037","65034","2","65036","174726","14267.2725","0.18547454249999998","4.002113626875003E7","520.2747714937494"
"9612","65036","65033","6","65039","174732","14267.930625","0.185483098125","4.0035404199375026E7","520.4602545918744"
"9613","65039","65033","9","65042","174741","14268.588749999999","0.18549165374999999","4.004967278812502E7","520.6457462456244"
"9614","65042","65038","8","65046","174749","14269.466250000001","0.18550306125000002","4.0063942254375026E7","520.8312493068744"
"9615","65046","65043","2","65045","174751","14269.246875","0.185500209375","4.007821150125003E7","521.0167495162494"
"9616","65045","65036","1","65037","174752","14267.491875","0.185477394375","4.009247899312503E7","521.2022269106244"
"9617","65037","65034","2","65036","174754","14267.2725","0.18547454249999998","4.010674626562503E7","521.3877014531244"
"9618","65036","65033","8","65041","174762","14268.369375000002","0.18548880187500003","4.012101463500003E7","521.5731902549993"
"9619","65041","65037","1","65038","174763","14267.711249999998","0.18548024624999998","4.013528234625003E7","521.7586705012493"
"9620","65038","65030","5","65035","174768","14267.053125","0.185471690625","4.014954939937503E7","521.9441421918743"
"9621","65035","65034","8","65042","174776","14268.588749999999","0.18549165374999999","4.0163817988125026E7","522.1296338456243"
"9622","65042","65041","4","65045","174780","14269.246875","0.185500209375","4.017808723500003E7","522.3151340549994"
"9623","65045","65039","7","65046","174787","14269.466250000001","0.18550306125000002","4.019235670125003E7","522.5006371162493"
"9624","65046","65041","8","65049","174795","14270.124375000001","0.185511616875","4.020662682562503E7","522.6861487331244"
"9625","65049","65043","3","65046","174798","14269.466250000001","0.18550306125000002","4.0220896291875035E7","522.8716517943743"
"9626","65046","65038","5","65043","174803","14268.808125","0.18549450562499997","4.023516510000003E7","523.0571462999993"
"9627","65043","65036","2","65038","174805","14267.711249999998","0.18548024624999998","4.024943281125003E7","523.2426265462493"
"9628","65038","65031","5","65036","174810","14267.2725","0.18547454249999998","4.026370008375003E7","523.4281010887493"
"9629","65036","65030","8","65038","174818","14267.711249999998","0.18548024624999998","4.027796779500003E7","523.6135813349993"
"9630","65038","65030","4","65034","174822","14266.83375","0.18546883874999998","4.029223462875003E7","523.7990501737493"
"9631","65034","65029","3","65032","174825","14266.394999999999","0.18546313499999997","4.030650102375004E7","523.9845133087492"
"9632","65032","65027","1","65028","174826","14265.517499999996","0.18545172749999994","4.0320766541250035E7","524.1699650362492"
"9633","65028","65020","8","65028","174834","14265.517499999996","0.18545172749999994","4.033503205875003E7","524.3554167637492"
"9634","65028","65027","7","65034","174841","14266.83375","0.18546883874999998","4.0349298892500035E7","524.5408856024992"
"9635","65034","65032","1","65033","174842","14266.614375","0.185465986875","4.036356550687504E7","524.7263515893742"
"9636","65033","65026","5","65031","174847","14266.175625","0.185460283125","4.0377831682500035E7","524.9118118724992"
"9637","65031","65023","1","65024","174848","14264.640000000001","0.18544032","4.0392096322500035E7","525.0972521924992"
"9638","65024","65016","2","65018","174850","14263.32375","0.18542320874999998","4.040635964625003E7","525.2826754012492"
"9639","65018","65017","5","65022","174855","14264.20125","0.18543461625","4.042062384750003E7","525.4681100174992"
"9640","65022","65019","2","65021","174857","14263.981875000001","0.185431764375","4.0434887829375036E7","525.6535417818742"
"9641","65021","65013","8","65021","174865","14263.981875000001","0.185431764375","4.044915181125004E7","525.8389735462492"
"9642","65021","65012","8","65020","174873","14263.7625","0.1854289125","4.046341557375004E7","526.0244024587493"
"9643","65020","65013","5","65018","174878","14263.32375","0.18542320874999998","4.047767889750004E7","526.2098256674992"
"9644","65018","65011","5","65016","174883","14262.885000000002","0.185417505","4.0491941782500036E7","526.3952431724992"
"9645","65016","65007","8","65015","174891","14262.665625","0.185414653125","4.0506204448125035E7","526.5806578256243"
"9646","65015","65009","5","65014","174896","14262.44625","0.18541180125","4.052046689437503E7","526.7660696268742"
"9647","65014","65010","8","65018","174904","14263.32375","0.18542320874999998","4.053473021812503E7","526.9514928356242"
"9648","65018","65009","6","65015","174910","14262.665625","0.185414653125","4.054899288375003E7","527.1369074887492"
"9649","65015","65011","7","65018","174917","14263.32375","0.18542320874999998","4.0563256207500026E7","527.3223306974992"
"9650","65018","65015","5","65020","174922","14263.7625","0.1854289125","4.057751997000003E7","527.5077596099992"
"9651","65020","65019","1","65020","174923","14263.7625","0.1854289125","4.059178373250003E7","527.6931885224992"
"9652","65020","65019","6","65025","174929","14264.859375","0.18544317187499998","4.060604859187503E7","527.8786316943742"
"9653","65025","65017","1","65018","174930","14263.32375","0.18542320874999998","4.062031191562503E7","528.0640549031242"
"9654","65018","65016","7","65023","174937","14264.420624999999","0.18543746812499998","4.063457633625003E7","528.2494923712492"
"9655","65023","65014","6","65020","174943","14263.7625","0.1854289125","4.064884009875003E7","528.4349212837492"
"9656","65020","65011","3","65014","174946","14262.44625","0.18541180125","4.066310254500003E7","528.6203330849992"
"9657","65014","65005","5","65010","174951","14261.56875","0.18540039375","4.067736411375003E7","528.8057334787492"
"9658","65010","65001","6","65007","174957","14260.910624999999","0.18539183812499996","4.069162502437504E7","528.9911253168742"
"9659","65007","65000","7","65007","174964","14260.910624999999","0.18539183812499996","4.070588593500004E7","529.1765171549993"
"9660","65007","65006","5","65011","174969","14261.788125","0.185403245625","4.072014772312504E7","529.3619204006243"
"9661","65011","65008","8","65016","174977","14262.885000000002","0.185417505","4.073441060812504E7","529.5473379056243"
"9662","65016","65010","9","65019","174986","14263.543125","0.185426060625","4.074867415125004E7","529.7327639662493"
"9663","65019","65016","6","65022","174992","14264.20125","0.18543461625","4.0762938352500044E7","529.9181985824993"
"9664","65022","65015","1","65016","174993","14262.885000000002","0.185417505","4.077720123750004E7","530.1036160874993"
"9665","65016","65015","9","65024","175002","14264.640000000001","0.18544032","4.079146587750004E7","530.2890564074993"
"9666","65024","65023","6","65029","175008","14265.736875","0.18545457937499998","4.080573161437504E7","530.4745109868743"
"9667","65029","65026","5","65031","175013","14266.175625","0.185460283125","4.081999779000004E7","530.6599712699993"
"9668","65031","65029","1","65030","175014","14265.95625","0.18545743124999997","4.083426374625003E7","530.8454287012494"
"9669","65030","65025","9","65034","175023","14266.83375","0.18546883874999998","4.0848530580000035E7","531.0308975399994"
"9670","65034","65026","8","65034","175031","14266.83375","0.18546883874999998","4.086279741375004E7","531.2163663787494"
"9671","65034","65025","7","65032","175038","14266.394999999999","0.18546313499999997","4.087706380875004E7","531.4018295137494"
"9672","65032","65030","5","65035","175043","14267.053125","0.185471690625","4.089133086187504E7","531.5873012043744"
"9673","65035","65027","1","65028","175044","14265.517499999996","0.18545172749999994","4.090559637937504E7","531.7727529318744"
"9674","65028","65022","5","65027","175049","14265.298125","0.18544887562499998","4.091986167750004E7","531.9582018074993"
"9675","65027","65021","6","65027","175055","14265.298125","0.18544887562499998","4.093412697562504E7","532.1436506831243"
"9676","65027","65021","9","65030","175064","14265.95625","0.18545743124999997","4.0948392931875035E7","532.3291081143743"
"9677","65030","65029","6","65035","175070","14267.053125","0.185471690625","4.096265998500004E7","532.5145798049994"
"9678","65035","65028","6","65034","175076","14266.83375","0.18546883874999998","4.097692681875004E7","532.7000486437494"
"9679","65034","65031","6","65037","175082","14267.491875","0.185477394375","4.099119431062504E7","532.8855260381243"
"9680","65037","65030","5","65035","175087","14267.053125","0.185471690625","4.100546136375004E7","533.0709977287494"
"9681","65035","65033","3","65036","175090","14267.2725","0.18547454249999998","4.101972863625004E7","533.2564722712493"
"9682","65036","65031","1","65032","175091","14266.394999999999","0.18546313499999997","4.1033995031250045E7","533.4419354062493"
"9683","65032","65031","3","65034","175094","14266.83375","0.18546883874999998","4.104826186500005E7","533.6274042449993"
"9684","65034","65032","7","65039","175101","14267.930625","0.185483098125","4.1062529795625046E7","533.8128873431243"
"9685","65039","65038","1","65039","175102","14267.930625","0.185483098125","4.1076797726250045E7","533.9983704412493"
"9686","65039","65036","9","65045","175111","14269.246875","0.185500209375","4.109106697312505E7","534.1838706506244"
"9687","65045","65041","1","65042","175112","14268.588749999999","0.18549165374999999","4.1105335561875045E7","534.3693623043744"
"9688","65042","65035","5","65040","175117","14268.15","0.18548594999999998","4.1119603711875044E7","534.5548482543744"
"9689","65040","65039","9","65048","175126","14269.904999999999","0.18550876499999996","4.1133873616875045E7","534.7403570193744"
"9690","65048","65040","1","65041","175127","14268.369375000002","0.18548880187500003","4.114814198625004E7","534.9258458212494"
"9691","65041","65039","7","65046","175134","14269.466250000001","0.18550306125000002","4.1162411452500045E7","535.1113488824993"
"9692","65046","65038","4","65042","175138","14268.588749999999","0.18549165374999999","4.117668004125004E7","535.2968405362493"
"9693","65042","65034","4","65038","175142","14267.711249999998","0.18548024624999998","4.119094775250004E7","535.4823207824993"
"9694","65038","65030","1","65031","175143","14266.175625","0.185460283125","4.120521392812504E7","535.6677810656244"
"9695","65031","65026","9","65035","175152","14267.053125","0.185471690625","4.121948098125004E7","535.8532527562494"
"9696","65035","65027","6","65033","175158","14266.614375","0.185465986875","4.123374759562504E7","536.0387187431244"
"9697","65033","65030","9","65039","175167","14267.930625","0.185483098125","4.124801552625004E7","536.2242018412494"
"9698","65039","65037","2","65039","175169","14267.930625","0.185483098125","4.126228345687504E7","536.4096849393744"
"9699","65039","65032","4","65036","175173","14267.2725","0.18547454249999998","4.127655072937504E7","536.5951594818744"
"9700","65036","65029","4","65033","175177","14266.614375","0.185465986875","4.1290817343750045E7","536.7806254687493"
"9701","65033","65030","2","65032","175179","14266.394999999999","0.18546313499999997","4.130508373875005E7","536.9660886037493"
"9702","65032","65027","6","65033","175185","14266.614375","0.185465986875","4.131935035312505E7","537.1515545906243"
"9703","65033","65032","4","65036","175189","14267.2725","0.18547454249999998","4.133361762562505E7","537.3370291331242"
"9704","65036","65027","7","65034","175196","14266.83375","0.18546883874999998","4.134788445937505E7","537.5224979718743"
"9705","65034","65025","9","65034","175205","14266.83375","0.18546883874999998","4.1362151293125056E7","537.7079668106243"
"9706","65034","65026","4","65030","175209","14265.95625","0.18545743124999997","4.137641724937505E7","537.8934242418743"
"9707","65030","65023","8","65031","175217","14266.175625","0.185460283125","4.139068342500005E7","538.0788845249994"
"9708","65031","65022","2","65024","175219","14264.640000000001","0.18544032","4.140494806500005E7","538.2643248449994"
"9709","65024","65015","2","65017","175221","14263.104374999999","0.18542035687499997","4.141921116937505E7","538.4497452018744"
"9710","65017","65016","8","65024","175229","14264.640000000001","0.18544032","4.143347580937505E7","538.6351855218744"
"9711","65024","65015","6","65021","175235","14263.981875000001","0.185431764375","4.144773979125005E7","538.8206172862494"
"9712","65021","65020","3","65023","175238","14264.420624999999","0.18543746812499998","4.146200421187505E7","539.0060547543744"
"9713","65023","65022","4","65026","175242","14265.07875","0.18544602375","4.147626929062505E7","539.1915007781245"
"9714","65026","65020","6","65026","175248","14265.07875","0.18544602375","4.149053436937505E7","539.3769468018745"
"9715","65026","65023","8","65031","175256","14266.175625","0.185460283125","4.150480054500005E7","539.5624070849996"
"9716","65031","65025","8","65033","175264","14266.614375","0.185465986875","4.151906715937505E7","539.7478730718746"
"9717","65033","65027","9","65036","175273","14267.2725","0.18547454249999998","4.153333443187505E7","539.9333476143745"
"9718","65036","65029","2","65031","175275","14266.175625","0.185460283125","4.154760060750005E7","540.1188078974996"
"9719","65031","65027","5","65032","175280","14266.394999999999","0.18546313499999997","4.156186700250005E7","540.3042710324995"
"9720","65032","65024","8","65032","175288","14266.394999999999","0.18546313499999997","4.157613339750005E7","540.4897341674995"
"9721","65032","65026","9","65035","175297","14267.053125","0.185471690625","4.1590400450625055E7","540.6752058581245"
"9722","65035","65028","1","65029","175298","14265.736875","0.18545457937499998","4.160466618750005E7","540.8606604374995"
"9723","65029","65021","5","65026","175303","14265.07875","0.18544602375","4.161893126625005E7","541.0461064612496"
"9724","65026","65022","3","65025","175306","14264.859375","0.18544317187499998","4.163319612562505E7","541.2315496331246"
"9725","65025","65016","4","65020","175310","14263.7625","0.1854289125","4.1647459888125055E7","541.4169785456246"
"9726","65020","65013","6","65019","175316","14263.543125","0.185426060625","4.166172343125006E7","541.6024046062496"
"9727","65019","65017","5","65022","175321","14264.20125","0.18543461625","4.167598763250006E7","541.7878392224995"
"9728","65022","65020","8","65028","175329","14265.517499999996","0.18545172749999994","4.169025315000006E7","541.9732909499995"
"9729","65028","65020","3","65023","175332","14264.420624999999","0.18543746812499998","4.170451757062506E7","542.1587284181245"
"9730","65023","65014","9","65023","175341","14264.420624999999","0.18543746812499998","4.171878199125006E7","542.3441658862495"
"9731","65023","65016","4","65020","175345","14263.7625","0.1854289125","4.173304575375006E7","542.5295947987495"
"9732","65020","65018","2","65020","175347","14263.7625","0.1854289125","4.174730951625007E7","542.7150237112495"
"9733","65020","65011","5","65016","175352","14262.885000000002","0.185417505","4.1761572401250064E7","542.9004412162495"
"9734","65016","65014","6","65020","175358","14263.7625","0.1854289125","4.177583616375007E7","543.0858701287495"
"9735","65020","65014","8","65022","175366","14264.20125","0.18543461625","4.179010036500007E7","543.2713047449995"
"9736","65022","65018","2","65020","175368","14263.7625","0.1854289125","4.180436412750007E7","543.4567336574995"
"9737","65020","65012","1","65013","175369","14262.226874999998","0.18540894937499997","4.181862635437507E7","543.6421426068745"
"9738","65013","65008","4","65012","175373","14262.0075","0.18540609749999998","4.183288836187507E7","543.8275487043745"
"9739","65012","65011","7","65018","175380","14263.32375","0.18542320874999998","4.184715168562507E7","544.0129719131245"
"9740","65018","65012","9","65021","175389","14263.981875000001","0.185431764375","4.186141566750007E7","544.1984036774995"
"9741","65021","65017","8","65025","175397","14264.859375","0.18544317187499998","4.187568052687507E7","544.3838468493745"
"9742","65025","65023","3","65026","175400","14265.07875","0.18544602375","4.188994560562507E7","544.5692928731246"
"9743","65026","65022","1","65023","175401","14264.420624999999","0.18543746812499998","4.190421002625007E7","544.7547303412496"
"9744","65023","65022","4","65026","175405","14265.07875","0.18544602375","4.191847510500007E7","544.9401763649996"
"9745","65026","65018","8","65026","175413","14265.07875","0.18544602375","4.193274018375007E7","545.1256223887497"
"9746","65026","65021","4","65025","175417","14264.859375","0.18544317187499998","4.194700504312507E7","545.3110655606247"
"9747","65025","65021","4","65025","175421","14264.859375","0.18544317187499998","4.196126990250007E7","545.4965087324997"
"9748","65025","65017","9","65026","175430","14265.07875","0.18544602375","4.197553498125007E7","545.6819547562498"
"9749","65026","65023","1","65024","175431","14264.640000000001","0.18544032","4.198979962125007E7","545.8673950762497"
"9750","65024","65022","4","65026","175435","14265.07875","0.18544602375","4.200406470000007E7","546.0528410999998"
"9751","65026","65024","6","65030","175441","14265.95625","0.18545743124999997","4.201833065625007E7","546.2382985312498"
"9752","65030","65022","8","65030","175449","14265.95625","0.18545743124999997","4.2032596612500064E7","546.4237559624999"
"9753","65030","65022","6","65028","175455","14265.517499999996","0.18545172749999994","4.204686213000006E7","546.6092076899998"
"9754","65028","65020","8","65028","175463","14265.517499999996","0.18545172749999994","4.206112764750006E7","546.7946594174998"
"9755","65028","65021","4","65025","175467","14264.859375","0.18544317187499998","4.207539250687506E7","546.9801025893748"
"9756","65025","65019","8","65027","175475","14265.298125","0.18544887562499998","4.208965780500006E7","547.1655514649998"
"9757","65027","65021","6","65027","175481","14265.298125","0.18544887562499998","4.210392310312506E7","547.3510003406248"
"9758","65027","65020","9","65029","175490","14265.736875","0.18545457937499998","4.2118188840000056E7","547.5364549199998"
"9759","65029","65026","2","65028","175492","14265.517499999996","0.18545172749999994","4.2132454357500054E7","547.7219066474997"
"9760","65028","65019","1","65020","175493","14263.7625","0.1854289125","4.214671812000006E7","547.9073355599998"
"9761","65020","65018","3","65021","175496","14263.981875000001","0.185431764375","4.216098210187506E7","548.0927673243748"
"9762","65021","65013","7","65020","175503","14263.7625","0.1854289125","4.217524586437506E7","548.2781962368748"
"9763","65020","65018","7","65025","175510","14264.859375","0.18544317187499998","4.218951072375006E7","548.4636394087498"
"9764","65025","65023","7","65030","175517","14265.95625","0.18545743124999997","4.220377668000006E7","548.6490968399999"
"9765","65030","65024","4","65028","175521","14265.517499999996","0.18545172749999994","4.221804219750006E7","548.8345485674998"
"9766","65028","65019","8","65027","175529","14265.298125","0.18544887562499998","4.223230749562506E7","549.0199974431248"
"9767","65027","65021","4","65025","175533","14264.859375","0.18544317187499998","4.224657235500006E7","549.2054406149998"
"9768","65025","65021","2","65023","175535","14264.420624999999","0.18543746812499998","4.226083677562506E7","549.3908780831248"
"9769","65023","65020","7","65027","175542","14265.298125","0.18544887562499998","4.227510207375006E7","549.5763269587497"
"9770","65027","65020","8","65028","175550","14265.517499999996","0.18545172749999994","4.2289367591250055E7","549.7617786862497"
"9771","65028","65026","4","65030","175554","14265.95625","0.18545743124999997","4.230363354750005E7","549.9472361174998"
"9772","65030","65021","9","65030","175563","14265.95625","0.18545743124999997","4.231789950375005E7","550.1326935487498"
"9773","65030","65021","8","65029","175571","14265.736875","0.18545457937499998","4.2332165240625046E7","550.3181481281248"
"9774","65029","65028","2","65030","175573","14265.95625","0.18545743124999997","4.234643119687504E7","550.5036055593748"
"9775","65030","65022","2","65024","175575","14264.640000000001","0.18544032","4.2360695836875044E7","550.6890458793748"
"9776","65024","65017","2","65019","175577","14263.543125","0.185426060625","4.237495938000005E7","550.8744719399998"
"9777","65019","65012","7","65019","175584","14263.543125","0.185426060625","4.238922292312505E7","551.0598980006248"
"9778","65019","65016","4","65020","175588","14263.7625","0.1854289125","4.2403486685625054E7","551.2453269131248"
"9779","65020","65012","4","65016","175592","14262.885000000002","0.185417505","4.241774957062505E7","551.4307444181248"
"9780","65016","65013","3","65016","175595","14262.885000000002","0.185417505","4.243201245562505E7","551.6161619231249"
"9781","65016","65014","7","65021","175602","14263.981875000001","0.185431764375","4.244627643750005E7","551.8015936874999"
"9782","65021","65020","3","65023","175605","14264.420624999999","0.18543746812499998","4.246054085812505E7","551.9870311556249"
"9783","65023","65015","1","65016","175606","14262.885000000002","0.185417505","4.247480374312505E7","552.1724486606249"
"9784","65016","65012","7","65019","175613","14263.543125","0.185426060625","4.2489067286250055E7","552.3578747212499"
"9785","65019","65015","4","65019","175617","14263.543125","0.185426060625","4.250333082937506E7","552.5433007818749"
"9786","65019","65011","5","65016","175622","14262.885000000002","0.185417505","4.251759371437506E7","552.7287182868749"
"9787","65016","65007","2","65009","175624","14261.349375","0.185397541875","4.253185506375006E7","552.9141158287499"
"9788","65009","65002","5","65007","175629","14260.910624999999","0.18539183812499996","4.254611597437506E7","553.099507666875"
"9789","65007","64998","8","65006","175637","14260.69125","0.18538898625","4.256037666562506E7","553.284896653125"
"9790","65006","65002","3","65005","175640","14260.471875","0.18538613437499998","4.2574637137500055E7","553.4702827875"
"9791","65005","64998","4","65002","175644","14259.81375","0.18537757875","4.2588896951250054E7","553.65566036625"
"9792","65002","64996","5","65001","175649","14259.594375","0.185374726875","4.260315654562505E7","553.841035093125"
"9793","65001","64999","3","65002","175652","14259.81375","0.18537757875","4.261741635937505E7","554.026412671875"
"9794","65002","64999","7","65006","175659","14260.69125","0.18538898625","4.263167705062505E7","554.2118016581251"
"9795","65006","64998","6","65004","175665","14260.2525","0.1853832825","4.2645937303125046E7","554.397184940625"
"9796","65004","65001","5","65006","175670","14260.69125","0.18538898625","4.266019799437504E7","554.582573926875"
"9797","65006","65003","9","65012","175679","14262.0075","0.18540609749999998","4.267446000187504E7","554.7679800243751"
"9798","65012","65003","8","65011","175687","14261.788125","0.185403245625","4.2688721790000044E7","554.9533832700001"
"9799","65011","65002","9","65011","175696","14261.788125","0.185403245625","4.2702983578125045E7","555.1387865156252"
"9800","65011","65007","1","65008","175697","14261.13","0.18539468999999997","4.271724470812505E7","555.3241812056251"
"9801","65008","65000","8","65008","175705","14261.13","0.18539468999999997","4.273150583812505E7","555.5095758956251"
"9802","65008","65003","4","65007","175709","14260.910624999999","0.18539183812499996","4.274576674875005E7","555.6949677337501"
"9803","65007","65004","2","65006","175711","14260.69125","0.18538898625","4.276002744000005E7","555.8803567200001"
"9804","65006","65002","6","65008","175717","14261.13","0.18539468999999997","4.277428857000005E7","556.0657514100001"
"9805","65008","65007","6","65013","175723","14262.226874999998","0.18540894937499997","4.278855079687505E7","556.251160359375"
"9806","65013","65008","9","65017","175732","14263.104374999999","0.18542035687499997","4.280281390125005E7","556.4365807162501"
"9807","65017","65014","4","65018","175736","14263.32375","0.18542320874999998","4.2817077225000046E7","556.6220039250001"
"9808","65018","65011","5","65016","175741","14262.885000000002","0.185417505","4.2831340110000044E7","556.8074214300001"
"9809","65016","65012","1","65013","175742","14262.226874999998","0.18540894937499997","4.2845602336875044E7","556.992830379375"
"9810","65013","65004","3","65007","175745","14260.910624999999","0.18539183812499996","4.285986324750005E7","557.1782222175001"
"9811","65007","65006","3","65009","175748","14261.349375","0.185397541875","4.287412459687505E7","557.3636197593751"
"9812","65009","65002","6","65008","175754","14261.13","0.18539468999999997","4.288838572687505E7","557.549014449375"
"9813","65008","65001","7","65008","175761","14261.13","0.18539468999999997","4.2902646856875055E7","557.734409139375"
"9814","65008","65006","3","65009","175764","14261.349375","0.185397541875","4.291690820625006E7","557.91980668125"
"9815","65009","65007","2","65009","175766","14261.349375","0.185397541875","4.293116955562506E7","558.1052042231249"
"9816","65009","65005","1","65006","175767","14260.69125","0.18538898625","4.2945430246875055E7","558.290593209375"
"9817","65006","65002","4","65006","175771","14260.69125","0.18538898625","4.295969093812505E7","558.475982195625"
"9818","65006","64999","4","65003","175775","14260.033124999996","0.18538043062499995","4.297395097125005E7","558.6613626262499"
"9819","65003","64997","1","64998","175776","14258.936249999999","0.18536617124999996","4.298820990750005E7","558.8467287975"
"9820","64998","64993","9","65002","175785","14259.81375","0.18537757875","4.300246972125005E7","559.03210637625"
"9821","65002","64996","6","65002","175791","14259.81375","0.18537757875","4.301672953500005E7","559.217483955"
"9822","65002","64995","9","65004","175800","14260.2525","0.1853832825","4.3030989787500046E7","559.4028672375"
"9823","65004","64997","2","64999","175802","14259.155625000001","0.185369023125","4.304524894312505E7","559.588236260625"
"9824","64999","64994","6","65000","175808","14259.375","0.185371875","4.305950831812505E7","559.773608135625"
"9825","65000","64997","9","65006","175817","14260.69125","0.18538898625","4.307376900937504E7","559.958997121875"
"9826","65006","65000","9","65009","175826","14261.349375","0.185397541875","4.3088030358750045E7","560.14439466375"
"9827","65009","65004","4","65008","175830","14261.13","0.18539468999999997","4.310229148875005E7","560.3297893537499"
"9828","65008","65000","4","65004","175834","14260.2525","0.1853832825","4.3116551741250046E7","560.5151726362499"
"9829","65004","64996","5","65001","175839","14259.594375","0.185374726875","4.3130811335625045E7","560.7005473631249"
"9830","65001","64993","3","64996","175842","14258.497500000001","0.18536046750000001","4.314506983312505E7","560.8859078306249"
"9831","64996","64993","5","64998","175847","14258.936249999999","0.18536617124999996","4.315932876937505E7","561.0712740018749"
"9832","64998","64995","6","65001","175853","14259.594375","0.185374726875","4.317358836375005E7","561.25664872875"
"9833","65001","65000","7","65007","175860","14260.910624999999","0.18539183812499996","4.318784927437505E7","561.442040566875"
"9834","65007","65004","5","65009","175865","14261.349375","0.185397541875","4.320211062375005E7","561.62743810875"
"9835","65009","65007","6","65013","175871","14262.226874999998","0.18540894937499997","4.321637285062505E7","561.8128470581249"
"9836","65013","65006","4","65010","175875","14261.56875","0.18540039375","4.3230634419375055E7","561.9982474518749"
"9837","65010","65002","1","65003","175876","14260.033124999996","0.18538043062499995","4.324489445250005E7","562.1836278824999"
"9838","65003","64998","7","65005","175883","14260.471875","0.18538613437499998","4.325915492437505E7","562.3690140168749"
"9839","65005","65001","1","65002","175884","14259.81375","0.18537757875","4.327341473812505E7","562.5543915956249"
"9840","65002","64993","4","64997","175888","14258.716875","0.185363319375","4.328767345500005E7","562.7397549149999"
"9841","64997","64989","4","64993","175892","14257.839375","0.18535191187499997","4.330193129437505E7","562.925106826875"
"9842","64993","64992","8","65000","175900","14259.375","0.185371875","4.331619066937505E7","563.110478701875"
"9843","65000","64998","8","65006","175908","14260.69125","0.18538898625","4.333045136062504E7","563.295867688125"
"9844","65006","64997","3","65000","175911","14259.375","0.185371875","4.334471073562504E7","563.481239563125"
"9845","65000","64992","8","65000","175919","14259.375","0.185371875","4.335897011062504E7","563.666611438125"
"9846","65000","64996","5","65001","175924","14259.594375","0.185374726875","4.337322970500004E7","563.851986165"
"9847","65001","64992","8","65000","175932","14259.375","0.185371875","4.338748908000004E7","564.03735804"
"9848","65000","64993","2","64995","175934","14258.278125","0.185357615625","4.3401747358125046E7","564.2227156556249"
"9849","64995","64992","2","64994","175936","14258.05875","0.18535476374999998","4.341600541687505E7","564.4080704193749"
"9850","64994","64987","6","64993","175942","14257.839375","0.18535191187499997","4.3430263256250046E7","564.5934223312499"
"9851","64993","64985","5","64990","175947","14257.18125","0.18534335624999998","4.3444520437500045E7","564.7787656874999"
"9852","64990","64986","5","64991","175952","14257.400625000002","0.18534620812500002","4.345877783812504E7","564.9641118956249"
"9853","64991","64988","1","64989","175953","14256.961875","0.185340504375","4.347303480000004E7","565.1494523999999"
"9854","64989","64981","9","64990","175962","14257.18125","0.18534335624999998","4.348729198125004E7","565.3347957562498"
"9855","64990","64985","1","64986","175963","14256.30375","0.18533194874999998","4.350154828500004E7","565.5201277049998"
"9856","64986","64985","5","64990","175968","14257.18125","0.18534335624999998","4.351580546625004E7","565.7054710612498"
"9857","64990","64986","5","64991","175973","14257.400625000002","0.18534620812500002","4.353006286687504E7","565.8908172693748"
"9858","64991","64988","3","64991","175976","14257.400625000002","0.18534620812500002","4.3544320267500035E7","566.0761634774998"
"9859","64991","64987","8","64995","175984","14258.278125","0.185357615625","4.355857854562504E7","566.2615210931248"
"9860","64995","64992","1","64993","175985","14257.839375","0.18535191187499997","4.3572836385000035E7","566.4468730049998"
"9861","64993","64991","8","64999","175993","14259.155625000001","0.185369023125","4.3587095540625036E7","566.6322420281248"
"9862","64999","64994","1","64995","175994","14258.278125","0.185357615625","4.360135381875004E7","566.8175996437498"
"9863","64995","64994","6","65000","176000","14259.375","0.185371875","4.361561319375004E7","567.0029715187497"
"9864","65000","64997","9","65006","176009","14260.69125","0.18538898625","4.3629873885000035E7","567.1883605049998"
"9865","65006","65001","8","65009","176017","14261.349375","0.185397541875","4.364413523437504E7","567.3737580468747"
"9866","65009","65008","4","65012","176021","14262.0075","0.18540609749999998","4.365839724187504E7","567.5591641443748"
"9867","65012","65007","7","65014","176028","14262.44625","0.18541180125","4.367265968812504E7","567.7445759456248"
"9868","65014","65005","9","65014","176037","14262.44625","0.18541180125","4.3686922134375036E7","567.9299877468748"
"9869","65014","65010","8","65018","176045","14263.32375","0.18542320874999998","4.370118545812503E7","568.1154109556247"
"9870","65018","65011","1","65012","176046","14262.0075","0.18540609749999998","4.371544746562503E7","568.3008170531248"
"9871","65012","65009","4","65013","176050","14262.226874999998","0.18540894937499997","4.372970969250003E7","568.4862260024997"
"9872","65013","65006","9","65015","176059","14262.665625","0.185414653125","4.374397235812503E7","568.6716406556247"
"9873","65015","65006","1","65007","176060","14260.910624999999","0.18539183812499996","4.3758233268750034E7","568.8570324937498"
"9874","65007","65004","6","65010","176066","14261.56875","0.18540039375","4.3772494837500036E7","569.0424328874998"
"9875","65010","65007","5","65012","176071","14262.0075","0.18540609749999998","4.3786756845000036E7","569.2278389849998"
"9876","65012","65004","1","65005","176072","14260.471875","0.18538613437499998","4.380101731687503E7","569.4132251193748"
"9877","65005","65000","5","65005","176077","14260.471875","0.18538613437499998","4.381527778875003E7","569.5986112537498"
"9878","65005","64996","5","65001","176082","14259.594375","0.185374726875","4.382953738312503E7","569.7839859806248"
"9879","65001","64993","2","64995","176084","14258.278125","0.185357615625","4.384379566125003E7","569.9693435962498"
"9880","64995","64987","3","64990","176087","14257.18125","0.18534335624999998","4.385805284250003E7","570.1546869524998"
"9881","64990","64988","7","64995","176094","14258.278125","0.185357615625","4.3872311120625034E7","570.3400445681248"
"9882","64995","64990","8","64998","176102","14258.936249999999","0.18536617124999996","4.3886570056875035E7","570.5254107393748"
"9883","64998","64995","6","65001","176108","14259.594375","0.185374726875","4.3900829651250035E7","570.7107854662498"
"9884","65001","64999","9","65008","176117","14261.13","0.18539468999999997","4.391509078125004E7","570.8961801562498"
"9885","65008","65003","1","65004","176118","14260.2525","0.1853832825","4.3929351033750035E7","571.0815634387498"
"9886","65004","65001","6","65007","176124","14260.910624999999","0.18539183812499996","4.394361194437504E7","571.2669552768748"
"9887","65007","65002","7","65009","176131","14261.349375","0.185397541875","4.395787329375004E7","571.4523528187498"
"9888","65009","65007","6","65013","176137","14262.226874999998","0.18540894937499997","4.397213552062504E7","571.6377617681247"
"9889","65013","65007","2","65009","176139","14261.349375","0.185397541875","4.398639687000004E7","571.8231593099997"
"9890","65009","65003","2","65005","176141","14260.471875","0.18538613437499998","4.400065734187504E7","572.0085454443747"
"9891","65005","65003","5","65008","176146","14261.13","0.18539468999999997","4.401491847187504E7","572.1939401343747"
"9892","65008","64999","7","65006","176153","14260.69125","0.18538898625","4.402917916312504E7","572.3793291206247"
"9893","65006","65000","2","65002","176155","14259.81375","0.18537757875","4.404343897687504E7","572.5647066993747"
"9894","65002","64996","3","64999","176158","14259.155625000001","0.185369023125","4.405769813250004E7","572.7500757224997"
"9895","64999","64990","3","64993","176161","14257.839375","0.18535191187499997","4.4071955971875034E7","572.9354276343747"
"9896","64993","64989","7","64996","176168","14258.497500000001","0.18536046750000001","4.408621446937504E7","573.1207881018747"
"9897","64996","64989","6","64995","176174","14258.278125","0.185357615625","4.410047274750004E7","573.3061457174997"
"9898","64995","64990","7","64997","176181","14258.716875","0.185363319375","4.411473146437504E7","573.4915090368747"
"9899","64997","64995","3","64998","176184","14258.936249999999","0.18536617124999996","4.412899040062504E7","573.6768752081248"
"9900","64998","64992","2","64994","176186","14258.05875","0.18535476374999998","4.4143248459375046E7","573.8622299718747"
"9901","64994","64987","2","64989","176188","14256.961875","0.185340504375","4.4157505421250045E7","574.0475704762497"
"9902","64989","64985","2","64987","176190","14256.523125","0.185334800625","4.4171761944375046E7","574.2329052768747"
"9903","64987","64980","6","64986","176196","14256.30375","0.18533194874999998","4.418601824812505E7","574.4182372256247"
"9904","64986","64980","4","64984","176200","14255.865","0.18532624499999997","4.420027411312505E7","574.6035634706247"
"9905","64984","64979","4","64983","176204","14255.645625","0.18532339312499999","4.421452975875005E7","574.7888868637498"
"9906","64983","64978","3","64981","176207","14255.206875","0.18531768937499998","4.422878496562505E7","574.9742045531248"
"9907","64981","64977","6","64983","176213","14255.645625","0.18532339312499999","4.424304061125005E7","575.1595279462498"
"9908","64983","64975","6","64981","176219","14255.206875","0.18531768937499998","4.425729581812505E7","575.3448456356248"
"9909","64981","64976","7","64983","176226","14255.645625","0.18532339312499999","4.427155146375005E7","575.5301690287498"
"9910","64983","64975","5","64980","176231","14254.9875","0.18531483749999997","4.428580645125005E7","575.7154838662498"
"9911","64980","64975","1","64976","176232","14254.11","0.18530343","4.4300060561250046E7","575.9007872962497"
"9912","64976","64975","2","64977","176234","14254.329375","0.18530628187499998","4.4314314890625045E7","576.0860935781247"
"9913","64977","64972","2","64974","176236","14253.671250000001","0.18529772625000002","4.4328568561875045E7","576.2713913043748"
"9914","64974","64970","3","64973","176239","14253.451874999999","0.18529487437499997","4.434282201375005E7","576.4566861787498"
"9915","64973","64969","6","64975","176245","14253.890625","0.18530057812499998","4.435707590437505E7","576.6419867568748"
"9916","64975","64970","4","64974","176249","14253.671250000001","0.18529772625000002","4.437132957562505E7","576.8272844831248"
"9917","64974","64967","6","64973","176255","14253.451874999999","0.18529487437499997","4.438558302750005E7","577.0125793574998"
"9918","64973","64972","5","64977","176260","14254.329375","0.18530628187499998","4.439983735687505E7","577.1978856393748"
"9919","64977","64973","5","64978","176265","14254.548749999996","0.18530913374999994","4.4414091905625045E7","577.3831947731248"
"9920","64978","64974","8","64982","176273","14255.426249999999","0.18532054124999997","4.442834733187505E7","577.5685153143748"
"9921","64982","64980","2","64982","176275","14255.426249999999","0.18532054124999997","4.444260275812505E7","577.7538358556249"
"9922","64982","64974","3","64977","176278","14254.329375","0.18530628187499998","4.445685708750005E7","577.9391421374999"
"9923","64977","64975","1","64976","176279","14254.11","0.18530343","4.447111119750005E7","578.1244455674998"
"9924","64976","64975","5","64980","176284","14254.9875","0.18531483749999997","4.448536618500005E7","578.3097604049998"
"9925","64980","64979","1","64980","176285","14254.9875","0.18531483749999997","4.4499621172500044E7","578.4950752424998"
"9926","64980","64979","3","64982","176288","14255.426249999999","0.18532054124999997","4.451387659875005E7","578.6803957837498"
"9927","64982","64979","4","64983","176292","14255.645625","0.18532339312499999","4.452813224437505E7","578.8657191768748"
"9928","64983","64982","1","64983","176293","14255.645625","0.18532339312499999","4.454238789000005E7","579.0510425699998"
"9929","64983","64980","4","64984","176297","14255.865","0.18532624499999997","4.4556643755000055E7","579.2363688149999"
"9930","64984","64983","6","64989","176303","14256.961875","0.185340504375","4.4570900716875054E7","579.4217093193748"
"9931","64989","64987","4","64991","176307","14257.400625000002","0.18534620812500002","4.458515811750005E7","579.6070555274998"
"9932","64991","64987","1","64988","176308","14256.742499999998","0.18533765249999998","4.459941486000005E7","579.7923931799999"
"9933","64988","64981","3","64984","176311","14255.865","0.18532624499999997","4.461367072500005E7","579.9777194249999"
"9934","64984","64980","2","64982","176313","14255.426249999999","0.18532054124999997","4.462792615125006E7","580.1630399662499"
"9935","64982","64977","8","64985","176321","14256.084375","0.185329096875","4.464218223562506E7","580.3483690631249"
"9936","64985","64977","5","64982","176326","14255.426249999999","0.18532054124999997","4.465643766187506E7","580.5336896043749"
"9937","64982","64977","8","64985","176334","14256.084375","0.185329096875","4.467069374625006E7","580.7190187012499"
"9938","64985","64976","2","64978","176336","14254.548749999996","0.18530913374999994","4.468494829500006E7","580.9043278349999"
"9939","64978","64973","6","64979","176342","14254.768125","0.185311985625","4.469920306312506E7","581.0896398206249"
"9940","64979","64977","6","64983","176348","14255.645625","0.18532339312499999","4.471345870875006E7","581.27496321375"
"9941","64983","64976","1","64977","176349","14254.329375","0.18530628187499998","4.472771303812506E7","581.460269495625"
"9942","64977","64968","3","64971","176352","14253.013125000001","0.185289170625","4.474196605125006E7","581.6455586662499"
"9943","64971","64968","8","64976","176360","14254.11","0.18530343","4.475622016125006E7","581.8308620962499"
"9944","64976","64970","9","64979","176369","14254.768125","0.185311985625","4.477047492937506E7","582.016174081875"
"9945","64979","64972","2","64974","176371","14253.671250000001","0.18529772625000002","4.478472860062506E7","582.201471808125"
"9946","64974","64968","3","64971","176374","14253.013125000001","0.185289170625","4.479898161375006E7","582.38676097875"
"9947","64971","64970","8","64978","176382","14254.548749999996","0.18530913374999994","4.481323616250006E7","582.5720701125"
"9948","64978","64974","1","64975","176383","14253.890625","0.18530057812499998","4.482749005312506E7","582.757370690625"
"9949","64975","64973","2","64975","176385","14253.890625","0.18530057812499998","4.484174394375006E7","582.9426712687499"
"9950","64975","64973","3","64976","176388","14254.11","0.18530343","4.485599805375006E7","583.1279746987499"
"9951","64976","64968","1","64969","176389","14252.574375","0.185283466875","4.4870250628125064E7","583.3132581656249"
"9952","64969","64968","9","64977","176398","14254.329375","0.18530628187499998","4.488450495750006E7","583.4985644474999"
"9953","64977","64974","4","64978","176402","14254.548749999996","0.18530913374999994","4.489875950625006E7","583.6838735812499"
"9954","64978","64970","5","64975","176407","14253.890625","0.18530057812499998","4.491301339687506E7","583.8691741593749"
"9955","64975","64968","3","64971","176410","14253.013125000001","0.185289170625","4.492726641000006E7","584.0544633299999"
"9956","64971","64963","4","64967","176414","14252.135624999999","0.18527776312499997","4.494151854562506E7","584.2397410931248"
"9957","64967","64961","8","64969","176422","14252.574375","0.185283466875","4.4955771120000064E7","584.4250245599999"
"9958","64969","64964","1","64965","176423","14251.696875","0.185272059375","4.497002281687506E7","584.6102966193749"
"9959","64965","64959","5","64964","176428","14251.4775","0.1852692075","4.498427429437506E7","584.795565826875"
"9960","64964","64962","1","64963","176429","14251.258124999998","0.18526635562499996","4.499852555250006E7","584.9808321825"
"9961","64963","64955","7","64962","176436","14251.03875","0.18526350374999997","4.501277659125006E7","585.16609568625"
"9962","64962","64954","9","64963","176445","14251.258124999998","0.18526635562499996","4.502702784937506E7","585.351362041875"
"9963","64963","64962","2","64964","176447","14251.4775","0.1852692075","4.504127932687506E7","585.536631249375"
"9964","64964","64960","6","64966","176453","14251.916250000002","0.18527491125","4.505553124312506E7","585.7219061606249"
"9965","64966","64963","3","64966","176456","14251.916250000002","0.18527491125","4.506978315937506E7","585.9071810718749"
"9966","64966","64962","2","64964","176458","14251.4775","0.1852692075","4.5084034636875056E7","586.0924502793749"
"9967","64964","64955","7","64962","176465","14251.03875","0.18526350374999997","4.5098285675625056E7","586.2777137831249"
"9968","64962","64953","2","64955","176467","14249.503125","0.18524354062499998","4.511253517875005E7","586.46295732375"
"9969","64955","64947","9","64956","176476","14249.7225","0.1852463925","4.512678490125005E7","586.6482037162499"
"9970","64956","64952","2","64954","176478","14249.28375","0.18524068875","4.514103418500005E7","586.8334444049999"
"9971","64954","64948","3","64951","176481","14248.625625","0.185232133125","4.515528281062505E7","587.018676538125"
"9972","64951","64943","5","64948","176486","14247.967499999999","0.1852235775","4.516953077812505E7","587.203900115625"
"9973","64948","64942","8","64950","176494","14248.40625","0.18522928125","4.518377918437505E7","587.389129396875"
"9974","64950","64942","9","64951","176503","14248.625625","0.185232133125","4.519802781000005E7","587.57436153"
"9975","64951","64950","8","64958","176511","14250.16125","0.18525209624999997","4.521227797125005E7","587.75961362625"
"9976","64958","64953","9","64962","176520","14251.03875","0.18526350374999997","4.522652901000005E7","587.94487713"
"9977","64962","64959","5","64964","176525","14251.4775","0.1852692075","4.524078048750005E7","588.1301463375"
"9978","64964","64959","1","64960","176526","14250.6","0.1852578","4.525503108750005E7","588.3154041375001"
"9979","64960","64956","1","64957","176527","14249.941874999999","0.18524924437499998","4.5269281029375054E7","588.500653381875"
"9980","64957","64948","8","64956","176535","14249.7225","0.1852463925","4.528353075187505E7","588.685899774375"
"9981","64956","64952","8","64960","176543","14250.6","0.1852578","4.529778135187505E7","588.871157574375"
"9982","64960","64954","6","64960","176549","14250.6","0.1852578","4.531203195187505E7","589.0564153743751"
"9983","64960","64959","2","64961","176551","14250.819375","0.185260651875","4.5326282771250054E7","589.24167602625"
"9984","64961","64959","5","64964","176556","14251.4775","0.1852692075","4.534053424875005E7","589.4269452337501"
"9985","64964","64961","3","64964","176559","14251.4775","0.1852692075","4.535478572625005E7","589.6122144412501"
"9986","64964","64956","7","64963","176566","14251.258124999998","0.18526635562499996","4.536903698437505E7","589.7974807968751"
"9987","64963","64960","8","64968","176574","14252.355","0.18528061499999998","4.538328933937505E7","589.9827614118751"
"9988","64968","64960","6","64966","176580","14251.916250000002","0.18527491125","4.539754125562505E7","590.1680363231251"
"9989","64966","64957","6","64963","176586","14251.258124999998","0.18526635562499996","4.541179251375005E7","590.3533026787501"
"9990","64963","64955","9","64964","176595","14251.4775","0.1852692075","4.5426043991250046E7","590.5385718862501"
"9991","64964","64961","1","64962","176596","14251.03875","0.18526350374999997","4.5440295030000046E7","590.7238353900001"
"9992","64962","64958","4","64962","176600","14251.03875","0.18526350374999997","4.5454546068750046E7","590.9090988937501"
"9993","64962","64959","7","64966","176607","14251.916250000002","0.18527491125","4.5468797985000044E7","591.094373805"
"9994","64966","64959","7","64966","176614","14251.916250000002","0.18527491125","4.548304990125004E7","591.27964871625"
"9995","64966","64964","8","64972","176622","14253.2325","0.1852920225","4.5497303133750044E7","591.46494073875"
"9996","64972","64968","6","64974","176628","14253.671250000001","0.18529772625000002","4.5511556805000044E7","591.650238465"
"9997","64974","64973","4","64977","176632","14254.329375","0.18530628187499998","4.552581113437504E7","591.835544746875"
"9998","64977","64972","8","64980","176640","14254.9875","0.18531483749999997","4.554006612187504E7","592.020859584375"
"9999","64980","64979","1","64980","176641","14254.9875","0.18531483749999997","4.555432110937504E7","592.206174421875"
"10000","64980","64978","9","64987","176650","14256.523125","0.185334800625","4.556857763250004E7","592.3915092225"
"10001","64987","64979","6","64985","176656","14256.084375","0.185329096875","4.558283371687504E7","592.5768383193749"
"10002","64985","64978","3","64981","176659","14255.206875","0.18531768937499998","4.5597088923750035E7","592.7621560087499"
"10003","64981","64974","4","64978","176663","14254.548749999996","0.18530913374999994","4.561134347250003E7","592.9474651424999"
"10004","64978","64970","8","64978","176671","14254.548749999996","0.18530913374999994","4.562559802125003E7","593.13277427625"
"10005","64978","64976","7","64983","176678","14255.645625","0.18532339312499999","4.5639853666875035E7","593.318097669375"
"10006","64983","64974","9","64983","176687","14255.645625","0.18532339312499999","4.565410931250004E7","593.5034210625"
"10007","64983","64981","2","64983","176689","14255.645625","0.18532339312499999","4.566836495812504E7","593.688744455625"
"10008","64983","64978","3","64981","176692","14255.206875","0.18531768937499998","4.568262016500004E7","593.874062145"
"10009","64981","64974","1","64975","176693","14253.890625","0.18530057812499998","4.569687405562504E7","594.059362723125"
"10010","64975","64971","5","64976","176698","14254.11","0.18530343","4.5711128165625036E7","594.244666153125"
"10011","64976","64970","2","64972","176700","14253.2325","0.1852920225","4.572538139812504E7","594.429958175625"
"10012","64972","64967","6","64973","176706","14253.451874999999","0.18529487437499997","4.573963485000004E7","594.61525305"
"10013","64973","64967","8","64975","176714","14253.890625","0.18530057812499998","4.575388874062504E7","594.8005536281249"
"10014","64975","64972","3","64975","176717","14253.890625","0.18530057812499998","4.576814263125004E7","594.9858542062499"
"10015","64975","64971","6","64977","176723","14254.329375","0.18530628187499998","4.578239696062504E7","595.1711604881249"
"10016","64977","64972","9","64981","176732","14255.206875","0.18531768937499998","4.5796652167500034E7","595.3564781774999"
"10017","64981","64976","4","64980","176736","14254.9875","0.18531483749999997","4.581090715500003E7","595.5417930149998"
"10018","64980","64972","4","64976","176740","14254.11","0.18530343","4.582516126500003E7","595.7270964449998"
"10019","64976","64974","9","64983","176749","14255.645625","0.18532339312499999","4.583941691062503E7","595.9124198381248"
"10020","64983","64979","1","64980","176750","14254.9875","0.18531483749999997","4.585367189812503E7","596.0977346756248"
"10021","64980","64975","4","64979","176754","14254.768125","0.185311985625","4.586792666625003E7","596.2830466612498"
"10022","64979","64971","2","64973","176756","14253.451874999999","0.18529487437499997","4.588218011812503E7","596.4683415356249"
"10023","64973","64966","7","64973","176763","14253.451874999999","0.18529487437499997","4.589643357000003E7","596.6536364099999"
"10024","64973","64971","1","64972","176764","14253.2325","0.1852920225","4.591068680250003E7","596.8389284324999"
"10025","64972","64966","4","64970","176768","14252.79375","0.18528631874999998","4.5924939596250035E7","597.0242147512498"
"10026","64970","64968","5","64973","176773","14253.451874999999","0.18529487437499997","4.5939193048125036E7","597.2095096256248"
"10027","64973","64967","3","64970","176776","14252.79375","0.18528631874999998","4.595344584187504E7","597.3947959443748"
"10028","64970","64966","2","64968","176778","14252.355","0.18528061499999998","4.5967698196875036E7","597.5800765593748"
"10029","64968","64967","1","64968","176779","14252.355","0.18528061499999998","4.598195055187503E7","597.7653571743748"
"10030","64968","64961","6","64967","176785","14252.135624999999","0.18527776312499997","4.599620268750003E7","597.9506349374998"
"10031","64967","64959","9","64968","176794","14252.355","0.18528061499999998","4.601045504250003E7","598.1359155524998"
"10032","64968","64960","1","64961","176795","14250.819375","0.185260651875","4.602470586187503E7","598.3211762043748"
"10033","64961","64954","2","64956","176797","14249.7225","0.1852463925","4.6038955584375024E7","598.5064225968747"
"10034","64956","64952","9","64961","176806","14250.819375","0.185260651875","4.6053206403750025E7","598.6916832487497"
"10035","64961","64960","6","64966","176812","14251.916250000002","0.18527491125","4.606745832000002E7","598.8769581599996"
"10036","64966","64959","6","64965","176818","14251.696875","0.185272059375","4.608171001687502E7","599.0622302193747"
"10037","64965","64957","6","64963","176824","14251.258124999998","0.18526635562499996","4.609596127500002E7","599.2474965749997"
"10038","64963","64958","4","64962","176828","14251.03875","0.18526350374999997","4.611021231375002E7","599.4327600787497"
"10039","64962","64957","8","64965","176836","14251.696875","0.185272059375","4.612446401062502E7","599.6180321381247"
"10040","64965","64959","7","64966","176843","14251.916250000002","0.18527491125","4.613871592687502E7","599.8033070493747"
"10041","64966","64958","3","64961","176846","14250.819375","0.185260651875","4.615296674625002E7","599.9885677012496"
"10042","64961","64955","4","64959","176850","14250.380625","0.18525494812499999","4.616721712687502E7","600.1738226493746"
"10043","64959","64953","7","64960","176857","14250.6","0.1852578","4.618146772687502E7","600.3590804493747"
"10044","64960","64957","3","64960","176860","14250.6","0.1852578","4.619571832687502E7","600.5443382493747"
"10045","64960","64958","3","64961","176863","14250.819375","0.185260651875","4.6209969146250024E7","600.7295989012497"
"10046","64961","64960","9","64969","176872","14252.574375","0.185283466875","4.622422172062503E7","600.9148823681247"
"10047","64969","64963","1","64964","176873","14251.4775","0.1852692075","4.623847319812503E7","601.1001515756247"
"10048","64964","64958","9","64967","176882","14252.135624999999","0.18527776312499997","4.6252725333750024E7","601.2854293387497"
"10049","64967","64960","5","64965","176887","14251.696875","0.185272059375","4.626697703062502E7","601.4707013981248"
"10050","64965","64959","3","64962","176890","14251.03875","0.18526350374999997","4.628122806937502E7","601.6559649018748"
"10051","64962","64954","2","64956","176892","14249.7225","0.1852463925","4.629547779187502E7","601.8412112943747"
"10052","64956","64954","4","64958","176896","14250.16125","0.18525209624999997","4.630972795312502E7","602.0264633906247"
"10053","64958","64950","1","64951","176897","14248.625625","0.185232133125","4.632397657875002E7","602.2116955237498"
"10054","64951","64945","9","64954","176906","14249.28375","0.18524068875","4.633822586250002E7","602.3969362124998"
"10055","64954","64947","1","64948","176907","14247.967499999999","0.1852235775","4.635247383000002E7","602.5821597899998"
"10056","64948","64945","8","64953","176915","14249.064374999996","0.18523783687499995","4.636672289437502E7","602.7673976268748"
"10057","64953","64946","7","64953","176922","14249.064374999996","0.18523783687499995","4.638097195875002E7","602.9526354637497"
"10058","64953","64945","3","64948","176925","14247.967499999999","0.1852235775","4.639521992625002E7","603.1378590412497"
"10059","64948","64944","6","64950","176931","14248.40625","0.18522928125","4.640946833250002E7","603.3230883224998"
"10060","64950","64941","2","64943","176933","14246.870625","0.185209318125","4.6423715203125015E7","603.5082976406247"
"10061","64943","64940","9","64949","176942","14248.186875000001","0.185226429375","4.6437963390000015E7","603.6935240699997"
"10062","64949","64942","8","64950","176950","14248.40625","0.18522928125","4.6452211796250015E7","603.8787533512498"
"10063","64950","64949","3","64952","176953","14248.845","0.185234985","4.6466460641250014E7","604.0639883362497"
"10064","64952","64947","8","64955","176961","14249.503125","0.18524354062499998","4.648071014437501E7","604.2492318768748"
"10065","64955","64947","1","64948","176962","14247.967499999999","0.1852235775","4.649495811187501E7","604.4344554543748"
"10066","64948","64947","2","64949","176964","14248.186875000001","0.185226429375","4.650920629875001E7","604.6196818837498"
"10067","64949","64944","9","64953","176973","14249.064374999996","0.18523783687499995","4.652345536312501E7","604.8049197206248"
"10068","64953","64952","8","64960","176981","14250.6","0.1852578","4.653770596312501E7","604.9901775206248"
"10069","64960","64952","3","64955","176984","14249.503125","0.18524354062499998","4.655195546625001E7","605.1754210612498"
"10070","64955","64948","3","64951","176987","14248.625625","0.185232133125","4.656620409187501E7","605.3606531943749"
"10071","64951","64947","2","64949","176989","14248.186875000001","0.185226429375","4.658045227875001E7","605.5458796237499"
"10072","64949","64944","7","64951","176996","14248.625625","0.185232133125","4.659470090437501E7","605.731111756875"
"10073","64951","64946","2","64948","176998","14247.967499999999","0.1852235775","4.660894887187501E7","605.9163353343749"
"10074","64948","64943","4","64947","177002","14247.748125","0.185220725625","4.662319662000001E7","606.1015560599999"
"10075","64947","64943","9","64952","177011","14248.845","0.185234985","4.663744546500001E7","606.2867910449999"
"10076","64952","64947","2","64949","177013","14248.186875000001","0.185226429375","4.665169365187501E7","606.4720174743749"
"10077","64949","64943","5","64948","177018","14247.967499999999","0.1852235775","4.666594161937501E7","606.6572410518748"
"10078","64948","64940","9","64949","177027","14248.186875000001","0.185226429375","4.668018980625001E7","606.8424674812499"
"10079","64949","64941","6","64947","177033","14247.748125","0.185220725625","4.6694437554375015E7","607.0276882068748"
"10080","64947","64946","1","64947","177034","14247.748125","0.185220725625","4.670868530250002E7","607.2129089324998"
"10081","64947","64940","9","64949","177043","14248.186875000001","0.185226429375","4.672293348937502E7","607.3981353618748"
"10082","64949","64944","8","64952","177051","14248.845","0.185234985","4.673718233437502E7","607.5833703468747"
"10083","64952","64950","4","64954","177055","14249.28375","0.18524068875","4.6751431618125014E7","607.7686110356248"
"10084","64954","64947","7","64954","177062","14249.28375","0.18524068875","4.676568090187501E7","607.9538517243748"
"10085","64954","64949","8","64957","177070","14249.941874999999","0.18524924437499998","4.6779930843750015E7","608.1391009687497"
"10086","64957","64953","9","64962","177079","14251.03875","0.18526350374999997","4.6794181882500015E7","608.3243644724997"
"10087","64962","64954","1","64955","177080","14249.503125","0.18524354062499998","4.680843138562501E7","608.5096080131248"
"10088","64955","64951","8","64959","177088","14250.380625","0.18525494812499999","4.6822681766250014E7","608.6948629612498"
"10089","64959","64958","3","64961","177091","14250.819375","0.185260651875","4.6836932585625015E7","608.8801236131247"
"10090","64961","64953","2","64955","177093","14249.503125","0.18524354062499998","4.685118208875001E7","609.0653671537498"
"10091","64955","64951","6","64957","177099","14249.941874999999","0.18524924437499998","4.6865432030625015E7","609.2506163981247"
"10092","64957","64955","9","64964","177108","14251.4775","0.1852692075","4.6879683508125015E7","609.4358856056248"
"10093","64964","64959","6","64965","177114","14251.696875","0.185272059375","4.689393520500001E7","609.6211576649998"
"10094","64965","64956","3","64959","177117","14250.380625","0.18525494812499999","4.6908185585625015E7","609.8064126131248"
"10095","64959","64957","6","64963","177123","14251.258124999998","0.18526635562499996","4.6922436843750015E7","609.9916789687499"
"10096","64963","64957","7","64964","177130","14251.4775","0.1852692075","4.6936688321250014E7","610.1769481762499"
"10097","64964","64963","2","64965","177132","14251.696875","0.185272059375","4.695094001812501E7","610.3622202356249"
"10098","64965","64961","7","64968","177139","14252.355","0.18528061499999998","4.696519237312501E7","610.5475008506249"
"10099","64968","64962","7","64969","177146","14252.574375","0.185283466875","4.697944494750001E7","610.7327843175"
"10100","64969","64965","3","64968","177149","14252.355","0.18528061499999998","4.699369730250001E7","610.9180649325"
"10101","64968","64962","4","64966","177153","14251.916250000002","0.18527491125","4.700794921875001E7","611.10333984375"
"10102","64966","64959","9","64968","177162","14252.355","0.18528061499999998","4.7022201573750004E7","611.28862045875"
"10103","64968","64965","7","64972","177169","14253.2325","0.1852920225","4.7036454806250006E7","611.47391248125"
"10104","64972","64963","8","64971","177177","14253.013125000001","0.185289170625","4.705070781937501E7","611.6592016518749"
"10105","64971","64969","9","64978","177186","14254.548749999996","0.18530913374999994","4.706496236812501E7","611.844510785625"
"10106","64978","64973","4","64977","177190","14254.329375","0.18530628187499998","4.7079216697500005E7","612.0298170675"
"10107","64977","64974","6","64980","177196","14254.9875","0.18531483749999997","4.7093471685E7","612.2151319049999"
"10108","64980","64972","5","64977","177201","14254.329375","0.18530628187499998","4.7107726014375E7","612.4004381868749"
"10109","64977","64972","7","64979","177208","14254.768125","0.185311985625","4.71219807825E7","612.5857501725"
"10110","64979","64974","1","64975","177209","14253.890625","0.18530057812499998","4.7136234673125E7","612.7710507506249"
"10111","64975","64972","4","64976","177213","14254.11","0.18530343","4.7150488783125E7","612.9563541806249"
"10112","64976","64967","3","64970","177216","14252.79375","0.18528631874999998","4.7164741576875E7","613.1416404993748"
"10113","64970","64964","9","64973","177225","14253.451874999999","0.18529487437499997","4.717899502875E7","613.3269353737498"
"10114","64973","64966","2","64968","177227","14252.355","0.18528061499999998","4.719324738375E7","613.5122159887499"
"10115","64968","64963","5","64968","177232","14252.355","0.18528061499999998","4.7207499738749996E7","613.6974966037499"
"10116","64968","64967","1","64968","177233","14252.355","0.18528061499999998","4.722175209374999E7","613.8827772187499"
"10117","64968","64965","7","64972","177240","14253.2325","0.1852920225","4.7236005326249994E7","614.0680692412499"
"10118","64972","64968","2","64970","177242","14252.79375","0.18528631874999998","4.725025812E7","614.2533555599998"
"10119","64970","64962","3","64965","177245","14251.696875","0.185272059375","4.7264509816874996E7","614.4386276193749"
"10120","64965","64963","3","64966","177248","14251.916250000002","0.18527491125","4.7278761733124994E7","614.6239025306248"
"10121","64966","64964","2","64966","177250","14251.916250000002","0.18527491125","4.729301364937499E7","614.8091774418748"
"10122","64966","64961","3","64964","177253","14251.4775","0.1852692075","4.730726512687499E7","614.9944466493748"
"10123","64964","64960","5","64965","177258","14251.696875","0.185272059375","4.732151682374999E7","615.1797187087499"
"10124","64965","64956","2","64958","177260","14250.16125","0.18525209624999997","4.733576698499999E7","615.3649708049999"
"10125","64958","64957","2","64959","177262","14250.380625","0.18525494812499999","4.7350017365624994E7","615.5502257531249"
"10126","64959","64951","2","64953","177264","14249.064374999996","0.18523783687499995","4.736426642999999E7","615.7354635899999"
"10127","64953","64944","9","64953","177273","14249.064374999996","0.18523783687499995","4.737851549437499E7","615.9207014268749"
"10128","64953","64946","9","64955","177282","14249.503125","0.18524354062499998","4.739276499749999E7","616.1059449674999"
"10129","64955","64953","4","64957","177286","14249.941874999999","0.18524924437499998","4.740701493937499E7","616.2911942118749"
"10130","64957","64949","5","64954","177291","14249.28375","0.18524068875","4.742126422312499E7","616.4764349006249"
"10131","64954","64947","5","64952","177296","14248.845","0.185234985","4.743551306812499E7","616.6616698856249"
"10132","64952","64951","2","64953","177298","14249.064374999996","0.18523783687499995","4.7449762132499985E7","616.8469077224999"
"10133","64953","64947","1","64948","177299","14247.967499999999","0.1852235775","4.746401009999999E7","617.0321312999998"
"10134","64948","64944","1","64945","177300","14247.309375","0.185215021875","4.747825740937499E7","617.2173463218749"
"10135","64945","64939","1","64940","177301","14246.2125","0.18520076249999998","4.749250362187499E7","617.4025470843749"
"10136","64940","64935","5","64940","177306","14246.2125","0.18520076249999998","4.750674983437499E7","617.5877478468749"
"10137","64940","64931","1","64932","177307","14244.457499999999","0.18517794749999997","4.752099429187499E7","617.7729257943749"
"10138","64932","64927","3","64930","177310","14244.01875","0.18517224375","4.753523831062499E7","617.958098038125"
"10139","64930","64928","5","64933","177315","14244.676875","0.18518079937499998","4.754948298749999E7","618.1432788374999"
"10140","64933","64925","3","64928","177318","14243.579999999996","0.18516653999999994","4.756372656749999E7","618.3284453774999"
"10141","64928","64924","3","64927","177321","14243.360625","0.18516368812499998","4.757796992812499E7","618.5136090656249"
"10142","64927","64925","3","64928","177324","14243.579999999996","0.18516653999999994","4.7592213508124985E7","618.6987756056249"
"10143","64928","64919","2","64921","177326","14242.044375000001","0.185146576875","4.760645555249999E7","618.8839221824999"
"10144","64921","64915","1","64916","177327","14240.947500000002","0.1851323175","4.7620696499999985E7","619.0690544999999"
"10145","64916","64911","1","64912","177328","14240.07","0.18512090999999997","4.7634936569999985E7","619.2541754099999"
"10146","64912","64903","2","64905","177330","14238.534375","0.18510094687499998","4.764917510437498E7","619.4392763568749"
"10147","64905","64904","9","64913","177339","14240.289374999998","0.18512376187499996","4.766341539374998E7","619.6244001187499"
"10148","64913","64911","6","64917","177345","14241.166874999999","0.18513516937499996","4.767765656062498E7","619.809535288125"
"10149","64917","64909","7","64916","177352","14240.947500000002","0.1851323175","4.769189750812498E7","619.994667605625"
"10150","64916","64914","9","64923","177361","14242.483124999999","0.18515228062499997","4.770613999124998E7","620.1798198862499"
"10151","64923","64915","1","64916","177362","14240.947500000002","0.1851323175","4.772038093874998E7","620.3649522037499"
"10152","64916","64911","4","64915","177366","14240.728125","0.185129465625","4.7734621666874975E7","620.5500816693749"
"10153","64915","64907","6","64913","177372","14240.289374999998","0.18512376187499996","4.7748861956249975E7","620.7352054312499"
"10154","64913","64907","4","64911","177376","14239.850625","0.18511805812499998","4.7763101806874976E7","620.9203234893749"
"10155","64911","64902","1","64903","177377","14238.095624999996","0.18509524312499995","4.7777339902499974E7","621.1054187325"
"10156","64903","64901","9","64910","177386","14239.63125","0.18511520625","4.7791579533749975E7","621.29053393875"
"10157","64910","64909","4","64913","177390","14240.289374999998","0.18512376187499996","4.7805819823124975E7","621.475657700625"
"10158","64913","64910","5","64915","177395","14240.728125","0.185129465625","4.782006055124997E7","621.66078716625"
"10159","64915","64909","5","64914","177400","14240.50875","0.18512661375","4.783430105999997E7","621.8459137799999"
"10160","64914","64906","6","64912","177406","14240.07","0.18512090999999997","4.784854112999997E7","622.03103469"
"10161","64912","64907","7","64914","177413","14240.50875","0.18512661375","4.786278163874997E7","622.2161613037499"
"10162","64914","64905","3","64908","177416","14239.1925","0.18510950249999997","4.7877020831249975E7","622.40127080625"
"10163","64908","64904","7","64911","177423","14239.850625","0.18511805812499998","4.7891260681874976E7","622.586388864375"
"10164","64911","64906","3","64909","177426","14239.411875","0.18511235437499998","4.790550009374998E7","622.7715012187499"
"10165","64909","64903","8","64911","177434","14239.850625","0.18511805812499998","4.791973994437498E7","622.9566192768749"
"10166","64911","64904","5","64909","177439","14239.411875","0.18511235437499998","4.793397935624998E7","623.1417316312499"
"10167","64909","64907","7","64914","177446","14240.50875","0.18512661375","4.794821986499998E7","623.3268582449998"
"10168","64914","64912","4","64916","177450","14240.947500000002","0.1851323175","4.796246081249998E7","623.5119905624998"
"10169","64916","64908","5","64913","177455","14240.289374999998","0.18512376187499996","4.797670110187498E7","623.6971143243749"
"10170","64913","64911","5","64916","177460","14240.947500000002","0.1851323175","4.7990942049374975E7","623.8822466418749"
"10171","64916","64914","4","64918","177464","14241.38625","0.18513802124999998","4.800518343562497E7","624.0673846631249"
"10172","64918","64915","1","64916","177465","14240.947500000002","0.1851323175","4.801942438312497E7","624.2525169806249"
"10173","64916","64912","9","64921","177474","14242.044375000001","0.185146576875","4.803366642749997E7","624.4376635575"
"10174","64921","64913","4","64917","177478","14241.166874999999","0.18513516937499996","4.804790759437497E7","624.622798726875"
"10175","64917","64915","1","64916","177479","14240.947500000002","0.1851323175","4.806214854187497E7","624.807931044375"
"10176","64916","64915","3","64918","177482","14241.38625","0.18513802124999998","4.8076389928124964E7","624.993069065625"
"10177","64918","64915","8","64923","177490","14242.483124999999","0.18515228062499997","4.8090632411249965E7","625.17822134625"
"10178","64923","64922","6","64928","177496","14243.579999999996","0.18516653999999994","4.810487599124996E7","625.3633878862499"
"10179","64928","64922","8","64930","177504","14244.01875","0.18517224375","4.811912000999996E7","625.5485601299999"
"10180","64930","64925","2","64927","177506","14243.360625","0.18516368812499998","4.813336337062496E7","625.733723818125"
"10181","64927","64922","6","64928","177512","14243.579999999996","0.18516653999999994","4.814760695062496E7","625.9188903581249"
"10182","64928","64921","3","64924","177515","14242.702500000001","0.1851551325","4.816184965312496E7","626.1040454906249"
"10183","64924","64915","2","64917","177517","14241.166874999999","0.18513516937499996","4.8176090819999956E7","626.2891806599999"
"10184","64917","64911","1","64912","177518","14240.07","0.18512090999999997","4.8190330889999956E7","626.47430157"
"10185","64912","64910","7","64917","177525","14241.166874999999","0.18513516937499996","4.820457205687495E7","626.659436739375"
"10186","64917","64914","2","64916","177527","14240.947500000002","0.1851323175","4.821881300437495E7","626.844569056875"
"10187","64916","64909","1","64910","177528","14239.63125","0.18511520625","4.823305263562495E7","627.029684263125"
"10188","64910","64901","1","64902","177529","14237.87625","0.18509239125","4.824729051187495E7","627.214776654375"
"10189","64902","64893","4","64897","177533","14236.779375","0.185078131875","4.826152729124995E7","627.39985478625"
"10190","64897","64892","7","64899","177540","14237.218125000001","0.185083835625","4.8275764509374954E7","627.584938621875"
"10191","64899","64892","5","64897","177545","14236.779375","0.185078131875","4.8290001288749956E7","627.77001675375"
"10192","64897","64888","7","64895","177552","14236.340625","0.185072428125","4.830423762937496E7","627.955089181875"
"10193","64895","64891","2","64893","177554","14235.901875","0.185066724375","4.8318473531249955E7","628.14015590625"
"10194","64893","64887","1","64888","177555","14234.804999999998","0.18505246499999997","4.8332708336249955E7","628.32520837125"
"10195","64888","64883","4","64887","177559","14234.585625","0.18504961312499998","4.8346942921874955E7","628.510257984375"
"10196","64887","64885","1","64886","177560","14234.36625","0.18504676124999997","4.8361177288124956E7","628.695304745625"
"10197","64886","64882","9","64891","177569","14235.463125000002","0.18506102062500002","4.8375412751249954E7","628.88036576625"
"10198","64891","64883","6","64889","177575","14235.024375","0.185055316875","4.838964777562495E7","629.065421083125"
"10199","64889","64880","6","64886","177581","14234.36625","0.18504676124999997","4.8403882141874954E7","629.250467844375"
"10200","64886","64879","4","64883","177585","14233.708125","0.18503820562499998","4.841811584999996E7","629.43550605"
"10201","64883","64877","3","64880","177588","14233.05","0.18502965","4.8432348899999954E7","629.6205357"
"10202","64880","64875","7","64882","177595","14233.488749999999","0.18503535374999996","4.844658238874996E7","629.80557105375"
"10203","64882","64879","8","64887","177603","14234.585625","0.18504961312499998","4.846081697437496E7","629.990620666875"
"10204","64887","64884","6","64890","177609","14235.24375","0.18505816874999997","4.8475052218124956E7","630.1756788356249"
"10205","64890","64888","9","64897","177618","14236.779375","0.185078131875","4.848928899749996E7","630.3607569674999"
"10206","64897","64889","4","64893","177622","14235.901875","0.185066724375","4.8503524899374954E7","630.545823691875"
"10207","64893","64887","3","64890","177625","14235.24375","0.18505816874999997","4.851776014312495E7","630.7308818606249"
"10208","64890","64888","4","64892","177629","14235.682499999999","0.18506387249999998","4.853199582562495E7","630.9159457331249"
"10209","64892","64886","9","64895","177638","14236.340625","0.185072428125","4.854623216624995E7","631.1010181612498"
"10210","64895","64891","4","64895","177642","14236.340625","0.185072428125","4.8560468506874956E7","631.2860905893748"
"10211","64895","64887","6","64893","177648","14235.901875","0.185066724375","4.857470440874995E7","631.4711573137498"
"10212","64893","64888","3","64891","177651","14235.463125000002","0.18506102062500002","4.858893987187495E7","631.6562183343748"
"10213","64891","64890","3","64893","177654","14235.901875","0.185066724375","4.860317577374995E7","631.8412850587498"
"10214","64893","64885","3","64888","177657","14234.804999999998","0.18505246499999997","4.861741057874995E7","632.0263375237498"
"10215","64888","64882","8","64890","177665","14235.24375","0.18505816874999997","4.8631645822499946E7","632.2113956924998"
"10216","64890","64888","4","64892","177669","14235.682499999999","0.18506387249999998","4.864588150499994E7","632.3964595649998"
"10217","64892","64885","6","64891","177675","14235.463125000002","0.18506102062500002","4.866011696812494E7","632.5815205856247"
"10218","64891","64887","2","64889","177677","14235.024375","0.185055316875","4.867435199249994E7","632.7665759024998"
"10219","64889","64885","1","64886","177678","14234.36625","0.18504676124999997","4.868858635874994E7","632.9516226637497"
"10220","64886","64879","1","64880","177679","14233.05","0.18502965","4.870281940874994E7","633.1366523137498"
"10221","64880","64876","2","64878","177681","14232.611249999996","0.18502394624999993","4.8717052019999936E7","633.3216762599998"
"10222","64878","64876","4","64880","177685","14233.05","0.18502965","4.873128506999993E7","633.5067059099998"
"10223","64880","64874","3","64877","177688","14232.391875","0.18502109437499997","4.874551746187493E7","633.6917270043748"
"10224","64877","64875","9","64884","177697","14233.9275","0.1850410575","4.8759751389374934E7","633.8767680618748"
"10225","64884","64876","9","64885","177706","14234.146875","0.18504390937499998","4.8773985536249936E7","634.0618119712499"
"10226","64885","64881","1","64882","177707","14233.488749999999","0.18503535374999996","4.878821902499994E7","634.2468473249999"
"10227","64882","64880","1","64881","177708","14233.269375","0.18503250187499998","4.8802452294374935E7","634.4318798268748"
"10228","64881","64878","5","64883","177713","14233.708125","0.18503820562499998","4.881668600249994E7","634.6169180324998"
"10229","64883","64881","1","64882","177714","14233.488749999999","0.18503535374999996","4.883091949124994E7","634.8019533862498"
"10230","64882","64876","8","64884","177722","14233.9275","0.1850410575","4.884515341874994E7","634.9869944437498"
"10231","64884","64876","2","64878","177724","14232.611249999996","0.18502394624999993","4.885938602999994E7","635.1720183899998"
"10232","64878","64877","9","64886","177733","14234.36625","0.18504676124999997","4.887362039624994E7","635.3570651512498"
"10233","64886","64878","6","64884","177739","14233.9275","0.1850410575","4.8887854323749945E7","635.5421062087498"
"10234","64884","64877","2","64879","177741","14232.830625","0.185026798125","4.890208715437494E7","635.7271330068749"
"10235","64879","64874","8","64882","177749","14233.488749999999","0.18503535374999996","4.8916320643124945E7","635.9121683606248"
"10236","64882","64878","1","64879","177750","14232.830625","0.185026798125","4.893055347374994E7","636.0971951587499"
"10237","64879","64876","8","64884","177758","14233.9275","0.1850410575","4.8944787401249945E7","636.2822362162499"
"10238","64884","64878","3","64881","177761","14233.269375","0.18503250187499998","4.895902067062494E7","636.4672687181248"
"10239","64881","64875","9","64884","177770","14233.9275","0.1850410575","4.897325459812494E7","636.6523097756249"
"10240","64884","64881","7","64888","177777","14234.804999999998","0.18505246499999997","4.898748940312494E7","636.8373622406249"
"10241","64888","64880","7","64887","177784","14234.585625","0.18504961312499998","4.900172398874994E7","637.0224118537499"
"10242","64887","64881","7","64888","177791","14234.804999999998","0.18505246499999997","4.901595879374994E7","637.2074643187499"
"10243","64888","64887","6","64893","177797","14235.901875","0.185066724375","4.903019469562494E7","637.3925310431249"
"10244","64893","64891","4","64895","177801","14236.340625","0.185072428125","4.904443103624994E7","637.5776034712499"
"10245","64895","64891","8","64899","177809","14237.218125000001","0.185083835625","4.905866825437494E7","637.7626873068749"
"10246","64899","64898","2","64900","177811","14237.4375","0.18508668749999999","4.907290569187494E7","637.9477739943749"
"10247","64900","64895","7","64902","177818","14237.87625","0.18509239125","4.908714356812494E7","638.1328663856249"
"10248","64902","64901","4","64905","177822","14238.534375","0.18510094687499998","4.910138210249994E7","638.3179673324998"
"10249","64905","64903","7","64910","177829","14239.63125","0.18511520625","4.911562173374994E7","638.5030825387498"
"10250","64910","64901","2","64903","177831","14238.095624999996","0.18509524312499995","4.912985982937494E7","638.6881777818749"
"10251","64903","64898","4","64902","177835","14237.87625","0.18509239125","4.914409770562494E7","638.8732701731249"
"10252","64902","64894","1","64895","177836","14236.340625","0.185072428125","4.915833404624994E7","639.0583426012498"
"10253","64895","64891","6","64897","177842","14236.779375","0.185078131875","4.917257082562494E7","639.2434207331248"
"10254","64897","64893","8","64901","177850","14237.656875","0.185089539375","4.918680848249994E7","639.4285102724998"
"10255","64901","64894","1","64895","177851","14236.340625","0.185072428125","4.9201044823124945E7","639.6135827006248"
"10256","64895","64886","7","64893","177858","14235.901875","0.185066724375","4.921528072499994E7","639.7986494249998"
"10257","64893","64892","3","64895","177861","14236.340625","0.185072428125","4.9229517065624945E7","639.9837218531247"
"10258","64895","64893","8","64901","177869","14237.656875","0.185089539375","4.9243754722499944E7","640.1688113924997"
"10259","64901","64894","5","64899","177874","14237.218125000001","0.185083835625","4.9257991940624945E7","640.3538952281248"
"10260","64899","64892","9","64901","177883","14237.656875","0.185089539375","4.9272229597499944E7","640.5389847674998"
"10261","64901","64892","2","64894","177885","14236.12125","0.18506957624999998","4.928646571874995E7","640.7240543437498"
"10262","64894","64892","5","64897","177890","14236.779375","0.185078131875","4.930070249812495E7","640.9091324756248"
"10263","64897","64891","7","64898","177897","14236.998749999999","0.18508098374999998","4.931493949687495E7","641.0942134593748"
"10264","64898","64895","6","64901","177903","14237.656875","0.185089539375","4.932917715374995E7","641.2793029987498"
"10265","64901","64900","8","64908","177911","14239.1925","0.18510950249999997","4.934341634624995E7","641.4644125012499"
"10266","64908","64903","8","64911","177919","14239.850625","0.18511805812499998","4.9357656196874954E7","641.6495305593749"
"10267","64911","64903","8","64911","177927","14239.850625","0.18511805812499998","4.9371896047499955E7","641.8346486174999"
"10268","64911","64904","1","64905","177928","14238.534375","0.18510094687499998","4.938613458187495E7","642.0197495643748"
"10269","64905","64903","9","64912","177937","14240.07","0.18512090999999997","4.940037465187495E7","642.2048704743748"
"10270","64912","64904","9","64913","177946","14240.289374999998","0.18512376187499996","4.941461494124995E7","642.3899942362499"
"10271","64913","64912","1","64913","177947","14240.289374999998","0.18512376187499996","4.942885523062495E7","642.5751179981249"
"10272","64913","64910","4","64914","177951","14240.50875","0.18512661375","4.944309573937495E7","642.7602446118749"
"10273","64914","64907","9","64916","177960","14240.947500000002","0.1851323175","4.945733668687495E7","642.9453769293749"
"10274","64916","64910","7","64917","177967","14241.166874999999","0.18513516937499996","4.9471577853749946E7","643.1305120987499"
"10275","64917","64913","3","64916","177970","14240.947500000002","0.1851323175","4.948581880124994E7","643.3156444162499"
"10276","64916","64909","4","64913","177974","14240.289374999998","0.18512376187499996","4.950005909062494E7","643.500768178125"
"10277","64913","64904","7","64911","177981","14239.850625","0.18511805812499998","4.9514298941249944E7","643.68588623625"
"10278","64911","64910","7","64917","177988","14241.166874999999","0.18513516937499996","4.952854010812494E7","643.871021405625"
"10279","64917","64911","9","64920","177997","14241.825","0.185143725","4.9542781933124945E7","644.056165130625"
"10280","64920","64914","5","64919","178002","14241.605625","0.185140873125","4.955702353874995E7","644.24130600375"
"10281","64919","64912","1","64913","178003","14240.289374999998","0.18512376187499996","4.957126382812495E7","644.426429765625"
"10282","64913","64906","1","64907","178004","14238.973124999999","0.18510665062499998","4.958550280124995E7","644.61153641625"
"10283","64907","64899","7","64906","178011","14238.75375","0.18510379875","4.959974155499995E7","644.796640215"
"10284","64906","64905","3","64908","178014","14239.1925","0.18510950249999997","4.961398074749995E7","644.9817497175001"
"10285","64908","64899","3","64902","178017","14237.87625","0.18509239125","4.962821862374995E7","645.1668421087501"
"10286","64902","64894","5","64899","178022","14237.218125000001","0.185083835625","4.964245584187495E7","645.3519259443751"
"10287","64899","64894","9","64903","178031","14238.095624999996","0.18509524312499995","4.965669393749995E7","645.5370211875002"
"10288","64903","64901","3","64904","178034","14238.315","0.185098095","4.9670932252499945E7","645.7221192825001"
"10289","64904","64899","6","64905","178040","14238.534375","0.18510094687499998","4.968517078687494E7","645.9072202293751"
"10290","64905","64904","4","64908","178044","14239.1925","0.18510950249999997","4.9699409979374945E7","646.0923297318751"
"10291","64908","64901","5","64906","178049","14238.75375","0.18510379875","4.971364873312494E7","646.2774335306251"
"10292","64906","64900","9","64909","178058","14239.411875","0.18511235437499998","4.972788814499994E7","646.462545885"
"10293","64909","64902","8","64910","178066","14239.63125","0.18511520625","4.9742127776249945E7","646.64766109125"
"10294","64910","64903","4","64907","178070","14238.973124999999","0.18510665062499998","4.975636674937495E7","646.832767741875"
"10295","64907","64898","8","64906","178078","14238.75375","0.18510379875","4.9770605503124945E7","647.017871540625"
"10296","64906","64899","9","64908","178087","14239.1925","0.18510950249999997","4.978484469562495E7","647.2029810431251"
"10297","64908","64901","4","64905","178091","14238.534375","0.18510094687499998","4.9799083229999945E7","647.38808199"
"10298","64905","64901","5","64906","178096","14238.75375","0.18510379875","4.981332198374994E7","647.57318578875"
"10299","64906","64902","3","64905","178099","14238.534375","0.18510094687499998","4.982756051812494E7","647.758286735625"
"10300","64905","64900","3","64903","178102","14238.095624999996","0.18509524312499995","4.9841798613749936E7","647.94338197875"
"10301","64903","64898","6","64904","178108","14238.315","0.185098095","4.9856036928749934E7","648.12848007375"
"10302","64904","64901","9","64910","178117","14239.63125","0.18511520625","4.9870276559999935E7","648.31359528"
"10303","64910","64908","8","64916","178125","14240.947500000002","0.1851323175","4.988451750749993E7","648.4987275975"
"10304","64916","64913","4","64917","178129","14241.166874999999","0.18513516937499996","4.989875867437493E7","648.683862766875"
"10305","64917","64914","1","64915","178130","14240.728125","0.185129465625","4.991299940249993E7","648.8689922325"
"10306","64915","64914","9","64923","178139","14242.483124999999","0.18515228062499997","4.992724188562493E7","649.0541445131249"
"10307","64923","64915","6","64921","178145","14242.044375000001","0.185146576875","4.994148392999993E7","649.2392910899999"
"10308","64921","64913","7","64920","178152","14241.825","0.185143725","4.9955725754999936E7","649.4244348149999"
"10309","64920","64912","6","64918","178158","14241.38625","0.18513802124999998","4.996996714124993E7","649.60957283625"
"10310","64918","64909","7","64916","178165","14240.947500000002","0.1851323175","4.998420808874993E7","649.79470515375"
"10311","64916","64912","6","64918","178171","14241.38625","0.18513802124999998","4.999844947499993E7","649.979843175"
"10312","64918","64911","4","64915","178175","14240.728125","0.185129465625","5.0012690203124925E7","650.164972640625"
"10313","64915","64914","5","64919","178180","14241.605625","0.185140873125","5.002693180874993E7","650.35011351375"
"10314","64919","64918","2","64920","178182","14241.825","0.185143725","5.004117363374993E7","650.53525723875"
"10315","64920","64911","1","64912","178183","14240.07","0.18512090999999997","5.005541370374993E7","650.72037814875"
"10316","64912","64910","1","64911","178184","14239.850625","0.18511805812499998","5.006965355437493E7","650.905496206875"
"10317","64911","64905","1","64906","178185","14238.75375","0.18510379875","5.008389230812493E7","651.090600005625"
"10318","64906","64903","8","64911","178193","14239.850625","0.18511805812499998","5.009813215874993E7","651.27571806375"
"10319","64911","64905","2","64907","178195","14238.973124999999","0.18510665062499998","5.0112371131874934E7","651.460824714375"
"10320","64907","64899","1","64900","178196","14237.4375","0.18508668749999999","5.0126608569374934E7","651.645911401875"
"10321","64900","64896","3","64899","178199","14237.218125000001","0.185083835625","5.0140845787499934E7","651.8309952375"
"10322","64899","64895","8","64903","178207","14238.095624999996","0.18509524312499995","5.015508388312493E7","652.016090480625"
"10323","64903","64899","6","64905","178213","14238.534375","0.18510094687499998","5.016932241749993E7","652.2011914275"
"10324","64905","64903","8","64911","178221","14239.850625","0.18511805812499998","5.018356226812493E7","652.386309485625"
"10325","64911","64909","6","64915","178227","14240.728125","0.185129465625","5.019780299624993E7","652.57143895125"
"10326","64915","64909","3","64912","178230","14240.07","0.18512090999999997","5.021204306624993E7","652.75655986125"
"10327","64912","64911","5","64916","178235","14240.947500000002","0.1851323175","5.022628401374993E7","652.94169217875"
"10328","64916","64909","9","64918","178244","14241.38625","0.18513802124999998","5.0240525399999924E7","653.1268302000001"
"10329","64918","64916","4","64920","178248","14241.825","0.185143725","5.025476722499993E7","653.3119739250001"
"10330","64920","64913","6","64919","178254","14241.605625","0.185140873125","5.026900883062493E7","653.497114798125"
"10331","64919","64916","3","64919","178257","14241.605625","0.185140873125","5.0283250436249934E7","653.68225567125"
"10332","64919","64918","6","64924","178263","14242.702500000001","0.1851551325","5.0297493138749935E7","653.86741080375"
"10333","64924","64918","3","64921","178266","14242.044375000001","0.185146576875","5.031173518312494E7","654.052557380625"
"10334","64921","64920","1","64921","178267","14242.044375000001","0.185146576875","5.032597722749994E7","654.2377039575"
"10335","64921","64919","1","64920","178268","14241.825","0.185143725","5.034021905249994E7","654.4228476825"
"10336","64920","64916","9","64925","178277","14242.921875","0.185157984375","5.035446197437494E7","654.608005666875"
"10337","64925","64924","8","64932","178285","14244.457499999999","0.18517794749999997","5.0368706431874946E7","654.793183614375"
"10338","64932","64926","9","64935","178294","14245.115625","0.18518650312499998","5.038295154749995E7","654.9783701175"
"10339","64935","64933","2","64935","178296","14245.115625","0.18518650312499998","5.039719666312495E7","655.1635566206251"
"10340","64935","64931","8","64939","178304","14245.993125","0.185197910625","5.041144265624995E7","655.34875453125"
"10341","64939","64936","8","64944","178312","14247.09","0.18521216999999998","5.042568974624995E7","655.53396670125"
"10342","64944","64943","6","64949","178318","14248.186875000001","0.185226429375","5.043993793312495E7","655.7191931306251"
"10343","64949","64945","6","64951","178324","14248.625625","0.185232133125","5.045418655874995E7","655.9044252637501"
"10344","64951","64946","1","64947","178325","14247.748125","0.185220725625","5.046843430687495E7","656.0896459893751"
"10345","64947","64944","9","64953","178334","14249.064374999996","0.18523783687499995","5.048268337124995E7","656.2748838262501"
"10346","64953","64946","2","64948","178336","14247.967499999999","0.1852235775","5.049693133874995E7","656.46010740375"
"10347","64948","64939","4","64943","178340","14246.870625","0.185209318125","5.051117820937495E7","656.645316721875"
"10348","64943","64938","7","64945","178347","14247.309375","0.185215021875","5.052542551874995E7","656.83053174375"
"10349","64945","64943","1","64944","178348","14247.09","0.18521216999999998","5.0539672608749956E7","657.01574391375"
"10350","64944","64938","2","64940","178350","14246.2125","0.18520076249999998","5.0553918821249954E7","657.2009446762501"
"10351","64940","64935","6","64941","178356","14246.431875000002","0.18520361437500002","5.056816525312495E7","657.3861482906251"
"10352","64941","64937","5","64942","178361","14246.651249999999","0.18520646624999998","5.058241190437495E7","657.571354756875"
"10353","64942","64941","7","64948","178368","14247.967499999999","0.1852235775","5.059665987187495E7","657.756578334375"
"10354","64948","64944","1","64945","178369","14247.309375","0.185215021875","5.0610907181249954E7","657.9417933562501"
"10355","64945","64936","9","64945","178378","14247.309375","0.185215021875","5.062515449062496E7","658.1270083781251"
"10356","64945","64936","6","64942","178384","14246.651249999999","0.18520646624999998","5.0639401141874954E7","658.312214844375"
"10357","64942","64936","3","64939","178387","14245.993125","0.185197910625","5.065364713499995E7","658.497412755"
"10358","64939","64935","5","64940","178392","14246.2125","0.18520076249999998","5.066789334749995E7","658.6826135175"
"10359","64940","64938","5","64943","178397","14246.870625","0.185209318125","5.068214021812495E7","658.867822835625"
"10360","64943","64941","6","64947","178403","14247.748125","0.185220725625","5.069638796624995E7","659.05304356125"
"10361","64947","64942","6","64948","178409","14247.967499999999","0.1852235775","5.071063593374995E7","659.23826713875"
"10362","64948","64941","8","64949","178417","14248.186875000001","0.185226429375","5.072488412062495E7","659.423493568125"
"10363","64949","64940","2","64942","178419","14246.651249999999","0.18520646624999998","5.073913077187495E7","659.6087000343749"
"10364","64942","64936","2","64938","178421","14245.773749999998","0.18519505874999997","5.075337654562495E7","659.7938950931249"
"10365","64938","64930","3","64933","178424","14244.676875","0.18518079937499998","5.076762122249995E7","659.9790758924998"
"10366","64933","64926","4","64930","178428","14244.01875","0.18517224375","5.078186524124995E7","660.1642481362499"
"10367","64930","64925","5","64930","178433","14244.01875","0.18517224375","5.0796109259999946E7","660.3494203799999"
"10368","64930","64921","5","64926","178438","14243.14125","0.18516083625","5.0810352401249945E7","660.5345812162499"
"10369","64926","64925","8","64933","178446","14244.676875","0.18518079937499998","5.082459707812495E7","660.7197620156248"
"10370","64933","64925","2","64927","178448","14243.360625","0.18516368812499998","5.083884043874995E7","660.9049257037499"
"10371","64927","64918","3","64921","178451","14242.044375000001","0.185146576875","5.085308248312495E7","661.0900722806249"
"10372","64921","64913","3","64916","178454","14240.947500000002","0.1851323175","5.086732343062495E7","661.2752045981249"
"10373","64916","64914","6","64920","178460","14241.825","0.185143725","5.088156525562495E7","661.4603483231249"
"10374","64920","64915","6","64921","178466","14242.044375000001","0.185146576875","5.089580729999995E7","661.6454948999999"
"10375","64921","64914","6","64920","178472","14241.825","0.185143725","5.0910049124999955E7","661.8306386249999"
"10376","64920","64913","2","64915","178474","14240.728125","0.185129465625","5.0924289853124954E7","662.0157680906249"
"10377","64915","64906","9","64915","178483","14240.728125","0.185129465625","5.093853058124995E7","662.2008975562499"
"10378","64915","64913","2","64915","178485","14240.728125","0.185129465625","5.095277130937495E7","662.3860270218748"
"10379","64915","64909","6","64915","178491","14240.728125","0.185129465625","5.096701203749995E7","662.5711564874998"
"10380","64915","64910","1","64911","178492","14239.850625","0.18511805812499998","5.098125188812495E7","662.7562745456248"
"10381","64911","64905","3","64908","178495","14239.1925","0.18510950249999997","5.099549108062495E7","662.9413840481249"
"10382","64908","64901","3","64904","178498","14238.315","0.185098095","5.100972939562495E7","663.1264821431248"
"10383","64904","64901","1","64902","178499","14237.87625","0.18509239125","5.102396727187495E7","663.3115745343748"
"10384","64902","64897","4","64901","178503","14237.656875","0.185089539375","5.103820492874995E7","663.4966640737498"
"10385","64901","64894","1","64895","178504","14236.340625","0.185072428125","5.105244126937495E7","663.6817365018748"
"10386","64895","64886","7","64893","178511","14235.901875","0.185066724375","5.106667717124995E7","663.8668032262498"
"10387","64893","64890","9","64899","178520","14237.218125000001","0.185083835625","5.108091438937495E7","664.0518870618748"
"10388","64899","64898","3","64901","178523","14237.656875","0.185089539375","5.109515204624995E7","664.2369766012498"
"10389","64901","64895","4","64899","178527","14237.218125000001","0.185083835625","5.110938926437495E7","664.4220604368749"
"10390","64899","64892","1","64893","178528","14235.901875","0.185066724375","5.1123625166249946E7","664.6071271612499"
"10391","64893","64889","5","64894","178533","14236.12125","0.18506957624999998","5.113786128749995E7","664.7921967374999"
"10392","64894","64888","8","64896","178541","14236.560000000001","0.18507528","5.115209784749995E7","664.9772720174999"
"10393","64896","64892","9","64901","178550","14237.656875","0.185089539375","5.116633550437495E7","665.1623615568749"
"10394","64901","64895","1","64896","178551","14236.560000000001","0.18507528","5.118057206437495E7","665.3474368368749"
"10395","64896","64889","8","64897","178559","14236.779375","0.185078131875","5.1194808843749955E7","665.5325149687499"
"10396","64897","64892","2","64894","178561","14236.12125","0.18506957624999998","5.120904496499996E7","665.7175845449999"
"10397","64894","64893","5","64898","178566","14236.998749999999","0.18508098374999998","5.122328196374996E7","665.9026655287499"
"10398","64898","64889","1","64890","178567","14235.24375","0.18505816874999997","5.123751720749996E7","666.0877236974999"
"10399","64890","64885","4","64889","178571","14235.024375","0.185055316875","5.125175223187496E7","666.2727790143749"
"10400","64889","64885","5","64890","178576","14235.24375","0.18505816874999997","5.1265987475624956E7","666.4578371831249"
"10401","64890","64883","3","64886","178579","14234.36625","0.18504676124999997","5.128022184187496E7","666.6428839443748"
"10402","64886","64880","2","64882","178581","14233.488749999999","0.18503535374999996","5.129445533062496E7","666.8279192981248"
"10403","64882","64881","1","64882","178582","14233.488749999999","0.18503535374999996","5.130868881937496E7","667.0129546518748"
"10404","64882","64881","9","64890","178591","14235.24375","0.18505816874999997","5.132292406312496E7","667.1980128206247"
"10405","64890","64887","3","64890","178594","14235.24375","0.18505816874999997","5.133715930687496E7","667.3830709893747"
"10406","64890","64886","4","64890","178598","14235.24375","0.18505816874999997","5.135139455062496E7","667.5681291581246"
"10407","64890","64882","5","64887","178603","14234.585625","0.18504961312499998","5.136562913624996E7","667.7531787712496"
"10408","64887","64879","2","64881","178605","14233.269375","0.18503250187499998","5.1379862405624956E7","667.9382112731246"
"10409","64881","64880","5","64885","178610","14234.146875","0.18504390937499998","5.139409655249996E7","668.1232551824996"
"10410","64885","64878","3","64881","178613","14233.269375","0.18503250187499998","5.1408329821874954E7","668.3082876843746"
"10411","64881","64877","7","64884","178620","14233.9275","0.1850410575","5.1422563749374956E7","668.4933287418746"
"10412","64884","64882","4","64886","178624","14234.36625","0.18504676124999997","5.143679811562496E7","668.6783755031246"
"10413","64886","64879","6","64885","178630","14234.146875","0.18504390937499998","5.145103226249996E7","668.8634194124996"
"10414","64885","64879","3","64882","178633","14233.488749999999","0.18503535374999996","5.146526575124996E7","669.0484547662496"
"10415","64882","64874","7","64881","178640","14233.269375","0.18503250187499998","5.147949902062496E7","669.2334872681246"
"10416","64881","64876","1","64877","178641","14232.391875","0.18502109437499997","5.149373141249996E7","669.4185083624996"
"10417","64877","64870","7","64877","178648","14232.391875","0.18502109437499997","5.1507963804374956E7","669.6035294568745"
"10418","64877","64876","9","64885","178657","14234.146875","0.18504390937499998","5.152219795124996E7","669.7885733662496"
"10419","64885","64881","4","64885","178661","14234.146875","0.18504390937499998","5.153643209812496E7","669.9736172756246"
"10420","64885","64876","3","64879","178664","14232.830625","0.185026798125","5.1550664928749956E7","670.1586440737497"
"10421","64879","64875","2","64877","178666","14232.391875","0.18502109437499997","5.1564897320624955E7","670.3436651681246"
"10422","64877","64873","2","64875","178668","14231.953125","0.185015390625","5.1579129273749955E7","670.5286805587497"
"10423","64875","64874","6","64880","178674","14233.05","0.18502965","5.159336232374995E7","670.7137102087497"
"10424","64880","64874","7","64881","178681","14233.269375","0.18503250187499998","5.160759559312495E7","670.8987427106247"
"10425","64881","64872","5","64877","178686","14232.391875","0.18502109437499997","5.162182798499995E7","671.0837638049996"
"10426","64877","64874","8","64882","178694","14233.488749999999","0.18503535374999996","5.163606147374995E7","671.2687991587496"
"10427","64882","64878","4","64882","178698","14233.488749999999","0.18503535374999996","5.1650294962499954E7","671.4538345124996"
"10428","64882","64878","5","64883","178703","14233.708125","0.18503820562499998","5.166452867062496E7","671.6388727181246"
"10429","64883","64877","2","64879","178705","14232.830625","0.185026798125","5.1678761501249954E7","671.8238995162496"
"10430","64879","64871","7","64878","178712","14232.611249999996","0.18502394624999993","5.169299411249995E7","672.0089234624996"
"10431","64878","64876","3","64879","178715","14232.830625","0.185026798125","5.170722694312495E7","672.1939502606247"
"10432","64879","64876","3","64879","178718","14232.830625","0.185026798125","5.172145977374995E7","672.3789770587497"
"10433","64879","64878","8","64886","178726","14234.36625","0.18504676124999997","5.173569413999995E7","672.5640238199996"
"10434","64886","64882","5","64887","178731","14234.585625","0.18504961312499998","5.174992872562495E7","672.7490734331246"
"10435","64887","64879","5","64884","178736","14233.9275","0.1850410575","5.176416265312495E7","672.9341144906247"
"10436","64884","64880","6","64886","178742","14234.36625","0.18504676124999997","5.177839701937495E7","673.1191612518746"
"10437","64886","64882","6","64888","178748","14234.804999999998","0.18505246499999997","5.179263182437495E7","673.3042137168746"
"10438","64888","64881","8","64889","178756","14235.024375","0.185055316875","5.180686684874995E7","673.4892690337497"
"10439","64889","64882","6","64888","178762","14234.804999999998","0.18505246499999997","5.182110165374995E7","673.6743214987497"
"10440","64888","64885","1","64886","178763","14234.36625","0.18504676124999997","5.183533601999995E7","673.8593682599997"
"10441","64886","64883","9","64892","178772","14235.682499999999","0.18506387249999998","5.184957170249995E7","674.0444321324997"
"10442","64892","64884","3","64887","178775","14234.585625","0.18504961312499998","5.186380628812495E7","674.2294817456246"
"10443","64887","64882","7","64889","178782","14235.024375","0.185055316875","5.187804131249995E7","674.4145370624997"
"10444","64889","64884","9","64893","178791","14235.901875","0.185066724375","5.1892277214374945E7","674.5996037868747"
"10445","64893","64889","5","64894","178796","14236.12125","0.18506957624999998","5.190651333562495E7","674.7846733631247"
"10446","64894","64890","6","64896","178802","14236.560000000001","0.18507528","5.192074989562495E7","674.9697486431247"
"10447","64896","64893","9","64902","178811","14237.87625","0.18509239125","5.193498777187495E7","675.1548410343747"
"10448","64902","64894","7","64901","178818","14237.656875","0.185089539375","5.194922542874995E7","675.3399305737497"
"10449","64901","64898","1","64899","178819","14237.218125000001","0.185083835625","5.196346264687495E7","675.5250144093748"
"10450","64899","64890","7","64897","178826","14236.779375","0.185078131875","5.197769942624995E7","675.7100925412498"
"10451","64897","64894","7","64901","178833","14237.656875","0.185089539375","5.199193708312495E7","675.8951820806247"
"10452","64901","64899","4","64903","178837","14238.095624999996","0.18509524312499995","5.200617517874995E7","676.0802773237498"
"10453","64903","64901","6","64907","178843","14238.973124999999","0.18510665062499998","5.202041415187495E7","676.2653839743748"
"10454","64907","64901","2","64903","178845","14238.095624999996","0.18509524312499995","5.203465224749995E7","676.4504792174998"
"10455","64903","64894","5","64899","178850","14237.218125000001","0.185083835625","5.204888946562495E7","676.6355630531249"
"10456","64899","64894","2","64896","178852","14236.560000000001","0.18507528","5.206312602562495E7","676.8206383331249"
"10457","64896","64890","4","64894","178856","14236.12125","0.18506957624999998","5.207736214687496E7","677.0057079093749"
"10458","64894","64887","6","64893","178862","14235.901875","0.185066724375","5.209159804874995E7","677.1907746337499"
"10459","64893","64885","9","64894","178871","14236.12125","0.18506957624999998","5.210583416999996E7","677.37584421"
"10460","64894","64887","8","64895","178879","14236.340625","0.185072428125","5.212007051062496E7","677.5609166381249"
"10461","64895","64894","9","64903","178888","14238.095624999996","0.18509524312499995","5.213430860624996E7","677.74601188125"
"10462","64903","64894","8","64902","178896","14237.87625","0.18509239125","5.214854648249996E7","677.9311042725"
"10463","64902","64900","5","64905","178901","14238.534375","0.18510094687499998","5.2162785016874954E7","678.1162052193749"
"10464","64905","64900","4","64904","178905","14238.315","0.185098095","5.217702333187495E7","678.3013033143749"
"10465","64904","64896","4","64900","178909","14237.4375","0.18508668749999999","5.219126076937495E7","678.4863900018748"
"10466","64900","64898","3","64901","178912","14237.656875","0.185089539375","5.220549842624995E7","678.6714795412498"
"10467","64901","64900","9","64909","178921","14239.411875","0.18511235437499998","5.221973783812495E7","678.8565918956248"
"10468","64909","64902","1","64903","178922","14238.095624999996","0.18509524312499995","5.223397593374995E7","679.0416871387498"
"10469","64903","64900","3","64903","178925","14238.095624999996","0.18509524312499995","5.224821402937495E7","679.2267823818748"
"10470","64903","64895","6","64901","178931","14237.656875","0.185089539375","5.226245168624995E7","679.4118719212498"
"10471","64901","64893","9","64902","178940","14237.87625","0.18509239125","5.227668956249995E7","679.5969643124998"
"10472","64902","64894","8","64902","178948","14237.87625","0.18509239125","5.229092743874995E7","679.7820567037498"
"10473","64902","64895","5","64900","178953","14237.4375","0.18508668749999999","5.230516487624995E7","679.9671433912498"
"10474","64900","64896","6","64902","178959","14237.87625","0.18509239125","5.2319402752499945E7","680.1522357824998"
"10475","64902","64895","2","64897","178961","14236.779375","0.185078131875","5.233363953187495E7","680.3373139143748"
"10476","64897","64894","2","64896","178963","14236.560000000001","0.18507528","5.234787609187495E7","680.5223891943748"
"10477","64896","64895","3","64898","178966","14236.998749999999","0.18508098374999998","5.236211309062495E7","680.7074701781248"
"10478","64898","64895","4","64899","178970","14237.218125000001","0.185083835625","5.237635030874995E7","680.8925540137499"
"10479","64899","64897","4","64901","178974","14237.656875","0.185089539375","5.239058796562495E7","681.0776435531249"
"10480","64901","64892","7","64899","178981","14237.218125000001","0.185083835625","5.240482518374995E7","681.2627273887499"
"10481","64899","64890","5","64895","178986","14236.340625","0.185072428125","5.2419061524374954E7","681.4477998168749"
"10482","64895","64893","9","64902","178995","14237.87625","0.18509239125","5.243329940062495E7","681.6328922081249"
"10483","64902","64894","3","64897","178998","14236.779375","0.185078131875","5.2447536179999955E7","681.8179703399999"
"10484","64897","64893","8","64901","179006","14237.656875","0.185089539375","5.2461773836874954E7","682.0030598793749"
"10485","64901","64900","6","64906","179012","14238.75375","0.18510379875","5.247601259062495E7","682.1881636781249"
"10486","64906","64905","2","64907","179014","14238.973124999999","0.18510665062499998","5.2490251563749954E7","682.3732703287499"
"10487","64907","64904","5","64909","179019","14239.411875","0.18511235437499998","5.2504490975624956E7","682.5583826831248"
"10488","64909","64905","6","64911","179025","14239.850625","0.18511805812499998","5.251873082624996E7","682.7435007412498"
"10489","64911","64902","1","64903","179026","14238.095624999996","0.18509524312499995","5.2532968921874955E7","682.9285959843749"
"10490","64903","64894","4","64898","179030","14236.998749999999","0.18508098374999998","5.254720592062496E7","683.1136769681249"
"10491","64898","64896","2","64898","179032","14236.998749999999","0.18508098374999998","5.256144291937496E7","683.2987579518749"
"10492","64898","64895","1","64896","179033","14236.560000000001","0.18507528","5.257567947937496E7","683.4838332318749"
"10493","64896","64890","9","64899","179042","14237.218125000001","0.185083835625","5.258991669749996E7","683.6689170674999"
"10494","64899","64897","8","64905","179050","14238.534375","0.18510094687499998","5.260415523187496E7","683.8540180143749"
"10495","64905","64904","9","64913","179059","14240.289374999998","0.18512376187499996","5.261839552124996E7","684.03914177625"
"10496","64913","64904","1","64905","179060","14238.534375","0.18510094687499998","5.2632634055624954E7","684.2242427231249"
"10497","64905","64902","5","64907","179065","14238.973124999999","0.18510665062499998","5.264687302874996E7","684.4093493737499"
"10498","64907","64901","9","64910","179074","14239.63125","0.18511520625","5.266111265999996E7","684.5944645799999"
"10499","64910","64901","4","64905","179078","14238.534375","0.18510094687499998","5.2675351194374956E7","684.7795655268749"
"10500","64905","64899","2","64901","179080","14237.656875","0.185089539375","5.2689588851249956E7","684.9646550662499"
"10501","64901","64896","8","64904","179088","14238.315","0.185098095","5.270382716624995E7","685.1497531612498"
"10502","64904","64898","3","64901","179091","14237.656875","0.185089539375","5.271806482312495E7","685.3348427006248"
"10503","64901","64892","5","64897","179096","14236.779375","0.185078131875","5.2732301602499954E7","685.5199208324998"
"10504","64897","64895","7","64902","179103","14237.87625","0.18509239125","5.274653947874995E7","685.7050132237498"
"10505","64902","64898","2","64900","179105","14237.4375","0.18508668749999999","5.276077691624995E7","685.8900999112498"
"10506","64900","64897","8","64905","179113","14238.534375","0.18510094687499998","5.277501545062495E7","686.0752008581247"
"10507","64905","64897","9","64906","179122","14238.75375","0.18510379875","5.278925420437495E7","686.2603046568747"
"10508","64906","64901","2","64903","179124","14238.095624999996","0.18509524312499995","5.2803492299999945E7","686.4453998999998"
"10509","64903","64896","8","64904","179132","14238.315","0.185098095","5.281773061499994E7","686.6304979949997"
"10510","64904","64895","7","64902","179139","14237.87625","0.18509239125","5.283196849124994E7","686.8155903862497"
"10511","64902","64899","3","64902","179142","14237.87625","0.18509239125","5.284620636749994E7","687.0006827774997"
"10512","64902","64901","3","64904","179145","14238.315","0.185098095","5.286044468249994E7","687.1857808724997"
"10513","64904","64903","8","64911","179153","14239.850625","0.18511805812499998","5.287468453312494E7","687.3708989306247"
"10514","64911","64910","2","64912","179155","14240.07","0.18512090999999997","5.288892460312494E7","687.5560198406247"
"10515","64912","64904","7","64911","179162","14239.850625","0.18511805812499998","5.290316445374994E7","687.7411378987497"
"10516","64911","64902","5","64907","179167","14238.973124999999","0.18510665062499998","5.291740342687494E7","687.9262445493747"
"10517","64907","64903","4","64907","179171","14238.973124999999","0.18510665062499998","5.293164239999995E7","688.1113511999997"
"10518","64907","64905","1","64906","179172","14238.75375","0.18510379875","5.294588115374994E7","688.2964549987497"
"10519","64906","64904","4","64908","179176","14239.1925","0.18510950249999997","5.2960120346249945E7","688.4815645012497"
"10520","64908","64905","3","64908","179179","14239.1925","0.18510950249999997","5.297435953874995E7","688.6666740037498"
"10521","64908","64902","7","64909","179186","14239.411875","0.18511235437499998","5.298859895062495E7","688.8517863581247"
"10522","64909","64901","1","64902","179187","14237.87625","0.18509239125","5.300283682687495E7","689.0368787493748"
"10523","64902","64895","8","64903","179195","14238.095624999996","0.18509524312499995","5.301707492249995E7","689.2219739924998"
"10524","64903","64902","1","64903","179196","14238.095624999996","0.18509524312499995","5.3031313018124945E7","689.4070692356248"
"10525","64903","64902","5","64907","179201","14238.973124999999","0.18510665062499998","5.304555199124995E7","689.5921758862498"
"10526","64907","64898","6","64904","179207","14238.315","0.185098095","5.305979030624995E7","689.7772739812498"
"10527","64904","64903","2","64905","179209","14238.534375","0.18510094687499998","5.307402884062494E7","689.9623749281247"
"10528","64905","64896","5","64901","179214","14237.656875","0.185089539375","5.308826649749994E7","690.1474644674997"
"10529","64901","64900","1","64901","179215","14237.656875","0.185089539375","5.310250415437494E7","690.3325540068747"
"10530","64901","64900","2","64902","179217","14237.87625","0.18509239125","5.311674203062494E7","690.5176463981247"
"10531","64902","64898","7","64905","179224","14238.534375","0.18510094687499998","5.313098056499994E7","690.7027473449997"
"10532","64905","64896","7","64903","179231","14238.095624999996","0.18509524312499995","5.3145218660624936E7","690.8878425881247"
"10533","64903","64895","2","64897","179233","14236.779375","0.185078131875","5.315945543999994E7","691.0729207199997"
"10534","64897","64890","8","64898","179241","14236.998749999999","0.18508098374999998","5.317369243874994E7","691.2580017037498"
"10535","64898","64891","6","64897","179247","14236.779375","0.185078131875","5.318792921812494E7","691.4430798356248"
"10536","64897","64894","7","64901","179254","14237.656875","0.185089539375","5.320216687499994E7","691.6281693749997"
"10537","64901","64894","7","64901","179261","14237.656875","0.185089539375","5.321640453187494E7","691.8132589143747"
"10538","64901","64893","1","64894","179262","14236.12125","0.18506957624999998","5.323064065312494E7","691.9983284906248"
"10539","64894","64893","4","64897","179266","14236.779375","0.185078131875","5.3244877432499945E7","692.1834066224998"
"10540","64897","64889","6","64895","179272","14236.340625","0.185072428125","5.325911377312495E7","692.3684790506247"
"10541","64895","64889","7","64896","179279","14236.560000000001","0.18507528","5.327335033312495E7","692.5535543306247"
"10542","64896","64889","8","64897","179287","14236.779375","0.185078131875","5.328758711249995E7","692.7386324624997"
"10543","64897","64891","6","64897","179293","14236.779375","0.185078131875","5.3301823891874954E7","692.9237105943747"
"10544","64897","64892","7","64899","179300","14237.218125000001","0.185083835625","5.3316061109999955E7","693.1087944299998"
"10545","64899","64893","4","64897","179304","14236.779375","0.185078131875","5.333029788937496E7","693.2938725618748"
"10546","64897","64889","4","64893","179308","14235.901875","0.185066724375","5.334453379124995E7","693.4789392862498"
"10547","64893","64888","2","64890","179310","14235.24375","0.18505816874999997","5.335876903499995E7","693.6639974549997"
"10548","64890","64888","2","64890","179312","14235.24375","0.18505816874999997","5.337300427874995E7","693.8490556237497"
"10549","64890","64888","3","64891","179315","14235.463125000002","0.18506102062500002","5.338723974187495E7","694.0341166443746"
"10550","64891","64888","1","64889","179316","14235.024375","0.185055316875","5.340147476624995E7","694.2191719612497"
"10551","64889","64883","3","64886","179319","14234.36625","0.18504676124999997","5.341570913249995E7","694.4042187224996"
"10552","64886","64884","1","64885","179320","14234.146875","0.18504390937499998","5.342994327937495E7","694.5892626318747"
"10553","64885","64882","6","64888","179326","14234.804999999998","0.18505246499999997","5.344417808437495E7","694.7743150968747"
"10554","64888","64883","8","64891","179334","14235.463125000002","0.18506102062500002","5.345841354749995E7","694.9593761174997"
"10555","64891","64886","3","64889","179337","14235.024375","0.185055316875","5.347264857187495E7","695.1444314343747"
"10556","64889","64885","8","64893","179345","14235.901875","0.185066724375","5.348688447374994E7","695.3294981587497"
"10557","64893","64888","9","64897","179354","14236.779375","0.185078131875","5.3501121253124945E7","695.5145762906247"
"10558","64897","64888","5","64893","179359","14235.901875","0.185066724375","5.351535715499994E7","695.6996430149998"
"10559","64893","64891","8","64899","179367","14237.218125000001","0.185083835625","5.352959437312494E7","695.8847268506248"
"10560","64899","64896","7","64903","179374","14238.095624999996","0.18509524312499995","5.354383246874994E7","696.0698220937498"
"10561","64903","64894","9","64903","179383","14238.095624999996","0.18509524312499995","5.355807056437494E7","696.2549173368749"
"10562","64903","64899","6","64905","179389","14238.534375","0.18510094687499998","5.3572309098749936E7","696.4400182837499"
"10563","64905","64896","9","64905","179398","14238.534375","0.18510094687499998","5.358654763312493E7","696.6251192306248"
"10564","64905","64901","2","64903","179400","14238.095624999996","0.18509524312499995","5.360078572874993E7","696.8102144737499"
"10565","64903","64894","5","64899","179405","14237.218125000001","0.185083835625","5.361502294687493E7","696.9952983093749"
"10566","64899","64898","7","64905","179412","14238.534375","0.18510094687499998","5.362926148124993E7","697.1803992562499"
"10567","64905","64903","2","64905","179414","14238.534375","0.18510094687499998","5.3643500015624925E7","697.3655002031248"
"10568","64905","64902","4","64906","179418","14238.75375","0.18510379875","5.365773876937492E7","697.5506040018748"
"10569","64906","64899","2","64901","179420","14237.656875","0.185089539375","5.367197642624992E7","697.7356935412498"
"10570","64901","64893","1","64894","179421","14236.12125","0.18506957624999998","5.3686212547499925E7","697.9207631174999"
"10571","64894","64893","4","64897","179425","14236.779375","0.185078131875","5.370044932687493E7","698.1058412493749"
"10572","64897","64896","3","64899","179428","14237.218125000001","0.185083835625","5.371468654499993E7","698.2909250849999"
"10573","64899","64890","3","64893","179431","14235.901875","0.185066724375","5.3728922446874924E7","698.4759918093749"
"10574","64893","64886","6","64892","179437","14235.682499999999","0.18506387249999998","5.374315812937492E7","698.6610556818749"
"10575","64892","64887","5","64892","179442","14235.682499999999","0.18506387249999998","5.375739381187492E7","698.8461195543749"
"10576","64892","64883","9","64892","179451","14235.682499999999","0.18506387249999998","5.3771629494374916E7","699.0311834268749"
"10577","64892","64890","8","64898","179459","14236.998749999999","0.18508098374999998","5.378586649312492E7","699.216264410625"
"10578","64898","64894","5","64899","179464","14237.218125000001","0.185083835625","5.380010371124992E7","699.40134824625"
"10579","64899","64891","5","64896","179469","14236.560000000001","0.18507528","5.381434027124992E7","699.58642352625"
"10580","64896","64894","8","64902","179477","14237.87625","0.18509239125","5.382857814749992E7","699.7715159175"
"10581","64902","64894","6","64900","179483","14237.4375","0.18508668749999999","5.384281558499992E7","699.956602605"
"10582","64900","64893","6","64899","179489","14237.218125000001","0.185083835625","5.385705280312492E7","700.141686440625"
"10583","64899","64891","7","64898","179496","14236.998749999999","0.18508098374999998","5.387128980187492E7","700.326767424375"
"10584","64898","64890","3","64893","179499","14235.901875","0.185066724375","5.388552570374992E7","700.51183414875"
"10585","64893","64891","2","64893","179501","14235.901875","0.185066724375","5.3899761605624914E7","700.6969008731251"
"10586","64893","64885","6","64891","179507","14235.463125000002","0.18506102062500002","5.391399706874991E7","700.88196189375"
"10587","64891","64888","7","64895","179514","14236.340625","0.185072428125","5.3928233409374915E7","701.067034321875"
"10588","64895","64890","1","64891","179515","14235.463125000002","0.18506102062500002","5.394246887249991E7","701.2520953425"
"10589","64891","64883","5","64888","179520","14234.804999999998","0.18505246499999997","5.395670367749991E7","701.4371478075"
"10590","64888","64881","9","64890","179529","14235.24375","0.18505816874999997","5.397093892124991E7","701.6222059762499"
"10591","64890","64886","6","64892","179535","14235.682499999999","0.18506387249999998","5.398517460374991E7","701.8072698487499"
"10592","64892","64886","4","64890","179539","14235.24375","0.18505816874999997","5.399940984749991E7","701.9923280174999"
"10593","64890","64881","8","64889","179547","14235.024375","0.185055316875","5.4013644871874906E7","702.1773833343749"
"10594","64889","64885","7","64892","179554","14235.682499999999","0.18506387249999998","5.40278805543749E7","702.3624472068749"
"10595","64892","64887","3","64890","179557","14235.24375","0.18505816874999997","5.40421157981249E7","702.5475053756248"
"10596","64890","64888","1","64889","179558","14235.024375","0.185055316875","5.40563508224999E7","702.7325606924999"
"10597","64889","64882","5","64887","179563","14234.585625","0.18504961312499998","5.40705854081249E7","702.9176103056249"
"10598","64887","64882","5","64887","179568","14234.585625","0.18504961312499998","5.40848199937499E7","703.1026599187499"
"10599","64887","64886","8","64894","179576","14236.12125","0.18506957624999998","5.4099056114999905E7","703.2877294949999"
"10600","64894","64890","5","64895","179581","14236.340625","0.185072428125","5.411329245562491E7","703.4728019231248"
"10601","64895","64892","6","64898","179587","14236.998749999999","0.18508098374999998","5.412752945437491E7","703.6578829068749"
"10602","64898","64889","2","64891","179589","14235.463125000002","0.18506102062500002","5.414176491749991E7","703.8429439274998"
"10603","64891","64885","2","64887","179591","14234.585625","0.18504961312499998","5.415599950312491E7","704.0279935406248"
"10604","64887","64878","4","64882","179595","14233.488749999999","0.18503535374999996","5.417023299187491E7","704.2130288943748"
"10605","64882","64879","9","64888","179604","14234.804999999998","0.18505246499999997","5.418446779687491E7","704.3980813593748"
"10606","64888","64886","4","64890","179608","14235.24375","0.18505816874999997","5.419870304062491E7","704.5831395281248"
"10607","64890","64883","7","64890","179615","14235.24375","0.18505816874999997","5.421293828437491E7","704.7681976968747"
"10608","64890","64883","8","64891","179623","14235.463125000002","0.18506102062500002","5.4227173747499906E7","704.9532587174997"
"10609","64891","64890","3","64893","179626","14235.901875","0.185066724375","5.42414096493749E7","705.1383254418747"
"10610","64893","64892","8","64900","179634","14237.4375","0.18508668749999999","5.42556470868749E7","705.3234121293747"
"10611","64900","64898","7","64905","179641","14238.534375","0.18510094687499998","5.42698856212499E7","705.5085130762496"
"10612","64905","64903","2","64905","179643","14238.534375","0.18510094687499998","5.42841241556249E7","705.6936140231246"
"10613","64905","64898","5","64903","179648","14238.095624999996","0.18509524312499995","5.4298362251249894E7","705.8787092662496"
"10614","64903","64896","1","64897","179649","14236.779375","0.185078131875","5.43125990306249E7","706.0637873981246"
"10615","64897","64893","5","64898","179654","14236.998749999999","0.18508098374999998","5.43268360293749E7","706.2488683818747"
"10616","64898","64895","7","64902","179661","14237.87625","0.18509239125","5.43410739056249E7","706.4339607731247"
"10617","64902","64900","2","64902","179663","14237.87625","0.18509239125","5.4355311781874895E7","706.6190531643747"
"10618","64902","64900","8","64908","179671","14239.1925","0.18510950249999997","5.43695509743749E7","706.8041626668747"
"10619","64908","64901","5","64906","179676","14238.75375","0.18510379875","5.4383789728124894E7","706.9892664656247"
"10620","64906","64902","7","64909","179683","14239.411875","0.18511235437499998","5.43980291399999E7","707.1743788199997"
"10621","64909","64904","1","64905","179684","14238.534375","0.18510094687499998","5.441226767437489E7","707.3594797668746"
"10622","64905","64904","4","64908","179688","14239.1925","0.18510950249999997","5.4426506866874896E7","707.5445892693747"
"10623","64908","64903","2","64905","179690","14238.534375","0.18510094687499998","5.444074540124989E7","707.7296902162497"
"10624","64905","64900","8","64908","179698","14239.1925","0.18510950249999997","5.4454984593749896E7","707.9147997187497"
"10625","64908","64906","9","64915","179707","14240.728125","0.185129465625","5.4469225321874894E7","708.0999291843747"
"10626","64915","64911","3","64914","179710","14240.50875","0.18512661375","5.448346583062489E7","708.2850557981246"
"10627","64914","64907","2","64909","179712","14239.411875","0.18511235437499998","5.4497705242499895E7","708.4701681524996"
"10628","64909","64905","4","64909","179716","14239.411875","0.18511235437499998","5.45119446543749E7","708.6552805068745"
"10629","64909","64900","4","64904","179720","14238.315","0.185098095","5.4526182969374895E7","708.8403786018745"
"10630","64904","64899","3","64902","179723","14237.87625","0.18509239125","5.4540420845624894E7","709.0254709931245"
"10631","64902","64897","5","64902","179728","14237.87625","0.18509239125","5.455465872187489E7","709.2105633843745"
"10632","64902","64900","3","64903","179731","14238.095624999996","0.18509524312499995","5.456889681749989E7","709.3956586274995"
"10633","64903","64902","2","64904","179733","14238.315","0.185098095","5.458313513249989E7","709.5807567224995"
"10634","64904","64898","4","64902","179737","14237.87625","0.18509239125","5.459737300874989E7","709.7658491137495"
"10635","64902","64901","8","64909","179745","14239.411875","0.18511235437499998","5.461161242062489E7","709.9509614681244"
"10636","64909","64904","7","64911","179752","14239.850625","0.18511805812499998","5.462585227124989E7","710.1360795262494"
"10637","64911","64904","7","64911","179759","14239.850625","0.18511805812499998","5.464009212187489E7","710.3211975843744"
"10638","64911","64905","1","64906","179760","14238.75375","0.18510379875","5.465433087562489E7","710.5063013831244"
"10639","64906","64902","4","64906","179764","14238.75375","0.18510379875","5.4668569629374884E7","710.6914051818744"
"10640","64906","64901","9","64910","179773","14239.63125","0.18511520625","5.4682809260624886E7","710.8765203881244"
"10641","64910","64906","4","64910","179777","14239.63125","0.18511520625","5.469704889187489E7","711.0616355943744"
"10642","64910","64901","3","64904","179780","14238.315","0.185098095","5.4711287206874885E7","711.2467336893743"
"10643","64904","64898","3","64901","179783","14237.656875","0.185089539375","5.4725524863749884E7","711.4318232287493"
"10644","64901","64893","6","64899","179789","14237.218125000001","0.185083835625","5.4739762081874885E7","711.6169070643743"
"10645","64899","64896","6","64902","179795","14237.87625","0.18509239125","5.475399995812488E7","711.8019994556244"
"10646","64902","64899","8","64907","179803","14238.973124999999","0.18510665062499998","5.476823893124989E7","711.9871061062494"
"10647","64907","64900","8","64908","179811","14239.1925","0.18510950249999997","5.478247812374989E7","712.1722156087494"
"10648","64908","64904","7","64911","179818","14239.850625","0.18511805812499998","5.479671797437489E7","712.3573336668744"
"10649","64911","64910","6","64916","179824","14240.947500000002","0.1851323175","5.481095892187489E7","712.5424659843744"
"10650","64916","64909","4","64913","179828","14240.289374999998","0.18512376187499996","5.482519921124989E7","712.7275897462495"
"10651","64913","64907","4","64911","179832","14239.850625","0.18511805812499998","5.483943906187489E7","712.9127078043745"
"10652","64911","64910","4","64914","179836","14240.50875","0.18512661375","5.485367957062489E7","713.0978344181244"
"10653","64914","64911","4","64915","179840","14240.728125","0.185129465625","5.486792029874989E7","713.2829638837494"
"10654","64915","64910","8","64918","179848","14241.38625","0.18513802124999998","5.488216168499988E7","713.4681019049995"
"10655","64918","64916","5","64921","179853","14242.044375000001","0.185146576875","5.4896403729374886E7","713.6532484818745"
"10656","64921","64918","4","64922","179857","14242.26375","0.18514942874999998","5.491064599312489E7","713.8383979106245"
"10657","64922","64919","2","64921","179859","14242.044375000001","0.185146576875","5.492488803749989E7","714.0235444874995"
"10658","64921","64915","6","64921","179865","14242.044375000001","0.185146576875","5.493913008187489E7","714.2086910643745"
"10659","64921","64912","5","64917","179870","14241.166874999999","0.18513516937499996","5.495337124874989E7","714.3938262337496"
"10660","64917","64912","9","64921","179879","14242.044375000001","0.185146576875","5.496761329312489E7","714.5789728106246"
"10661","64921","64913","1","64914","179880","14240.50875","0.18512661375","5.498185380187489E7","714.7640994243745"
"10662","64914","64911","3","64914","179883","14240.50875","0.18512661375","5.499609431062489E7","714.9492260381245"
"10663","64914","64908","5","64913","179888","14240.289374999998","0.18512376187499996","5.501033459999989E7","715.1343497999995"
"10664","64913","64907","5","64912","179893","14240.07","0.18512090999999997","5.502457466999989E7","715.3194707099996"
"10665","64912","64909","6","64915","179899","14240.728125","0.185129465625","5.503881539812489E7","715.5046001756245"
"10666","64915","64910","9","64919","179908","14241.605625","0.185140873125","5.505305700374989E7","715.6897410487495"
"10667","64919","64918","3","64921","179911","14242.044375000001","0.185146576875","5.5067299048124894E7","715.8748876256245"
"10668","64921","64916","8","64924","179919","14242.702500000001","0.1851551325","5.5081541750624895E7","716.0600427581245"
"10669","64924","64922","5","64927","179924","14243.360625","0.18516368812499998","5.5095785111249894E7","716.2452064462495"
"10670","64927","64920","6","64926","179930","14243.14125","0.18516083625","5.511002825249989E7","716.4303672824996"
"10671","64926","64925","9","64934","179939","14244.89625","0.18518365125","5.5124273148749895E7","716.6155509337495"
"10672","64934","64931","8","64939","179947","14245.993125","0.185197910625","5.5138519141874894E7","716.8007488443745"
"10673","64939","64930","5","64935","179952","14245.115625","0.18518650312499998","5.5152764257499896E7","716.9859353474995"
"10674","64935","64934","9","64943","179961","14246.870625","0.185209318125","5.516701112812489E7","717.1711446656245"
"10675","64943","64942","1","64943","179962","14246.870625","0.185209318125","5.518125799874989E7","717.3563539837495"
"10676","64943","64939","6","64945","179968","14247.309375","0.185215021875","5.519550530812489E7","717.5415690056245"
"10677","64945","64943","7","64950","179975","14248.40625","0.18522928125","5.520975371437489E7","717.7267982868746"
"10678","64950","64945","4","64949","179979","14248.186875000001","0.185226429375","5.522400190124989E7","717.9120247162496"
"10679","64949","64944","2","64946","179981","14247.528750000001","0.18521787375","5.5238249429999895E7","718.0972425899996"
"10680","64946","64938","2","64940","179983","14246.2125","0.18520076249999998","5.5252495642499894E7","718.2824433524996"
"10681","64940","64938","4","64942","179987","14246.651249999999","0.18520646624999998","5.526674229374989E7","718.4676498187496"
"10682","64942","64940","3","64943","179990","14246.870625","0.185209318125","5.528098916437489E7","718.6528591368746"
"10683","64943","64938","1","64939","179991","14245.993125","0.185197910625","5.529523515749989E7","718.8380570474995"
"10684","64939","64930","2","64932","179993","14244.457499999999","0.18517794749999997","5.530947961499989E7","719.0232349949996"
"10685","64932","64931","9","64940","180002","14246.2125","0.18520076249999998","5.532372582749989E7","719.2084357574996"
"10686","64940","64937","9","64946","180011","14247.528750000001","0.18521787375","5.533797335624989E7","719.3936536312497"
"10687","64946","64944","2","64946","180013","14247.528750000001","0.18521787375","5.535222088499989E7","719.5788715049997"
"10688","64946","64942","5","64947","180018","14247.748125","0.185220725625","5.5366468633124895E7","719.7640922306247"
"10689","64947","64940","2","64942","180020","14246.651249999999","0.18520646624999998","5.538071528437489E7","719.9492986968746"
"10690","64942","64941","1","64942","180021","14246.651249999999","0.18520646624999998","5.539496193562489E7","720.1345051631246"
"10691","64942","64939","8","64947","180029","14247.748125","0.185220725625","5.540920968374989E7","720.3197258887495"
"10692","64947","64946","5","64951","180034","14248.625625","0.185232133125","5.542345830937489E7","720.5049580218746"
"10693","64951","64945","1","64946","180035","14247.528750000001","0.18521787375","5.543770583812489E7","720.6901758956246"
"10694","64946","64940","7","64947","180042","14247.748125","0.185220725625","5.5451953586249895E7","720.8753966212496"
"10695","64947","64946","6","64952","180048","14248.845","0.185234985","5.5466202431249894E7","721.0606316062496"
"10696","64952","64946","9","64955","180057","14249.503125","0.18524354062499998","5.548045193437489E7","721.2458751468746"
"10697","64955","64953","3","64956","180060","14249.7225","0.1852463925","5.549470165687489E7","721.4311215393745"
"10698","64956","64948","1","64949","180061","14248.186875000001","0.185226429375","5.550894984374989E7","721.6163479687496"
"10699","64949","64941","3","64944","180064","14247.09","0.18521216999999998","5.552319693374989E7","721.8015601387496"
"10700","64944","64942","6","64948","180070","14247.967499999999","0.1852235775","5.553744490124989E7","721.9867837162495"
"10701","64948","64946","9","64955","180079","14249.503125","0.18524354062499998","5.555169440437489E7","722.1720272568746"
"10702","64955","64946","6","64952","180085","14248.845","0.185234985","5.556594324937489E7","722.3572622418745"
"10703","64952","64944","7","64951","180092","14248.625625","0.185232133125","5.558019187499989E7","722.5424943749996"
"10704","64951","64942","1","64943","180093","14246.870625","0.185209318125","5.5594438745624885E7","722.7277036931246"
"10705","64943","64938","8","64946","180101","14247.528750000001","0.18521787375","5.560868627437489E7","722.9129215668746"
"10706","64946","64940","7","64947","180108","14247.748125","0.185220725625","5.562293402249989E7","723.0981422924996"
"10707","64947","64938","9","64947","180117","14247.748125","0.185220725625","5.563718177062489E7","723.2833630181245"
"10708","64947","64941","1","64942","180118","14246.651249999999","0.18520646624999998","5.565142842187489E7","723.4685694843745"
"10709","64942","64940","1","64941","180119","14246.431875000002","0.18520361437500002","5.5665674853749886E7","723.6537730987495"
"10710","64941","64935","1","64936","180120","14245.335","0.18518935499999997","5.567992018874989E7","723.8389624537496"
"10711","64936","64929","8","64937","180128","14245.554375","0.185192206875","5.569416574312489E7","724.0241546606245"
"10712","64937","64929","7","64936","180135","14245.335","0.18518935499999997","5.570841107812489E7","724.2093440156245"
"10713","64936","64935","6","64941","180141","14246.431875000002","0.18520361437500002","5.5722657509999886E7","724.3945476299996"
"10714","64941","64933","4","64937","180145","14245.554375","0.185192206875","5.573690306437489E7","724.5797398368745"
"10715","64937","64929","9","64938","180154","14245.773749999998","0.18519505874999997","5.5751148838124886E7","724.7649348956245"
"10716","64938","64929","6","64935","180160","14245.115625","0.18518650312499998","5.576539395374989E7","724.9501213987495"
"10717","64935","64934","7","64941","180167","14246.431875000002","0.18520361437500002","5.5779640385624886E7","725.1353250131245"
"10718","64941","64932","6","64938","180173","14245.773749999998","0.18519505874999997","5.5793886159374885E7","725.3205200718745"
"10719","64938","64936","9","64945","180182","14247.309375","0.185215021875","5.580813346874989E7","725.5057350937495"
"10720","64945","64943","3","64946","180185","14247.528750000001","0.18521787375","5.582238099749989E7","725.6909529674996"
"10721","64946","64937","9","64946","180194","14247.528750000001","0.18521787375","5.583662852624989E7","725.8761708412496"
"10722","64946","64941","7","64948","180201","14247.967499999999","0.1852235775","5.5850876493749894E7","726.0613944187496"
"10723","64948","64944","1","64945","180202","14247.309375","0.185215021875","5.58651238031249E7","726.2466094406246"
"10724","64945","64942","9","64951","180211","14248.625625","0.185232133125","5.58793724287499E7","726.4318415737497"
"10725","64951","64945","1","64946","180212","14247.528750000001","0.18521787375","5.58936199574999E7","726.6170594474997"
"10726","64946","64944","5","64949","180217","14248.186875000001","0.185226429375","5.59078681443749E7","726.8022858768747"
"10727","64949","64946","8","64954","180225","14249.28375","0.18524068875","5.59221174281249E7","726.9875265656248"
"10728","64954","64946","7","64953","180232","14249.064374999996","0.18523783687499995","5.5936366492499895E7","727.1727644024998"
"10729","64953","64947","6","64953","180238","14249.064374999996","0.18523783687499995","5.595061555687489E7","727.3580022393747"
"10730","64953","64952","8","64960","180246","14250.6","0.1852578","5.5964866156874895E7","727.5432600393748"
"10731","64960","64958","7","64965","180253","14251.696875","0.185272059375","5.597911785374989E7","727.7285320987498"
"10732","64965","64959","4","64963","180257","14251.258124999998","0.18526635562499996","5.599336911187489E7","727.9137984543748"
"10733","64963","64954","2","64956","180259","14249.7225","0.1852463925","5.600761883437489E7","728.0990448468748"
"10734","64956","64949","5","64954","180264","14249.28375","0.18524068875","5.602186811812489E7","728.2842855356248"
"10735","64954","64952","1","64953","180265","14249.064374999996","0.18523783687499995","5.6036117182499886E7","728.4695233724998"
"10736","64953","64946","6","64952","180271","14248.845","0.185234985","5.6050366027499884E7","728.6547583574998"
"10737","64952","64948","5","64953","180276","14249.064374999996","0.18523783687499995","5.606461509187488E7","728.8399961943747"
"10738","64953","64952","5","64957","180281","14249.941874999999","0.18524924437499998","5.6078865033749886E7","729.0252454387497"
"10739","64957","64951","3","64954","180284","14249.28375","0.18524068875","5.609311431749988E7","729.2104861274997"
"10740","64954","64947","4","64951","180288","14248.625625","0.185232133125","5.610736294312488E7","729.3957182606248"
"10741","64951","64947","5","64952","180293","14248.845","0.185234985","5.612161178812488E7","729.5809532456248"
"10742","64952","64947","9","64956","180302","14249.7225","0.1852463925","5.613586151062488E7","729.7661996381247"
"10743","64956","64951","4","64955","180306","14249.503125","0.18524354062499998","5.6150111013749875E7","729.9514431787497"
"10744","64955","64950","2","64952","180308","14248.845","0.185234985","5.6164359858749874E7","730.1366781637497"
"10745","64952","64946","2","64948","180310","14247.967499999999","0.1852235775","5.6178607826249875E7","730.3219017412497"
"10746","64948","64947","5","64952","180315","14248.845","0.185234985","5.6192856671249874E7","730.5071367262497"
"10747","64952","64950","7","64957","180322","14249.941874999999","0.18524924437499998","5.620710661312488E7","730.6923859706246"
"10748","64957","64954","2","64956","180324","14249.7225","0.1852463925","5.622135633562487E7","730.8776323631246"
"10749","64956","64951","6","64957","180330","14249.941874999999","0.18524924437499998","5.623560627749988E7","731.0628816074995"
"10750","64957","64948","8","64956","180338","14249.7225","0.1852463925","5.624985599999987E7","731.2481279999995"
"10751","64956","64949","2","64951","180340","14248.625625","0.185232133125","5.626410462562487E7","731.4333601331246"
"10752","64951","64944","7","64951","180347","14248.625625","0.185232133125","5.627835325124987E7","731.6185922662496"
"10753","64951","64942","7","64949","180354","14248.186875000001","0.185226429375","5.629260143812487E7","731.8038186956246"
"10754","64949","64944","4","64948","180358","14247.967499999999","0.1852235775","5.6306849405624874E7","731.9890422731246"
"10755","64948","64940","3","64943","180361","14246.870625","0.185209318125","5.632109627624987E7","732.1742515912496"
"10756","64943","64934","8","64942","180369","14246.651249999999","0.18520646624999998","5.633534292749987E7","732.3594580574995"
"10757","64942","64937","8","64945","180377","14247.309375","0.185215021875","5.634959023687487E7","732.5446730793745"
"10758","64945","64940","2","64942","180379","14246.651249999999","0.18520646624999998","5.636383688812487E7","732.7298795456245"
"10759","64942","64937","3","64940","180382","14246.2125","0.18520076249999998","5.637808310062487E7","732.9150803081245"
"10760","64940","64939","3","64942","180385","14246.651249999999","0.18520646624999998","5.6392329751874864E7","733.1002867743745"
"10761","64942","64937","3","64940","180388","14246.2125","0.18520076249999998","5.640657596437486E7","733.2854875368745"
"10762","64940","64936","9","64945","180397","14247.309375","0.185215021875","5.6420823273749866E7","733.4707025587495"
"10763","64945","64944","8","64952","180405","14248.845","0.185234985","5.6435072118749864E7","733.6559375437495"
"10764","64952","64948","2","64950","180407","14248.40625","0.18522928125","5.6449320524999864E7","733.8411668249995"
"10765","64950","64945","7","64952","180414","14248.845","0.185234985","5.646356936999986E7","734.0264018099995"
"10766","64952","64950","3","64953","180417","14249.064374999996","0.18523783687499995","5.647781843437486E7","734.2116396468745"
"10767","64953","64952","6","64958","180423","14250.16125","0.18525209624999997","5.6492068595624864E7","734.3968917431245"
"10768","64958","64957","3","64960","180426","14250.6","0.1852578","5.6506319195624866E7","734.5821495431245"
"10769","64960","64958","6","64964","180432","14251.4775","0.1852692075","5.6520570673124865E7","734.7674187506245"
"10770","64964","64958","6","64964","180438","14251.4775","0.1852692075","5.6534822150624864E7","734.9526879581246"
"10771","64964","64955","5","64960","180443","14250.6","0.1852578","5.6549072750624865E7","735.1379457581246"
"10772","64960","64954","3","64957","180446","14249.941874999999","0.18524924437499998","5.656332269249987E7","735.3231950024996"
"10773","64957","64956","5","64961","180451","14250.819375","0.185260651875","5.657757351187487E7","735.5084556543745"
"10774","64961","64955","9","64964","180460","14251.4775","0.1852692075","5.659182498937487E7","735.6937248618746"
"10775","64964","64961","7","64968","180467","14252.355","0.18528061499999998","5.6606077344374865E7","735.8790054768746"
"10776","64968","64960","8","64968","180475","14252.355","0.18528061499999998","5.662032969937486E7","736.0642860918746"
"10777","64968","64967","2","64969","180477","14252.574375","0.185283466875","5.6634582273749866E7","736.2495695587496"
"10778","64969","64963","6","64969","180483","14252.574375","0.185283466875","5.664883484812487E7","736.4348530256246"
"10779","64969","64967","8","64975","180491","14253.890625","0.18530057812499998","5.666308873874987E7","736.6201536037496"
"10780","64975","64970","4","64974","180495","14253.671250000001","0.18529772625000002","5.667734240999987E7","736.8054513299996"
"10781","64974","64971","9","64980","180504","14254.9875","0.18531483749999997","5.669159739749987E7","736.9907661674996"
"10782","64980","64975","2","64977","180506","14254.329375","0.18530628187499998","5.6705851726874866E7","737.1760724493746"
"10783","64977","64972","3","64975","180509","14253.890625","0.18530057812499998","5.6720105617499866E7","737.3613730274996"
"10784","64975","64969","8","64977","180517","14254.329375","0.18530628187499998","5.6734359946874864E7","737.5466793093746"
"10785","64977","64968","8","64976","180525","14254.11","0.18530343","5.6748614056874864E7","737.7319827393745"
"10786","64976","64968","5","64973","180530","14253.451874999999","0.18529487437499997","5.6762867508749865E7","737.9172776137495"
"10787","64973","64964","9","64973","180539","14253.451874999999","0.18529487437499997","5.6777120960624866E7","738.1025724881246"
"10788","64973","64964","5","64969","180544","14252.574375","0.185283466875","5.679137353499987E7","738.2878559549996"
"10789","64969","64967","7","64974","180551","14253.671250000001","0.18529772625000002","5.680562720624987E7","738.4731536812496"
"10790","64974","64965","1","64966","180552","14251.916250000002","0.18527491125","5.681987912249987E7","738.6584285924996"
"10791","64966","64960","8","64968","180560","14252.355","0.18528061499999998","5.6834131477499865E7","738.8437092074996"
"10792","64968","64964","2","64966","180562","14251.916250000002","0.18527491125","5.684838339374986E7","739.0289841187496"
"10793","64966","64960","7","64967","180569","14252.135624999999","0.18527776312499997","5.686263552937486E7","739.2142618818746"
"10794","64967","64963","4","64967","180573","14252.135624999999","0.18527776312499997","5.687688766499986E7","739.3995396449995"
"10795","64967","64964","6","64970","180579","14252.79375","0.18528631874999998","5.689114045874986E7","739.5848259637495"
"10796","64970","64961","8","64969","180587","14252.574375","0.185283466875","5.6905393033124864E7","739.7701094306245"
"10797","64969","64964","2","64966","180589","14251.916250000002","0.18527491125","5.691964494937486E7","739.9553843418745"
"10798","64966","64957","9","64966","180598","14251.916250000002","0.18527491125","5.693389686562486E7","740.1406592531245"
"10799","64966","64964","5","64969","180603","14252.574375","0.185283466875","5.694814943999986E7","740.3259427199995"
"10800","64969","64961","7","64968","180610","14252.355","0.18528061499999998","5.696240179499986E7","740.5112233349995"
"10801","64968","34968","0","34968","180610","7671.105","0.09972436499999998","5.697007289999986E7","740.6109476999995"
"10802","34968","34959","6","34965","180616","7670.446875","0.09971580937499999","5.6977743346874855E7","740.7106635093745"
"10803","34965","34964","7","34971","180623","7671.7631249999995","0.09973292062499999","5.698541510999986E7","740.8103964299995"
"10804","34971","34962","9","34971","180632","7671.7631249999995","0.09973292062499999","5.699308687312486E7","740.9101293506245"
"10805","34971","34966","3","34969","180635","7671.324374999999","0.09972721687499998","5.7000758197499864E7","741.0098565674995"
"10806","34969","34962","1","34963","180636","7670.008125","0.099710105625","5.700842820562486E7","741.1095666731245"
"10807","34963","34954","2","34956","180638","7668.4725","0.0996901425","5.701609667812486E7","741.2092568156245"
"10808","34956","34948","5","34953","180643","7667.814375","0.09968158687499999","5.702376449249986E7","741.3089384024995"
"10809","34953","34949","6","34955","180649","7668.253125","0.099687290625","5.7031432745624855E7","741.4086256931245"
"10810","34955","34953","4","34957","180653","7668.691875","0.099692994375","5.703910143749986E7","741.5083186874995"
"10811","34957","34955","2","34957","180655","7668.691875","0.099692994375","5.704677012937486E7","741.6080116818745"
"10812","34957","34952","4","34956","180659","7668.4725","0.0996901425","5.705443860187486E7","741.7077018243745"
"10813","34956","34955","4","34959","180663","7669.130625","0.09969869812499998","5.706210773249986E7","741.8074005224995"
"10814","34959","34950","3","34953","180666","7667.814375","0.09968158687499999","5.706977554687486E7","741.9070821093745"
"10815","34953","34950","3","34953","180669","7667.814375","0.09968158687499999","5.707744336124986E7","742.0067636962495"
"10816","34953","34950","1","34951","180670","7667.375625","0.09967588312499999","5.7085110736874856E7","742.1064395793745"
"10817","34951","34950","9","34959","180679","7669.130625","0.09969869812499998","5.709277986749986E7","742.2061382774996"
"10818","34959","34952","5","34957","180684","7668.691875","0.099692994375","5.710044855937486E7","742.3058312718746"
"10819","34957","34948","5","34953","180689","7667.814375","0.09968158687499999","5.710811637374986E7","742.4055128587496"
"10820","34953","34945","8","34953","180697","7667.814375","0.09968158687499999","5.711578418812486E7","742.5051944456246"
"10821","34953","34952","5","34957","180702","7668.691875","0.099692994375","5.712345287999986E7","742.6048874399996"
"10822","34957","34956","1","34957","180703","7668.691875","0.099692994375","5.7131121571874864E7","742.7045804343746"
"10823","34957","34951","4","34955","180707","7668.253125","0.099687290625","5.713878982499986E7","742.8042677249996"
"10824","34955","34950","7","34957","180714","7668.691875","0.099692994375","5.7146458516874865E7","742.9039607193746"
"10825","34957","34950","7","34957","180721","7668.691875","0.099692994375","5.715412720874987E7","743.0036537137496"
"10826","34957","34952","2","34954","180723","7668.03375","0.09968443874999999","5.7161795242499866E7","743.1033381524996"
"10827","34954","34951","3","34954","180726","7668.03375","0.09968443874999999","5.716946327624986E7","743.2030225912497"
"10828","34954","34951","9","34960","180735","7669.35","0.09970155","5.7177132626249865E7","743.3027241412497"
"10829","34960","34957","2","34959","180737","7669.130625","0.09969869812499998","5.718480175687487E7","743.4024228393747"
"10830","34959","34954","3","34957","180740","7668.691875","0.099692994375","5.719247044874987E7","743.5021158337497"
"10831","34957","34956","7","34963","180747","7670.008125","0.099710105625","5.720014045687487E7","743.6018259393747"
"10832","34963","34956","2","34958","180749","7668.911250000001","0.09969584625000001","5.720780936812487E7","743.7015217856248"
"10833","34958","34957","2","34959","180751","7669.130625","0.09969869812499998","5.7215478498749875E7","743.8012204837498"
"10834","34959","34950","7","34957","180758","7668.691875","0.099692994375","5.722314719062488E7","743.9009134781248"
"10835","34957","34956","6","34962","180764","7669.788750000001","0.09970725375","5.723081697937488E7","744.0006207318748"
"10836","34962","34959","1","34960","180765","7669.35","0.09970155","5.723848632937488E7","744.1003222818748"
"10837","34960","34953","5","34958","180770","7668.911250000001","0.09969584625000001","5.724615524062488E7","744.2000181281248"
"10838","34958","34955","6","34961","180776","7669.569375","0.099704401875","5.725382480999988E7","744.2997225299998"
"10839","34961","34958","5","34963","180781","7670.008125","0.099710105625","5.726149481812488E7","744.3994326356249"
"10840","34963","34960","1","34961","180782","7669.569375","0.099704401875","5.7269164387499884E7","744.4991370374998"
"10841","34961","34954","4","34958","180786","7668.911250000001","0.09969584625000001","5.727683329874989E7","744.5988328837499"
"10842","34958","34949","6","34955","180792","7668.253125","0.099687290625","5.728450155187488E7","744.6985201743748"
"10843","34955","34950","6","34956","180798","7668.4725","0.0996901425","5.729217002437488E7","744.7982103168748"
"10844","34956","34949","7","34956","180805","7668.4725","0.0996901425","5.729983849687488E7","744.8979004593748"
"10845","34956","34951","5","34956","180810","7668.4725","0.0996901425","5.730750696937487E7","744.9975906018748"
"10846","34956","34948","1","34949","180811","7666.936874999999","0.09967017937499999","5.731517390624987E7","745.0972607812498"
"10847","34949","34948","6","34954","180817","7668.03375","0.09968443874999999","5.732284193999987E7","745.1969452199999"
"10848","34954","34953","5","34958","180822","7668.911250000001","0.09969584625000001","5.733051085124987E7","745.2966410662499"
"10849","34958","34954","2","34956","180824","7668.4725","0.0996901425","5.733817932374987E7","745.3963312087499"
"10850","34956","34951","2","34953","180826","7667.814375","0.09968158687499999","5.734584713812487E7","745.4960127956249"
"10851","34953","34951","9","34960","180835","7669.35","0.09970155","5.735351648812487E7","745.5957143456249"
"10852","34960","34955","8","34963","180843","7670.008125","0.099710105625","5.736118649624987E7","745.6954244512499"
"10853","34963","34956","6","34962","180849","7669.788750000001","0.09970725375","5.736885628499987E7","745.7951317049999"
"10854","34962","34958","9","34967","180858","7670.885625","0.099721513125","5.737652717062487E7","745.8948532181249"
"10855","34967","34962","3","34965","180861","7670.446875","0.09971580937499999","5.7384197617499866E7","745.9945690274999"
"10856","34965","34957","8","34965","180869","7670.446875","0.09971580937499999","5.7391868064374864E7","746.0942848368749"
"10857","34965","34956","7","34963","180876","7670.008125","0.099710105625","5.7399538072499864E7","746.1939949424999"
"10858","34963","34956","7","34963","180883","7670.008125","0.099710105625","5.740720808062486E7","746.2937050481249"
"10859","34963","34956","9","34965","180892","7670.446875","0.09971580937499999","5.741487852749986E7","746.3934208574999"
"10860","34965","34957","9","34966","180901","7670.666249999999","0.09971866124999998","5.742254919374986E7","746.4931395187499"
"10861","34966","34962","6","34968","180907","7671.105","0.09972436499999998","5.743022029874986E7","746.5928638837499"
"10862","34968","34960","9","34969","180916","7671.324374999999","0.09972721687499998","5.743789162312486E7","746.6925911006249"
"10863","34969","34961","4","34965","180920","7670.446875","0.09971580937499999","5.744556206999986E7","746.7923069099999"
"10864","34965","34961","5","34966","180925","7670.666249999999","0.09971866124999998","5.745323273624986E7","746.8920255712499"
"10865","34966","34965","8","34973","180933","7672.201875000001","0.099738624375","5.746090493812486E7","746.9917641956249"
"10866","34973","34969","3","34972","180936","7671.9825","0.0997357725","5.746857692062486E7","747.0914999681249"
"10867","34972","34966","8","34974","180944","7672.421249999999","0.09974147624999999","5.747624934187486E7","747.1912414443749"
"10868","34974","34970","6","34976","180950","7672.86","0.09974717999999999","5.748392220187486E7","747.2909886243749"
"10869","34976","34969","1","34970","180951","7671.54375","0.09973006875","5.749159374562486E7","747.3907186931249"
"10870","34970","34969","1","34970","180952","7671.54375","0.09973006875","5.7499265289374866E7","747.4904487618749"
"10871","34970","34969","5","34974","180957","7672.421249999999","0.09974147624999999","5.7506937710624866E7","747.5901902381248"
"10872","34974","34971","4","34975","180961","7672.640625","0.09974432812499999","5.7514610351249866E7","747.6899345662498"
"10873","34975","34969","2","34971","180963","7671.7631249999995","0.09973292062499999","5.752228211437487E7","747.7896674868748"
"10874","34971","34969","2","34971","180965","7671.7631249999995","0.09973292062499999","5.752995387749987E7","747.8894004074998"
"10875","34971","34964","3","34967","180968","7670.885625","0.099721513125","5.753762476312487E7","747.9891219206248"
"10876","34967","34959","4","34963","180972","7670.008125","0.099710105625","5.754529477124987E7","748.0888320262499"
"10877","34963","34962","9","34971","180981","7671.7631249999995","0.09973292062499999","5.755296653437487E7","748.1885649468749"
"10878","34971","34966","8","34974","180989","7672.421249999999","0.09974147624999999","5.756063895562487E7","748.2883064231248"
"10879","34974","34972","5","34977","180994","7673.079375","0.09975003187499999","5.756831203499987E7","748.3880564549999"
"10880","34977","34970","7","34977","181001","7673.079375","0.09975003187499999","5.757598511437487E7","748.4878064868749"
"10881","34977","34974","5","34979","181006","7673.518125","0.099755735625","5.7583658632499866E7","748.5875622224999"
"10882","34979","34971","9","34980","181015","7673.7375","0.0997585875","5.759133236999986E7","748.6873208099998"
"10883","34980","34971","9","34980","181024","7673.7375","0.0997585875","5.759900610749986E7","748.7870793974998"
"10884","34980","34972","9","34981","181033","7673.956875","0.099761439375","5.760668006437486E7","748.8868408368749"
"10885","34981","34976","4","34980","181037","7673.7375","0.0997585875","5.761435380187485E7","748.9865994243748"
"10886","34980","34977","2","34979","181039","7673.518125","0.099755735625","5.762202731999985E7","749.0863551599998"
"10887","34979","34972","5","34977","181044","7673.079375","0.09975003187499999","5.762970039937485E7","749.1861051918748"
"10888","34977","34976","9","34985","181053","7674.834375","0.099772846875","5.763737523374985E7","749.2858780387498"
"10889","34985","34977","6","34983","181059","7674.395625000001","0.09976714312500001","5.7645049629374854E7","749.3856451818748"
"10890","34983","34982","3","34985","181062","7674.834375","0.099772846875","5.7652724463749856E7","749.4854180287498"
"10891","34985","34981","2","34983","181064","7674.395625000001","0.09976714312500001","5.766039885937486E7","749.5851851718747"
"10892","34983","34977","5","34982","181069","7674.17625","0.09976429125","5.766807303562486E7","749.6849494631248"
"10893","34982","34973","4","34977","181073","7673.079375","0.09975003187499999","5.767574611499986E7","749.7846994949998"
"10894","34977","34968","2","34970","181075","7671.54375","0.09973006875","5.768341765874986E7","749.8844295637498"
"10895","34970","34963","5","34968","181080","7671.105","0.09972436499999998","5.769108876374986E7","749.9841539287498"
"10896","34968","34961","7","34968","181087","7671.105","0.09972436499999998","5.769875986874986E7","750.0838782937499"
"10897","34968","34960","5","34965","181092","7670.446875","0.09971580937499999","5.7706430315624855E7","750.1835941031248"
"10898","34965","34961","5","34966","181097","7670.666249999999","0.09971866124999998","5.771410098187485E7","750.2833127643748"
"10899","34966","34957","9","34966","181106","7670.666249999999","0.09971866124999998","5.772177164812485E7","750.3830314256248"
"10900","34966","34958","8","34966","181114","7670.666249999999","0.09971866124999998","5.772944231437485E7","750.4827500868748"
"10901","34966","34964","9","34973","181123","7672.201875000001","0.099738624375","5.773711451624985E7","750.5824887112499"
"10902","34973","34968","7","34975","181130","7672.640625","0.09974432812499999","5.774478715687485E7","750.6822330393749"
"10903","34975","34966","6","34972","181136","7671.9825","0.0997357725","5.775245913937485E7","750.7819688118749"
"10904","34972","34968","5","34973","181141","7672.201875000001","0.099738624375","5.776013134124985E7","750.8817074362499"
"10905","34973","34971","9","34980","181150","7673.7375","0.0997585875","5.776780507874985E7","750.9814660237499"
"10906","34980","34973","5","34978","181155","7673.29875","0.09975288375","5.777547837749985E7","751.0812189075"
"10907","34978","34975","9","34984","181164","7674.615","0.09976999499999999","5.778315299249985E7","751.1809889025"
"10908","34984","34975","8","34983","181172","7674.395625000001","0.09976714312500001","5.779082738812485E7","751.2807560456249"
"10909","34983","34977","1","34978","181173","7673.29875","0.09975288375","5.779850068687485E7","751.380508929375"
"10910","34978","34977","7","34984","181180","7674.615","0.09976999499999999","5.780617530187485E7","751.4802789243749"
"10911","34984","34975","5","34980","181185","7673.7375","0.0997585875","5.781384903937485E7","751.5800375118749"
"10912","34980","34977","7","34984","181192","7674.615","0.09976999499999999","5.782152365437485E7","751.6798075068749"
"10913","34984","34980","4","34984","181196","7674.615","0.09976999499999999","5.7829198269374855E7","751.7795775018749"
"10914","34984","34975","1","34976","181197","7672.86","0.09974717999999999","5.7836871129374854E7","751.8793246818749"
"10915","34976","34967","4","34971","181201","7671.7631249999995","0.09973292062499999","5.784454289249986E7","751.9790576024999"
"10916","34971","34966","4","34970","181205","7671.54375","0.09973006875","5.785221443624986E7","752.0787876712499"
"10917","34970","34963","2","34965","181207","7670.446875","0.09971580937499999","5.785988488312486E7","752.1785034806248"
"10918","34965","34956","2","34958","181209","7668.911250000001","0.09969584625000001","5.786755379437486E7","752.2781993268749"
"10919","34958","34956","1","34957","181210","7668.691875","0.099692994375","5.7875222486249864E7","752.3778923212499"
"10920","34957","34949","8","34957","181218","7668.691875","0.099692994375","5.788289117812487E7","752.4775853156249"
"10921","34957","34952","7","34959","181225","7669.130625","0.09969869812499998","5.789056030874987E7","752.5772840137499"
"10922","34959","34951","2","34953","181227","7667.814375","0.09968158687499999","5.789822812312487E7","752.676965600625"
"10923","34953","34944","3","34947","181230","7666.498125","0.099664475625","5.790589462124987E7","752.77663007625"
"10924","34947","34940","1","34941","181231","7665.181874999999","0.09964736437499999","5.791355980312487E7","752.8762774406249"
"10925","34941","34935","3","34938","181234","7664.52375","0.09963880875","5.792122432687487E7","752.9759162493749"
"10926","34938","34930","7","34937","181241","7664.304375000001","0.099635956875","5.792888863124987E7","753.0755522062499"
"10927","34937","34934","8","34942","181249","7665.40125","0.09965021624999999","5.7936554032499865E7","753.1752024224999"
"10928","34942","34935","8","34943","181257","7665.620625","0.099653068125","5.794421965312486E7","753.2748554906249"
"10929","34943","34939","5","34944","181262","7665.839999999999","0.09965591999999998","5.7951885493124865E7","753.3745114106249"
"10930","34944","34943","5","34948","181267","7666.717500000001","0.0996673275","5.7959552210624866E7","753.4741787381249"
"10931","34948","34940","4","34944","181271","7665.839999999999","0.09965591999999998","5.796721805062487E7","753.573834658125"
"10932","34944","34935","2","34937","181273","7664.304375000001","0.099635956875","5.797488235499987E7","753.6734706149999"
"10933","34937","34928","5","34933","181278","7663.426875000001","0.09962454937500001","5.798254578187487E7","753.7730951643749"
"10934","34933","34927","9","34936","181287","7664.085","0.099633105","5.799020986687487E7","753.8727282693749"
"10935","34936","34934","2","34936","181289","7664.085","0.099633105","5.7997873951874875E7","753.9723613743748"
"10936","34936","34933","7","34940","181296","7664.9625","0.09964451249999999","5.800553891437487E7","754.0720058868749"
"10937","34940","34934","9","34943","181305","7665.620625","0.099653068125","5.801320453499987E7","754.1716589549999"
"10938","34943","34939","5","34944","181310","7665.839999999999","0.09965591999999998","5.802087037499987E7","754.2713148749999"
"10939","34944","34942","9","34951","181319","7667.375625","0.09967588312499999","5.802853775062487E7","754.3709907581249"
"10940","34951","34949","4","34953","181323","7667.814375","0.09968158687499999","5.803620556499987E7","754.4706723449999"
"10941","34953","34948","7","34955","181330","7668.253125","0.099687290625","5.804387381812487E7","754.5703596356249"
"10942","34955","34950","9","34959","181339","7669.130625","0.09969869812499998","5.805154294874987E7","754.6700583337499"
"10943","34959","34956","7","34963","181346","7670.008125","0.099710105625","5.805921295687487E7","754.769768439375"
"10944","34963","34959","2","34961","181348","7669.569375","0.099704401875","5.806688252624987E7","754.86947284125"
"10945","34961","34955","3","34958","181351","7668.911250000001","0.09969584625000001","5.807455143749987E7","754.9691686875"
"10946","34958","34952","5","34957","181356","7668.691875","0.099692994375","5.808222012937488E7","755.068861681875"
"10947","34957","34954","4","34958","181360","7668.911250000001","0.09969584625000001","5.808988904062488E7","755.168557528125"
"10948","34958","34952","1","34953","181361","7667.814375","0.09968158687499999","5.809755685499988E7","755.268239115"
"10949","34953","34952","9","34961","181370","7669.569375","0.099704401875","5.810522642437488E7","755.367943516875"
"10950","34961","34959","2","34961","181372","7669.569375","0.099704401875","5.811289599374988E7","755.46764791875"
"10951","34961","34952","4","34956","181376","7668.4725","0.0996901425","5.8120564466249876E7","755.56733806125"
"10952","34956","34951","1","34952","181377","7667.595","0.09967873499999999","5.8128232061249875E7","755.66701679625"
"10953","34952","34946","7","34953","181384","7667.814375","0.09968158687499999","5.813589987562487E7","755.766698383125"
"10954","34953","34944","9","34953","181393","7667.814375","0.09968158687499999","5.814356768999987E7","755.86637997"
"10955","34953","34949","1","34950","181394","7667.15625","0.09967303124999999","5.815123484624987E7","755.96605300125"
"10956","34950","34946","3","34949","181397","7666.936874999999","0.09967017937499999","5.815890178312487E7","756.065723180625"
"10957","34949","34942","7","34949","181404","7666.936874999999","0.09967017937499999","5.816656871999987E7","756.16539336"
"10958","34949","34944","7","34951","181411","7667.375625","0.09967588312499999","5.817423609562487E7","756.265069243125"
"10959","34951","34942","4","34946","181415","7666.2787499999995","0.09966162374999998","5.8181902374374874E7","756.364730866875"
"10960","34946","34942","7","34949","181422","7666.936874999999","0.09967017937499999","5.8189569311249875E7","756.46440104625"
"10961","34949","34943","8","34951","181430","7667.375625","0.09967588312499999","5.8197236686874874E7","756.564076929375"
"10962","34951","34944","9","34953","181439","7667.814375","0.09968158687499999","5.820490450124987E7","756.66375851625"
"10963","34953","34946","5","34951","181444","7667.375625","0.09967588312499999","5.821257187687487E7","756.763434399375"
"10964","34951","34949","8","34957","181452","7668.691875","0.099692994375","5.8220240568749875E7","756.86312739375"
"10965","34957","34956","7","34963","181459","7670.008125","0.099710105625","5.8227910576874875E7","756.962837499375"
"10966","34963","34954","7","34961","181466","7669.569375","0.099704401875","5.8235580146249875E7","757.06254190125"
"10967","34961","34953","8","34961","181474","7669.569375","0.099704401875","5.824324971562488E7","757.162246303125"
"10968","34961","34956","2","34958","181476","7668.911250000001","0.09969584625000001","5.825091862687488E7","757.261942149375"
"10969","34958","34951","9","34960","181485","7669.35","0.09970155","5.825858797687488E7","757.361643699375"
"10970","34960","34958","3","34961","181488","7669.569375","0.099704401875","5.826625754624988E7","757.46134810125"
"10971","34961","34953","8","34961","181496","7669.569375","0.099704401875","5.827392711562488E7","757.561052503125"
"10972","34961","34952","5","34957","181501","7668.691875","0.099692994375","5.8281595807499886E7","757.6607454975"
"10973","34957","34949","9","34958","181510","7668.911250000001","0.09969584625000001","5.828926471874989E7","757.76044134375"
"10974","34958","34949","2","34951","181512","7667.375625","0.09967588312499999","5.829693209437489E7","757.860117226875"
"10975","34951","34948","8","34956","181520","7668.4725","0.0996901425","5.8304600566874884E7","757.959807369375"
"10976","34956","34952","8","34960","181528","7669.35","0.09970155","5.8312269916874886E7","758.0595089193749"
"10977","34960","34951","9","34960","181537","7669.35","0.09970155","5.831993926687489E7","758.1592104693749"
"10978","34960","34952","1","34953","181538","7667.814375","0.09968158687499999","5.8327607081249885E7","758.2588920562499"
"10979","34953","34944","4","34948","181542","7666.717500000001","0.0996673275","5.833527379874989E7","758.3585593837499"
"10980","34948","34944","3","34947","181545","7666.498125","0.099664475625","5.834294029687489E7","758.4582238593749"
"10981","34947","34941","6","34947","181551","7666.498125","0.099664475625","5.835060679499989E7","758.5578883349999"
"10982","34947","34938","8","34946","181559","7666.2787499999995","0.09966162374999998","5.835827307374989E7","758.6575499587499"
"10983","34946","34938","8","34946","181567","7666.2787499999995","0.09966162374999998","5.8365939352499895E7","758.7572115824998"
"10984","34946","34942","5","34947","181572","7666.498125","0.099664475625","5.83736058506249E7","758.8568760581248"
"10985","34947","34942","6","34948","181578","7666.717500000001","0.0996673275","5.83812725681249E7","758.9565433856249"
"10986","34948","34947","4","34951","181582","7667.375625","0.09967588312499999","5.83889399437499E7","759.0562192687498"
"10987","34951","34942","1","34943","181583","7665.620625","0.099653068125","5.8396605564374894E7","759.1558723368748"
"10988","34943","34942","2","34944","181585","7665.839999999999","0.09965591999999998","5.84042714043749E7","759.2555282568749"
"10989","34944","34938","6","34944","181591","7665.839999999999","0.09965591999999998","5.84119372443749E7","759.3551841768749"
"10990","34944","34943","6","34949","181597","7666.936874999999","0.09967017937499999","5.84196041812499E7","759.4548543562499"
"10991","34949","34944","9","34953","181606","7667.814375","0.09968158687499999","5.84272719956249E7","759.554535943125"
"10992","34953","34951","8","34959","181614","7669.130625","0.09969869812499998","5.84349411262499E7","759.65423464125"
"10993","34959","34956","1","34957","181615","7668.691875","0.099692994375","5.8442609818124905E7","759.753927635625"
"10994","34957","34950","7","34957","181622","7668.691875","0.099692994375","5.845027850999991E7","759.85362063"
"10995","34957","34955","1","34956","181623","7668.4725","0.0996901425","5.8457946982499905E7","759.9533107725"
"10996","34956","34948","7","34955","181630","7668.253125","0.099687290625","5.84656152356249E7","760.052998063125"
"10997","34955","34953","5","34958","181635","7668.911250000001","0.09969584625000001","5.8473284146874905E7","760.152693909375"
"10998","34958","34956","9","34965","181644","7670.446875","0.09971580937499999","5.84809545937499E7","760.25240971875"
"10999","34965","34959","9","34968","181653","7671.105","0.09972436499999998","5.84886256987499E7","760.35213408375"
"11000","34968","34963","3","34966","181656","7670.666249999999","0.09971866124999998","5.84962963649999E7","760.451852745"
"11001","34966","34960","8","34968","181664","7671.105","0.09972436499999998","5.8503967469999894E7","760.55157711"
"11002","34968","34967","5","34972","181669","7671.9825","0.0997357725","5.85116394524999E7","760.6513128825001"
"11003","34972","34971","9","34980","181678","7673.7375","0.0997585875","5.851931318999989E7","760.75107147"
"11004","34980","34971","4","34975","181682","7672.640625","0.09974432812499999","5.852698583062489E7","760.850815798125"
"11005","34975","34972","3","34975","181685","7672.640625","0.09974432812499999","5.853465847124989E7","760.95056012625"
"11006","34975","34971","8","34979","181693","7673.518125","0.099755735625","5.854233198937489E7","761.050315861875"
"11007","34979","34972","8","34980","181701","7673.7375","0.0997585875","5.855000572687489E7","761.150074449375"
"11008","34980","34978","9","34987","181710","7675.273125000001","0.099778550625","5.855768099999989E7","761.249853"
"11009","34987","34981","8","34989","181718","7675.711875","0.09978425437499999","5.856535671187489E7","761.349637254375"
"11010","34989","34981","1","34982","181719","7674.17625","0.09976429125","5.857303088812489E7","761.449401545625"
"11011","34982","34979","5","34984","181724","7674.615","0.09976999499999999","5.858070550312489E7","761.549171540625"
"11012","34984","34975","2","34977","181726","7673.079375","0.09975003187499999","5.858837858249989E7","761.6489215725001"
"11013","34977","34974","4","34978","181730","7673.29875","0.09975288375","5.859605188124989E7","761.7486744562501"
"11014","34978","34977","2","34979","181732","7673.518125","0.099755735625","5.860372539937489E7","761.8484301918751"
"11015","34979","34970","2","34972","181734","7671.9825","0.0997357725","5.861139738187489E7","761.9481659643751"
"11016","34972","34970","3","34973","181737","7672.201875000001","0.099738624375","5.861906958374989E7","762.0479045887502"
"11017","34973","34972","2","34974","181739","7672.421249999999","0.09974147624999999","5.862674200499989E7","762.1476460650001"
"11018","34974","34973","5","34978","181744","7673.29875","0.09975288375","5.863441530374989E7","762.2473989487502"
"11019","34978","34969","9","34978","181753","7673.29875","0.09975288375","5.864208860249989E7","762.3471518325002"
"11020","34978","34975","5","34980","181758","7673.7375","0.0997585875","5.8649762339999884E7","762.4469104200002"
"11021","34980","34975","4","34979","181762","7673.518125","0.099755735625","5.865743585812488E7","762.5466661556252"
"11022","34979","34973","1","34974","181763","7672.421249999999","0.09974147624999999","5.866510827937488E7","762.6464076318751"
"11023","34974","34965","3","34968","181766","7671.105","0.09972436499999998","5.867277938437488E7","762.7461319968752"
"11024","34968","34963","8","34971","181774","7671.7631249999995","0.09973292062499999","5.868045114749988E7","762.8458649175002"
"11025","34971","34969","8","34977","181782","7673.079375","0.09975003187499999","5.868812422687488E7","762.9456149493752"
"11026","34977","34973","1","34974","181783","7672.421249999999","0.09974147624999999","5.869579664812488E7","763.0453564256252"
"11027","34974","34970","1","34971","181784","7671.7631249999995","0.09973292062499999","5.870346841124988E7","763.1450893462502"
"11028","34971","34968","5","34973","181789","7672.201875000001","0.099738624375","5.8711140613124885E7","763.2448279706252"
"11029","34973","34966","1","34967","181790","7670.885625","0.099721513125","5.871881149874988E7","763.3445494837503"
"11030","34967","34958","8","34966","181798","7670.666249999999","0.09971866124999998","5.872648216499988E7","763.4442681450003"
"11031","34966","34963","8","34971","181806","7671.7631249999995","0.09973292062499999","5.873415392812488E7","763.5440010656253"
"11032","34971","34962","3","34965","181809","7670.446875","0.09971580937499999","5.874182437499988E7","763.6437168750002"
"11033","34965","34960","3","34963","181812","7670.008125","0.099710105625","5.874949438312488E7","763.7434269806253"
"11034","34963","34960","4","34964","181816","7670.2275","0.09971295749999999","5.875716461062488E7","763.8431399381252"
"11035","34964","34961","4","34965","181820","7670.446875","0.09971580937499999","5.876483505749988E7","763.9428557475002"
"11036","34965","34962","7","34969","181827","7671.324374999999","0.09972721687499998","5.877250638187488E7","764.0425829643751"
"11037","34969","34965","3","34968","181830","7671.105","0.09972436499999998","5.878017748687488E7","764.1423073293752"
"11038","34968","34959","3","34962","181833","7669.788750000001","0.09970725375","5.878784727562488E7","764.2420145831252"
"11039","34962","34955","9","34964","181842","7670.2275","0.09971295749999999","5.879551750312488E7","764.3417275406251"
"11040","34964","34955","8","34963","181850","7670.008125","0.099710105625","5.880318751124988E7","764.4414376462502"
"11041","34963","34960","2","34962","181852","7669.788750000001","0.09970725375","5.881085729999988E7","764.5411449000002"
"11042","34962","34954","9","34963","181861","7670.008125","0.099710105625","5.881852730812488E7","764.6408550056252"
"11043","34963","34959","6","34965","181867","7670.446875","0.09971580937499999","5.8826197754999876E7","764.7405708150002"
"11044","34965","34956","3","34959","181870","7669.130625","0.09969869812499998","5.883386688562488E7","764.8402695131252"
"11045","34959","34956","4","34960","181874","7669.35","0.09970155","5.884153623562488E7","764.9399710631252"
"11046","34960","34954","1","34955","181875","7668.253125","0.099687290625","5.884920448874988E7","765.0396583537502"
"11047","34955","34952","3","34955","181878","7668.253125","0.099687290625","5.885687274187487E7","765.1393456443751"
"11048","34955","34953","5","34958","181883","7668.911250000001","0.09969584625000001","5.886454165312488E7","765.2390414906251"
"11049","34958","34951","5","34956","181888","7668.4725","0.0996901425","5.887221012562487E7","765.3387316331251"
"11050","34956","34949","6","34955","181894","7668.253125","0.099687290625","5.887987837874987E7","765.4384189237501"
"11051","34955","34952","9","34961","181903","7669.569375","0.099704401875","5.888754794812487E7","765.5381233256251"
"11052","34961","34958","8","34966","181911","7670.666249999999","0.09971866124999998","5.889521861437487E7","765.6378419868751"
"11053","34966","34959","2","34961","181913","7669.569375","0.099704401875","5.890288818374987E7","765.73754638875"
"11054","34961","34960","5","34965","181918","7670.446875","0.09971580937499999","5.891055863062487E7","765.837262198125"
"11055","34965","34961","3","34964","181921","7670.2275","0.09971295749999999","5.891822885812487E7","765.936975155625"
"11056","34964","34959","7","34966","181928","7670.666249999999","0.09971866124999998","5.8925899524374865E7","766.036693816875"
"11057","34966","34961","9","34970","181937","7671.54375","0.09973006875","5.893357106812487E7","766.1364238856249"
"11058","34970","34966","8","34974","181945","7672.421249999999","0.09974147624999999","5.894124348937487E7","766.2361653618749"
"11059","34974","34967","7","34974","181952","7672.421249999999","0.09974147624999999","5.894891591062487E7","766.3359068381249"
"11060","34974","34966","6","34972","181958","7671.9825","0.0997357725","5.895658789312487E7","766.4356426106249"
"11061","34972","34971","6","34977","181964","7673.079375","0.09975003187499999","5.896426097249987E7","766.5353926424999"
"11062","34977","34976","7","34983","181971","7674.395625000001","0.09976714312500001","5.897193536812487E7","766.6351597856249"
"11063","34983","34982","7","34989","181978","7675.711875","0.09978425437499999","5.897961107999987E7","766.7349440399998"
"11064","34989","34984","2","34986","181980","7675.05375","0.09977569874999999","5.898728613374987E7","766.8347197387499"
"11065","34986","34982","7","34989","181987","7675.711875","0.09978425437499999","5.899496184562487E7","766.9345039931248"
"11066","34989","34988","2","34990","181989","7675.93125","0.09978710625","5.900263777687487E7","767.0342910993749"
"11067","34990","34987","1","34988","181990","7675.4925","0.09978140249999999","5.901031326937487E7","767.1340725018748"
"11068","34988","34986","7","34993","181997","7676.589375","0.09979566187499998","5.901798985874987E7","767.2338681637498"
"11069","34993","34990","6","34996","182003","7677.2474999999995","0.09980421749999999","5.902566710624987E7","767.3336723812498"
"11070","34996","34990","2","34992","182005","7676.37","0.09979281","5.9033343476249866E7","767.4334651912499"
"11071","34992","34984","8","34992","182013","7676.37","0.09979281","5.904101984624986E7","767.5332580012499"
"11072","34992","34991","9","35000","182022","7678.125","0.09981562499999999","5.904869797124986E7","767.6330736262499"
"11073","35000","34992","4","34996","182026","7677.2474999999995","0.09980421749999999","5.9056375218749866E7","767.73287784375"
"11074","34996","34993","3","34996","182029","7677.2474999999995","0.09980421749999999","5.906405246624987E7","767.83268206125"
"11075","34996","34994","1","34995","182030","7677.028125","0.09980136562499999","5.907172949437487E7","767.932483426875"
"11076","34995","34992","8","35000","182038","7678.125","0.09981562499999999","5.907940761937487E7","768.032299051875"
"11077","35000","34994","9","35003","182047","7678.783125","0.099824180625","5.908708640249987E7","768.1321232325"
"11078","35003","35000","5","35005","182052","7679.221875","0.099829884375","5.909476562437487E7","768.231953116875"
"11079","35005","35002","8","35010","182060","7680.31875","0.09984414375","5.910244594312487E7","768.3317972606251"
"11080","35010","35001","5","35006","182065","7679.44125","0.09983273625","5.9110125384374864E7","768.4316299968751"
"11081","35006","34997","5","35002","182070","7678.56375","0.09982132875","5.911780394812486E7","768.5314513256251"
"11082","35002","34997","8","35005","182078","7679.221875","0.099829884375","5.912548316999986E7","768.6312812100001"
"11083","35005","34998","6","35004","182084","7679.0025","0.09982703249999998","5.913316217249986E7","768.7311082425001"
"11084","35004","35002","1","35003","182085","7678.783125","0.099824180625","5.9140840955624856E7","768.8309324231251"
"11085","35003","35000","1","35001","182086","7678.344375","0.09981847687499999","5.9148519299999855E7","768.9307509000001"
"11086","35001","34996","9","35005","182095","7679.221875","0.099829884375","5.915619852187485E7","769.0305807843752"
"11087","35005","35003","3","35006","182098","7679.44125","0.09983273625","5.916387796312485E7","769.1304135206252"
"11088","35006","35004","9","35013","182107","7680.976875","0.09985269937499999","5.917155893999985E7","769.2302662200002"
"11089","35013","35005","7","35012","182114","7680.757500000001","0.0998498475","5.917923969749985E7","769.3301160675002"
"11090","35012","35007","8","35015","182122","7681.415625","0.099858403125","5.918692111312485E7","769.4299744706252"
"11091","35015","35011","9","35020","182131","7682.5125","0.09987266249999999","5.919460362562485E7","769.5298471331253"
"11092","35020","35017","1","35018","182132","7682.07375","0.09986695874999998","5.920228569937485E7","769.6297140918753"
"11093","35018","35014","8","35022","182140","7682.95125","0.09987836624999999","5.920996865062485E7","769.7295924581252"
"11094","35022","35013","9","35022","182149","7682.95125","0.09987836624999999","5.921765160187485E7","769.8294708243752"
"11095","35022","35015","6","35021","182155","7682.7318749999995","0.09987551437499999","5.922533433374985E7","769.9293463387502"
"11096","35021","35013","4","35017","182159","7681.854375","0.099864106875","5.923301618812485E7","770.0292104456252"
"11097","35017","35012","2","35014","182161","7681.19625","0.09985555125","5.924069738437485E7","770.1290659968752"
"11098","35014","35013","5","35018","182166","7682.07375","0.09986695874999998","5.9248379458124846E7","770.2289329556252"
"11099","35018","35011","8","35019","182174","7682.293124999999","0.09986981062499999","5.925606175124985E7","770.3288027662502"
"11100","35019","35015","4","35019","182178","7682.293124999999","0.09986981062499999","5.926374404437485E7","770.4286725768752"
"11101","35019","35012","4","35016","182182","7681.634999999999","0.09986125499999998","5.927142567937485E7","770.5285338318752"
"11102","35016","35012","6","35018","182188","7682.07375","0.09986695874999998","5.927910775312485E7","770.6284007906252"
"11103","35018","35017","5","35022","182193","7682.95125","0.09987836624999999","5.928679070437485E7","770.7282791568751"
"11104","35022","35019","1","35020","182194","7682.5125","0.09987266249999999","5.929447321687485E7","770.8281518193752"
"11105","35020","35016","1","35017","182195","7681.854375","0.099864106875","5.930215507124985E7","770.9280159262502"
"11106","35017","35010","4","35014","182199","7681.19625","0.09985555125","5.930983626749985E7","771.0278714775002"
"11107","35014","35006","5","35011","182204","7680.538125","0.09984699562499999","5.931751680562485E7","771.1277184731251"
"11108","35011","35004","9","35013","182213","7680.976875","0.09985269937499999","5.932519778249985E7","771.2275711725001"
"11109","35013","35004","3","35007","182216","7679.660625","0.099835588125","5.933287744312485E7","771.3274067606251"
"11110","35007","35003","7","35010","182223","7680.31875","0.09984414375","5.9340557761874855E7","771.4272509043751"
"11111","35010","35009","1","35010","182224","7680.31875","0.09984414375","5.9348238080624856E7","771.5270950481251"
"11112","35010","35008","7","35015","182231","7681.415625","0.099858403125","5.9355919496249855E7","771.6269534512502"
"11113","35015","35010","3","35013","182234","7680.976875","0.09985269937499999","5.9363600473124854E7","771.7268061506252"
"11114","35013","35008","8","35016","182242","7681.634999999999","0.09986125499999998","5.937128210812485E7","771.8266674056251"
"11115","35016","35008","7","35015","182249","7681.415625","0.099858403125","5.937896352374985E7","771.9265258087502"
"11116","35015","35014","4","35018","182253","7682.07375","0.09986695874999998","5.938664559749985E7","772.0263927675002"
"11117","35018","35011","5","35016","182258","7681.634999999999","0.09986125499999998","5.9394327232499845E7","772.1262540225001"
"11118","35016","35015","2","35017","182260","7681.854375","0.099864106875","5.940200908687484E7","772.2261181293751"
"11119","35017","35016","6","35022","182266","7682.95125","0.09987836624999999","5.9409692038124844E7","772.3259964956251"
"11120","35022","35019","2","35021","182268","7682.7318749999995","0.09987551437499999","5.941737476999985E7","772.42587201"
"11121","35021","35016","4","35020","182272","7682.5125","0.09987266249999999","5.942505728249985E7","772.5257446725001"
"11122","35020","35014","2","35016","182274","7681.634999999999","0.09986125499999998","5.943273891749985E7","772.6256059275"
"11123","35016","35012","5","35017","182279","7681.854375","0.099864106875","5.9440420771874845E7","772.725470034375"
"11124","35017","35016","3","35019","182282","7682.293124999999","0.09986981062499999","5.944810306499985E7","772.825339845"
"11125","35019","35011","8","35019","182290","7682.293124999999","0.09986981062499999","5.945578535812485E7","772.925209655625"
"11126","35019","35011","7","35018","182297","7682.07375","0.09986695874999998","5.946346743187485E7","773.025076614375"
"11127","35018","35017","8","35025","182305","7683.609375","0.09988692187499999","5.947115104124985E7","773.1249635362501"
"11128","35025","35017","6","35023","182311","7683.170625000001","0.099881218125","5.947883421187485E7","773.2248447543751"
"11129","35023","35018","6","35024","182317","7683.389999999999","0.09988406999999999","5.948651760187485E7","773.3247288243751"
"11130","35024","35016","2","35018","182319","7682.07375","0.09986695874999998","5.949419967562485E7","773.4245957831251"
"11131","35018","35012","7","35019","182326","7682.293124999999","0.09986981062499999","5.950188196874985E7","773.5244655937502"
"11132","35019","35012","1","35013","182327","7680.976875","0.09985269937499999","5.950956294562485E7","773.6243182931252"
"11133","35013","35007","4","35011","182331","7680.538125","0.09984699562499999","5.951724348374985E7","773.7241652887501"
"11134","35011","35004","7","35011","182338","7680.538125","0.09984699562499999","5.952492402187485E7","773.824012284375"
"11135","35011","35009","6","35015","182344","7681.415625","0.099858403125","5.953260543749985E7","773.9238706875001"
"11136","35015","35006","7","35013","182351","7680.976875","0.09985269937499999","5.954028641437485E7","774.0237233868751"
"11137","35013","35009","9","35018","182360","7682.07375","0.09986695874999998","5.954796848812485E7","774.1235903456251"
"11138","35018","35017","4","35021","182364","7682.7318749999995","0.09987551437499999","5.955565121999985E7","774.22346586"
"11139","35021","35014","4","35018","182368","7682.07375","0.09986695874999998","5.956333329374985E7","774.32333281875"
"11140","35018","35012","1","35013","182369","7680.976875","0.09985269937499999","5.9571014270624846E7","774.423185518125"
"11141","35013","35008","3","35011","182372","7680.538125","0.09984699562499999","5.957869480874985E7","774.52303251375"
"11142","35011","35003","7","35010","182379","7680.31875","0.09984414375","5.958637512749985E7","774.6228766575"
"11143","35010","35006","5","35011","182384","7680.538125","0.09984699562499999","5.959405566562485E7","774.722723653125"
"11144","35011","35005","3","35008","182387","7679.880000000001","0.09983844","5.960173554562485E7","774.8225620931249"
"11145","35008","35006","4","35010","182391","7680.31875","0.09984414375","5.960941586437485E7","774.922406236875"
"11146","35010","35005","8","35013","182399","7680.976875","0.09985269937499999","5.961709684124985E7","775.02225893625"
"11147","35013","35011","3","35014","182402","7681.19625","0.09985555125","5.962477803749985E7","775.1221144875"
"11148","35014","35009","2","35011","182404","7680.538125","0.09984699562499999","5.963245857562485E7","775.2219614831249"
"11149","35011","35010","7","35017","182411","7681.854375","0.099864106875","5.964014042999985E7","775.3218255899999"
"11150","35017","35014","7","35021","182418","7682.7318749999995","0.09987551437499999","5.964782316187485E7","775.4217011043748"
"11151","35021","35012","4","35016","182422","7681.634999999999","0.09986125499999998","5.965550479687485E7","775.5215623593748"
"11152","35016","35009","9","35018","182431","7682.07375","0.09986695874999998","5.966318687062485E7","775.6214293181248"
"11153","35018","35012","2","35014","182433","7681.19625","0.09985555125","5.967086806687485E7","775.7212848693748"
"11154","35014","35013","2","35015","182435","7681.415625","0.099858403125","5.9678549482499845E7","775.8211432724999"
"11155","35015","35006","3","35009","182438","7680.099375","0.09984129187499999","5.968622958187485E7","775.9209845643749"
"11156","35009","35008","7","35015","182445","7681.415625","0.099858403125","5.9693910997499846E7","776.0208429674999"
"11157","35015","35010","3","35013","182448","7680.976875","0.09985269937499999","5.9701591974374846E7","776.1206956668749"
"11158","35013","35010","4","35014","182452","7681.19625","0.09985555125","5.9709273170624845E7","776.2205512181249"
"11159","35014","35007","3","35010","182455","7680.31875","0.09984414375","5.9716953489374846E7","776.320395361875"
"11160","35010","35005","4","35009","182459","7680.099375","0.09984129187499999","5.972463358874985E7","776.42023665375"
"11161","35009","35002","5","35007","182464","7679.660625","0.099835588125","5.973231324937485E7","776.5200722418749"
"11162","35007","35002","3","35005","182467","7679.221875","0.099829884375","5.973999247124985E7","776.6199021262499"
"11163","35005","34999","6","35005","182473","7679.221875","0.099829884375","5.9747671693124846E7","776.719732010625"
"11164","35005","34998","3","35001","182476","7678.344375","0.09981847687499999","5.9755350037499845E7","776.8195504875"
"11165","35001","34997","5","35002","182481","7678.56375","0.09982132875","5.9763028601249844E7","776.91937181625"
"11166","35002","34995","4","34999","182485","7677.905624999999","0.09981277312499999","5.9770706506874844E7","777.019184589375"
"11167","34999","34995","6","35001","182491","7678.344375","0.09981847687499999","5.9778384851249844E7","777.11900306625"
"11168","35001","34997","7","35004","182498","7679.0025","0.09982703249999998","5.978606385374984E7","777.21883009875"
"11169","35004","35003","3","35006","182501","7679.44125","0.09983273625","5.979374329499984E7","777.318662835"
"11170","35006","35002","5","35007","182506","7679.660625","0.099835588125","5.980142295562484E7","777.418498423125"
"11171","35007","34999","3","35002","182509","7678.56375","0.09982132875","5.980910151937484E7","777.518319751875"
"11172","35002","35001","9","35010","182518","7680.31875","0.09984414375","5.981678183812484E7","777.618163895625"
"11173","35010","35007","3","35010","182521","7680.31875","0.09984414375","5.982446215687484E7","777.718008039375"
"11174","35010","35009","3","35012","182524","7680.757500000001","0.0998498475","5.983214291437484E7","777.817857886875"
"11175","35012","35003","9","35012","182533","7680.757500000001","0.0998498475","5.983982367187484E7","777.917707734375"
"11176","35012","35008","1","35009","182534","7680.099375","0.09984129187499999","5.9847503771249846E7","778.01754902625"
"11177","35009","35006","7","35013","182541","7680.976875","0.09985269937499999","5.9855184748124845E7","778.117401725625"
"11178","35013","35010","1","35011","182542","7680.538125","0.09984699562499999","5.9862865286249846E7","778.2172487212499"
"11179","35011","35010","5","35015","182547","7681.415625","0.099858403125","5.9870546701874845E7","778.317107124375"
"11180","35015","35009","6","35015","182553","7681.415625","0.099858403125","5.987822811749984E7","778.4169655275"
"11181","35015","35006","7","35013","182560","7680.976875","0.09985269937499999","5.988590909437484E7","778.516818226875"
"11182","35013","35010","4","35014","182564","7681.19625","0.09985555125","5.989359029062484E7","778.616673778125"
"11183","35014","35011","6","35017","182570","7681.854375","0.099864106875","5.990127214499984E7","778.716537885"
"11184","35017","35015","5","35020","182575","7682.5125","0.09987266249999999","5.990895465749984E7","778.8164105475"
"11185","35020","35016","7","35023","182582","7683.170625000001","0.099881218125","5.991663782812484E7","778.916291765625"
"11186","35023","35020","4","35024","182586","7683.389999999999","0.09988406999999999","5.9924321218124844E7","779.0161758356251"
"11187","35024","35022","7","35029","182593","7684.486875","0.09989832937499998","5.993200570499984E7","779.1160741650001"
"11188","35029","35026","6","35032","182599","7685.145","0.099906885","5.9939690849999845E7","779.2159810500001"
"11189","35032","35028","5","35033","182604","7685.364375000001","0.099909736875","5.994737621437485E7","779.3158907868751"
"11190","35033","35027","2","35029","182606","7684.486875","0.09989832937499998","5.9955060701249845E7","779.4157891162502"
"11191","35029","35024","5","35029","182611","7684.486875","0.09989832937499998","5.996274518812484E7","779.5156874456252"
"11192","35029","35028","4","35032","182615","7685.145","0.099906885","5.9970430333124846E7","779.6155943306252"
"11193","35032","35024","8","35032","182623","7685.145","0.099906885","5.997811547812485E7","779.7155012156252"
"11194","35032","35029","4","35033","182627","7685.364375000001","0.099909736875","5.998580084249985E7","779.8154109525002"
"11195","35033","35029","4","35033","182631","7685.364375000001","0.099909736875","5.9993486206874855E7","779.9153206893752"
"11196","35033","35030","4","35034","182635","7685.58375","0.09991258874999999","6.000117179062486E7","780.0152332781253"
"11197","35034","35029","9","35038","182644","7686.46125","0.09992399625","6.000885825187486E7","780.1151572743753"
"11198","35038","35036","3","35039","182647","7686.680625","0.099926848125","6.0016544932499856E7","780.2150841225003"
"11199","35039","35034","7","35041","182654","7687.119374999999","0.09993255187499998","6.002423205187485E7","780.3150166743753"
"11200","35041","35032","6","35038","182660","7686.46125","0.09992399625","6.003191851312485E7","780.4149406706254"
"11201","35038","35034","9","35043","182669","7687.558125","0.09993825562499999","6.003960607124985E7","780.5148789262504"
"11202","35043","35041","4","35045","182673","7687.996875","0.09994395937499999","6.004729406812485E7","780.6148228856254"
"11203","35045","35036","3","35039","182676","7686.680625","0.099926848125","6.005498074874985E7","780.7147497337504"
"11204","35039","35033","3","35036","182679","7686.0225","0.09991829249999999","6.006266677124985E7","780.8146680262504"
"11205","35036","35028","9","35037","182688","7686.241875000001","0.099921144375","6.007035301312485E7","780.9145891706254"
"11206","35037","35034","6","35040","182694","7686.9","0.09992969999999998","6.007803991312485E7","781.0145188706254"
"11207","35040","35033","2","35035","182696","7685.803125","0.099915440625","6.008572571624985E7","781.1144343112503"
"11208","35035","35029","5","35034","182701","7685.58375","0.09991258874999999","6.0093411299999855E7","781.2143469000004"
"11209","35034","35031","7","35038","182708","7686.46125","0.09992399625","6.0101097761249855E7","781.3142708962504"
"11210","35038","35037","9","35046","182717","7688.2162499999995","0.09994681124999999","6.010878597749986E7","781.4142177075004"
"11211","35046","35038","7","35045","182724","7687.996875","0.09994395937499999","6.011647397437486E7","781.5141616668753"
"11212","35045","35037","2","35039","182726","7686.680625","0.099926848125","6.012416065499986E7","781.6140885150004"
"11213","35039","35031","6","35037","182732","7686.241875000001","0.099921144375","6.013184689687486E7","781.7140096593754"
"11214","35037","35029","7","35036","182739","7686.0225","0.09991829249999999","6.013953291937486E7","781.8139279518754"
"11215","35036","35029","2","35031","182741","7684.925625","0.09990403312499999","6.014721784499986E7","781.9138319850003"
"11216","35031","35029","9","35038","182750","7686.46125","0.09992399625","6.015490430624986E7","782.0137559812504"
"11217","35038","35033","2","35035","182752","7685.803125","0.099915440625","6.016259010937486E7","782.1136714218753"
"11218","35035","35033","9","35042","182761","7687.33875","0.09993540375","6.0170277448124856E7","782.2136068256253"
"11219","35042","35037","8","35045","182769","7687.996875","0.09994395937499999","6.017796544499986E7","782.3135507850003"
"11220","35045","35037","1","35038","182770","7686.46125","0.09992399625","6.018565190624986E7","782.4134747812503"
"11221","35038","35033","6","35039","182776","7686.680625","0.099926848125","6.019333858687486E7","782.5134016293754"
"11222","35039","35030","9","35039","182785","7686.680625","0.099926848125","6.020102526749986E7","782.6133284775004"
"11223","35039","35030","3","35033","182788","7685.364375000001","0.099909736875","6.020871063187486E7","782.7132382143755"
"11224","35033","35024","5","35029","182793","7684.486875","0.09989832937499998","6.021639511874986E7","782.8131365437505"
"11225","35029","35024","1","35025","182794","7683.609375","0.09988692187499999","6.022407872812486E7","782.9130234656255"
"11226","35025","35019","3","35022","182797","7682.95125","0.09987836624999999","6.023176167937486E7","783.0129018318755"
"11227","35022","35016","7","35023","182804","7683.170625000001","0.099881218125","6.023944484999986E7","783.1127830500005"
"11228","35023","35015","9","35024","182813","7683.389999999999","0.09988406999999999","6.024712823999986E7","783.2126671200006"
"11229","35024","35022","3","35025","182816","7683.609375","0.09988692187499999","6.025481184937486E7","783.3125540418756"
"11230","35025","35019","2","35021","182818","7682.7318749999995","0.09987551437499999","6.026249458124986E7","783.4124295562506"
"11231","35021","35013","9","35022","182827","7682.95125","0.09987836624999999","6.0270177532499865E7","783.5123079225006"
"11232","35022","35013","8","35021","182835","7682.7318749999995","0.09987551437499999","6.027786026437487E7","783.6121834368755"
"11233","35021","35016","1","35017","182836","7681.854375","0.099864106875","6.0285542118749864E7","783.7120475437505"
"11234","35017","35016","6","35022","182842","7682.95125","0.09987836624999999","6.0293225069999866E7","783.8119259100005"
"11235","35022","35017","6","35023","182848","7683.170625000001","0.099881218125","6.030090824062487E7","783.9118071281255"
"11236","35023","35015","8","35023","182856","7683.170625000001","0.099881218125","6.030859141124987E7","784.0116883462505"
"11237","35023","35014","7","35021","182863","7682.7318749999995","0.09987551437499999","6.031627414312487E7","784.1115638606254"
"11238","35021","35017","3","35020","182866","7682.5125","0.09987266249999999","6.0323956655624874E7","784.2114365231255"
"11239","35020","35011","5","35016","182871","7681.634999999999","0.09986125499999998","6.033163829062487E7","784.3112977781254"
"11240","35016","35010","3","35013","182874","7680.976875","0.09985269937499999","6.033931926749987E7","784.4111504775004"
"11241","35013","35011","4","35015","182878","7681.415625","0.099858403125","6.034700068312487E7","784.5110088806255"
"11242","35015","35013","5","35018","182883","7682.07375","0.09986695874999998","6.035468275687487E7","784.6108758393755"
"11243","35018","35012","3","35015","182886","7681.415625","0.099858403125","6.0362364172499865E7","784.7107342425005"
"11244","35015","35014","1","35015","182887","7681.415625","0.099858403125","6.0370045588124864E7","784.8105926456255"
"11245","35015","35012","2","35014","182889","7681.19625","0.09985555125","6.037772678437486E7","784.9104481968756"
"11246","35014","35007","8","35015","182897","7681.415625","0.099858403125","6.038540819999986E7","785.0103066000006"
"11247","35015","35011","6","35017","182903","7681.854375","0.099864106875","6.039309005437486E7","785.1101707068756"
"11248","35017","35013","1","35014","182904","7681.19625","0.09985555125","6.040077125062486E7","785.2100262581256"
"11249","35014","35008","8","35016","182912","7681.634999999999","0.09986125499999998","6.0408452885624856E7","785.3098875131255"
"11250","35016","35009","7","35016","182919","7681.634999999999","0.09986125499999998","6.041613452062485E7","785.4097487681255"
"11251","35016","35007","8","35015","182927","7681.415625","0.099858403125","6.042381593624985E7","785.5096071712505"
"11252","35015","35013","5","35018","182932","7682.07375","0.09986695874999998","6.043149800999985E7","785.6094741300005"
"11253","35018","35009","7","35016","182939","7681.634999999999","0.09986125499999998","6.043917964499985E7","785.7093353850005"
"11254","35016","35015","8","35023","182947","7683.170625000001","0.099881218125","6.044686281562485E7","785.8092166031255"
"11255","35023","35022","7","35029","182954","7684.486875","0.09989832937499998","6.0454547302499846E7","785.9091149325005"
"11256","35029","35022","2","35024","182956","7683.389999999999","0.09988406999999999","6.0462230692499846E7","786.0089990025006"
"11257","35024","35020","3","35023","182959","7683.170625000001","0.099881218125","6.046991386312485E7","786.1088802206256"
"11258","35023","35017","6","35023","182965","7683.170625000001","0.099881218125","6.047759703374985E7","786.2087614387506"
"11259","35023","35018","9","35027","182974","7684.048125","0.099892625625","6.048528108187485E7","786.3086540643756"
"11260","35027","35026","3","35029","182977","7684.486875","0.09989832937499998","6.0492965568749845E7","786.4085523937506"
"11261","35029","35022","2","35024","182979","7683.389999999999","0.09988406999999999","6.0500648958749846E7","786.5084364637506"
"11262","35024","35023","6","35029","182985","7684.486875","0.09989832937499998","6.050833344562484E7","786.6083347931257"
"11263","35029","35021","7","35028","182992","7684.2675","0.0998954775","6.051601771312484E7","786.7082302706257"
"11264","35028","35024","1","35025","182993","7683.609375","0.09988692187499999","6.052370132249984E7","786.8081171925007"
"11265","35025","35019","9","35028","183002","7684.2675","0.0998954775","6.053138558999984E7","786.9080126700007"
"11266","35028","35026","2","35028","183004","7684.2675","0.0998954775","6.053906985749984E7","787.0079081475008"
"11267","35028","35026","8","35034","183012","7685.58375","0.09991258874999999","6.054675544124984E7","787.1078207362508"
"11268","35034","35026","5","35031","183017","7684.925625","0.09990403312499999","6.055444036687484E7","787.2077247693758"
"11269","35031","35024","2","35026","183019","7683.82875","0.09988977375","6.0562124195624836E7","787.3076145431257"
"11270","35026","35025","5","35030","183024","7684.70625","0.09990118125","6.056980890187483E7","787.4075157243757"
"11271","35030","35027","9","35036","183033","7686.0225","0.09991829249999999","6.057749492437483E7","787.5074340168757"
"11272","35036","35033","7","35040","183040","7686.9","0.09992969999999998","6.058518182437483E7","787.6073637168756"
"11273","35040","35031","8","35039","183048","7686.680625","0.099926848125","6.059286850499983E7","787.7072905650007"
"11274","35039","35032","6","35038","183054","7686.46125","0.09992399625","6.060055496624983E7","787.8072145612507"
"11275","35038","35029","5","35034","183059","7685.58375","0.09991258874999999","6.060824054999983E7","787.9071271500007"
"11276","35034","35025","5","35030","183064","7684.70625","0.09990118125","6.061592525624983E7","788.0070283312507"
"11277","35030","35028","7","35035","183071","7685.803125","0.099915440625","6.062361105937483E7","788.1069437718756"
"11278","35035","35034","9","35043","183080","7687.558125","0.09993825562499999","6.063129861749983E7","788.2068820275007"
"11279","35043","35035","9","35044","183089","7687.777499999999","0.09994110749999999","6.063898639499983E7","788.3068231350006"
"11280","35044","35040","2","35042","183091","7687.33875","0.09993540375","6.064667373374983E7","788.4067585387506"
"11281","35042","35036","3","35039","183094","7686.680625","0.099926848125","6.065436041437483E7","788.5066853868757"
"11282","35039","35034","9","35043","183103","7687.558125","0.09993825562499999","6.0662047972499825E7","788.6066236425007"
"11283","35043","35040","1","35041","183104","7687.119374999999","0.09993255187499998","6.066973509187482E7","788.7065561943757"
"11284","35041","35040","6","35046","183110","7688.2162499999995","0.09994681124999999","6.0677423308124825E7","788.8065030056257"
"11285","35046","35037","7","35044","183117","7687.777499999999","0.09994110749999999","6.068511108562483E7","788.9064441131256"
"11286","35044","35040","1","35041","183118","7687.119374999999","0.09993255187499998","6.069279820499983E7","789.0063766650006"
"11287","35041","35038","5","35043","183123","7687.558125","0.09993825562499999","6.070048576312482E7","789.1063149206257"
"11288","35043","35037","9","35046","183132","7688.2162499999995","0.09994681124999999","6.0708173979374826E7","789.2062617318757"
"11289","35046","35043","6","35049","183138","7688.874374999999","0.09995536687499999","6.071586285374983E7","789.3062170987506"
"11290","35049","35044","5","35049","183143","7688.874374999999","0.09995536687499999","6.072355172812483E7","789.4061724656256"
"11291","35049","35046","4","35050","183147","7689.09375","0.09995821875","6.073124082187483E7","789.5061306843755"
"11292","35050","35046","7","35053","183154","7689.751875","0.099966774375","6.0738930573749825E7","789.6060974587506"
"11293","35053","35052","2","35054","183156","7689.97125","0.09996962624999998","6.074662054499982E7","789.7060670850005"
"11294","35054","35048","6","35054","183162","7689.97125","0.09996962624999998","6.075431051624982E7","789.8060367112505"
"11295","35054","35053","3","35056","183165","7690.41","0.09997532999999999","6.076200092624982E7","789.9060120412505"
"11296","35056","35047","4","35051","183169","7689.313125","0.099961070625","6.076969023937482E7","790.0059731118755"
"11297","35051","35046","5","35051","183174","7689.313125","0.099961070625","6.0777379552499816E7","790.1059341825005"
"11298","35051","35043","9","35052","183183","7689.5325","0.0999639225","6.0785069084999815E7","790.2058981050005"
"11299","35052","35050","6","35056","183189","7690.41","0.09997532999999999","6.079275949499981E7","790.3058734350005"
"11300","35056","35049","2","35051","183191","7689.313125","0.099961070625","6.080044880812481E7","790.4058345056255"
"11301","35051","35047","1","35048","183192","7688.655000000001","0.099952515","6.080813746312481E7","790.5057870206256"
"11302","35048","35042","7","35049","183199","7688.874374999999","0.09995536687499999","6.081582633749981E7","790.6057423875005"
"11303","35049","35044","6","35050","183205","7689.09375","0.09995821875","6.082351543124981E7","790.7057006062505"
"11304","35050","35046","4","35050","183209","7689.09375","0.09995821875","6.083120452499981E7","790.8056588250005"
"11305","35050","35046","5","35051","183214","7689.313125","0.099961070625","6.083889383812481E7","790.9056198956255"
"11306","35051","35043","2","35045","183216","7687.996875","0.09994395937499999","6.0846581834999815E7","791.0055638550004"
"11307","35045","35037","9","35046","183225","7688.2162499999995","0.09994681124999999","6.085427005124982E7","791.1055106662504"
"11308","35046","35043","6","35049","183231","7688.874374999999","0.09995536687499999","6.086195892562482E7","791.2054660331254"
"11309","35049","35042","7","35049","183238","7688.874374999999","0.09995536687499999","6.086964779999982E7","791.3054214000003"
"11310","35049","35047","8","35055","183246","7690.190625","0.099972478125","6.0877337990624815E7","791.4053938781253"
"11311","35055","35054","5","35059","183251","7691.068125","0.09998388562499999","6.088502905874982E7","791.5053777637503"
"11312","35059","35057","3","35060","183254","7691.2875","0.09998673749999999","6.089272034624982E7","791.6053645012503"
"11313","35060","35051","1","35052","183255","7689.5325","0.0999639225","6.090040987874982E7","791.7053284237503"
"11314","35052","35047","8","35055","183263","7690.190625","0.099972478125","6.0908100069374815E7","791.8053009018753"
"11315","35055","35046","6","35052","183269","7689.5325","0.0999639225","6.091578960187481E7","791.9052648243753"
"11316","35052","35047","1","35048","183270","7688.655000000001","0.099952515","6.0923478256874815E7","792.0052173393753"
"11317","35048","35043","9","35052","183279","7689.5325","0.0999639225","6.093116778937481E7","792.1051812618754"
"11318","35052","35049","9","35058","183288","7690.848750000001","0.09998103375","6.0938858638124816E7","792.2051622956254"
"11319","35058","35050","3","35053","183291","7689.751875","0.099966774375","6.0946548389999814E7","792.3051290700005"
"11320","35053","35048","4","35052","183295","7689.5325","0.0999639225","6.095423792249981E7","792.4050929925005"
"11321","35052","35049","2","35051","183297","7689.313125","0.099961070625","6.096192723562481E7","792.5050540631255"
"11322","35051","35042","8","35050","183305","7689.09375","0.09995821875","6.096961632937481E7","792.6050122818755"
"11323","35050","35043","9","35052","183314","7689.5325","0.0999639225","6.097730586187481E7","792.7049762043755"
"11324","35052","35044","3","35047","183317","7688.435625","0.09994966312499999","6.098499429749981E7","792.8049258675005"
"11325","35047","35041","6","35047","183323","7688.435625","0.09994966312499999","6.0992682733124815E7","792.9048755306255"
"11326","35047","35039","2","35041","183325","7687.119374999999","0.09993255187499998","6.100036985249981E7","793.0048080825005"
"11327","35041","35039","3","35042","183328","7687.33875","0.09993540375","6.100805719124981E7","793.1047434862505"
"11328","35042","35036","4","35040","183332","7686.9","0.09992969999999998","6.101574409124981E7","793.2046731862505"
"11329","35040","35036","5","35041","183337","7687.119374999999","0.09993255187499998","6.102343121062481E7","793.3046057381255"
"11330","35041","35039","1","35040","183338","7686.9","0.09992969999999998","6.1031118110624805E7","793.4045354381254"
"11331","35040","35032","9","35041","183347","7687.119374999999","0.09993255187499998","6.10388052299998E7","793.5044679900004"
"11332","35041","35039","1","35040","183348","7686.9","0.09992969999999998","6.10464921299998E7","793.6043976900004"
"11333","35040","35032","8","35040","183356","7686.9","0.09992969999999998","6.10541790299998E7","793.7043273900003"
"11334","35040","35038","6","35044","183362","7687.777499999999","0.09994110749999999","6.10618668074998E7","793.8042684975003"
"11335","35044","35042","8","35050","183370","7689.09375","0.09995821875","6.10695559012498E7","793.9042267162503"
"11336","35050","35047","1","35048","183371","7688.655000000001","0.099952515","6.1077244556249805E7","794.0041792312503"
"11337","35048","35044","4","35048","183375","7688.655000000001","0.099952515","6.1084933211249806E7","794.1041317462503"
"11338","35048","35046","3","35049","183378","7688.874374999999","0.09995536687499999","6.109262208562481E7","794.2040871131253"
"11339","35049","35042","6","35048","183384","7688.655000000001","0.099952515","6.110031074062481E7","794.3040396281253"
"11340","35048","35039","4","35043","183388","7687.558125","0.09993825562499999","6.1107998298749804E7","794.4039778837504"
"11341","35043","35041","7","35048","183395","7688.655000000001","0.099952515","6.1115686953749806E7","794.5039303987504"
"11342","35048","35042","6","35048","183401","7688.655000000001","0.099952515","6.112337560874981E7","794.6038829137505"
"11343","35048","35043","4","35047","183405","7688.435625","0.09994966312499999","6.113106404437481E7","794.7038325768755"
"11344","35047","35044","2","35046","183407","7688.2162499999995","0.09994681124999999","6.113875226062481E7","794.8037793881255"
"11345","35046","35045","2","35047","183409","7688.435625","0.09994966312499999","6.114644069624981E7","794.9037290512505"
"11346","35047","35038","8","35046","183417","7688.2162499999995","0.09994681124999999","6.1154128912499815E7","795.0036758625005"
"11347","35046","35037","3","35040","183420","7686.9","0.09992969999999998","6.1161815812499814E7","795.1036055625004"
"11348","35040","35031","5","35036","183425","7686.0225","0.09991829249999999","6.1169501834999815E7","795.2035238550004"
"11349","35036","35033","8","35041","183433","7687.119374999999","0.09993255187499998","6.117718895437481E7","795.3034564068754"
"11350","35041","35034","4","35038","183437","7686.46125","0.09992399625","6.118487541562481E7","795.4033804031254"
"11351","35038","35032","8","35040","183445","7686.9","0.09992969999999998","6.119256231562481E7","795.5033101031254"
"11352","35040","35037","6","35043","183451","7687.558125","0.09993825562499999","6.120024987374981E7","795.6032483587504"
"11353","35043","35038","8","35046","183459","7688.2162499999995","0.09994681124999999","6.120793808999981E7","795.7031951700004"
"11354","35046","35044","6","35050","183465","7689.09375","0.09995821875","6.121562718374981E7","795.8031533887504"
"11355","35050","35044","1","35045","183466","7687.996875","0.09994395937499999","6.122331518062481E7","795.9030973481254"
"11356","35045","35036","1","35037","183467","7686.241875000001","0.099921144375","6.123100142249981E7","796.0030184925004"
"11357","35037","35034","9","35043","183476","7687.558125","0.09993825562499999","6.123868898062481E7","796.1029567481254"
"11358","35043","35039","6","35045","183482","7687.996875","0.09994395937499999","6.124637697749981E7","796.2029007075004"
"11359","35045","35039","9","35048","183491","7688.655000000001","0.099952515","6.1254065632499814E7","796.3028532225004"
"11360","35048","35045","3","35048","183494","7688.655000000001","0.099952515","6.1261754287499815E7","796.4028057375004"
"11361","35048","35043","2","35045","183496","7687.996875","0.09994395937499999","6.126944228437482E7","796.5027496968754"
"11362","35045","35042","3","35045","183499","7687.996875","0.09994395937499999","6.127713028124982E7","796.6026936562504"
"11363","35045","35042","6","35048","183505","7688.655000000001","0.099952515","6.128481893624982E7","796.7026461712504"
"11364","35048","35039","3","35042","183508","7687.33875","0.09993540375","6.129250627499982E7","796.8025815750004"
"11365","35042","35041","8","35049","183516","7688.874374999999","0.09995536687499999","6.130019514937482E7","796.9025369418754"
"11366","35049","35040","4","35044","183520","7687.777499999999","0.09994110749999999","6.1307882926874824E7","797.0024780493753"
"11367","35044","35038","7","35045","183527","7687.996875","0.09994395937499999","6.131557092374983E7","797.1024220087503"
"11368","35045","35038","1","35039","183528","7686.680625","0.099926848125","6.1323257604374826E7","797.2023488568753"
"11369","35039","35032","3","35035","183531","7685.803125","0.099915440625","6.133094340749983E7","797.3022642975003"
"11370","35035","35027","8","35035","183539","7685.803125","0.099915440625","6.133862921062483E7","797.4021797381253"
"11371","35035","35034","8","35042","183547","7687.33875","0.09993540375","6.1346316549374826E7","797.5021151418753"
"11372","35042","35041","2","35043","183549","7687.558125","0.09993825562499999","6.135400410749982E7","797.6020533975003"
"11373","35043","35042","4","35046","183553","7688.2162499999995","0.09994681124999999","6.1361692323749825E7","797.7020002087503"
"11374","35046","35042","7","35049","183560","7688.874374999999","0.09995536687499999","6.1369381198124826E7","797.8019555756252"
"11375","35049","35046","7","35053","183567","7689.751875","0.099966774375","6.1377070949999824E7","797.9019223500003"
"11376","35053","35046","7","35053","183574","7689.751875","0.099966774375","6.138476070187482E7","798.0018891243753"
"11377","35053","35052","2","35054","183576","7689.97125","0.09996962624999998","6.139245067312482E7","798.1018587506253"
"11378","35054","35047","8","35055","183584","7690.190625","0.099972478125","6.140014086374982E7","798.2018312287503"
"11379","35055","35054","1","35055","183585","7690.190625","0.099972478125","6.1407831054374814E7","798.3018037068753"
"11380","35055","35046","8","35054","183593","7689.97125","0.09996962624999998","6.141552102562481E7","798.4017733331252"
"11381","35054","35048","9","35057","183602","7690.629375","0.099978181875","6.1423211654999815E7","798.5017515150003"
"11382","35057","35050","9","35059","183611","7691.068125","0.09998388562499999","6.143090272312482E7","798.6017354006252"
"11383","35059","35052","6","35058","183617","7690.848750000001","0.09998103375","6.143859357187482E7","798.7017164343753"
"11384","35058","35051","4","35055","183621","7690.190625","0.099972478125","6.144628376249982E7","798.8016889125003"
"11385","35055","35049","8","35057","183629","7690.629375","0.099978181875","6.145397439187482E7","798.9016670943753"
"11386","35057","35049","9","35058","183638","7690.848750000001","0.09998103375","6.146166524062482E7","799.0016481281253"
"11387","35058","35054","6","35060","183644","7691.2875","0.09998673749999999","6.1469356528124824E7","799.1016348656253"
"11388","35060","35052","5","35057","183649","7690.629375","0.099978181875","6.147704715749983E7","799.2016130475004"
"11389","35057","35053","3","35056","183652","7690.41","0.09997532999999999","6.1484737567499824E7","799.3015883775004"
"11390","35056","35050","8","35058","183660","7690.848750000001","0.09998103375","6.149242841624983E7","799.4015694112504"
"11391","35058","35054","7","35061","183667","7691.506875","0.099989589375","6.150011992312483E7","799.5015590006254"
"11392","35061","35059","8","35067","183675","7692.823125","0.10000670062499999","6.1507812746249825E7","799.6015657012505"
"11393","35067","35066","6","35072","183681","7693.92","0.10002095999999999","6.151550666624983E7","799.7015866612505"
"11394","35072","35071","9","35080","183690","7695.675","0.100043775","6.152320234124982E7","799.8016304362505"
"11395","35080","35079","6","35085","183696","7696.771875","0.100058034375","6.1530899113124825E7","799.9016884706256"
"11396","35085","35079","8","35087","183704","7697.210625000001","0.100063738125","6.1538596323749825E7","800.0017522087505"
"11397","35087","35080","7","35087","183711","7697.210625000001","0.100063738125","6.1546293534374826E7","800.1018159468755"
"11398","35087","35081","5","35086","183716","7696.99125","0.10006088625","6.155399052562483E7","800.2018768331255"
"11399","35086","35084","2","35086","183718","7696.99125","0.10006088625","6.156168751687483E7","800.3019377193756"
"11400","35086","35080","8","35088","183726","7697.43","0.10006659","6.156938494687483E7","800.4020043093756"
"11401","35088","35087","2","35089","183728","7697.649375","0.100069441875","6.1577082596249826E7","800.5020737512506"
"11402","35089","35084","7","35091","183735","7698.088124999999","0.10007514562499999","6.1584780684374824E7","800.6021488968756"
"11403","35091","35087","4","35091","183739","7698.088124999999","0.10007514562499999","6.159247877249982E7","800.7022240425007"
"11404","35091","35086","7","35093","183746","7698.526875","0.10008084937499999","6.160017729937482E7","800.8023048918757"
"11405","35093","35090","5","35095","183751","7698.965625","0.10008655312499999","6.160787626499982E7","800.9023914450007"
"11406","35095","35088","5","35093","183756","7698.526875","0.10008084937499999","6.161557479187482E7","801.0024722943757"
"11407","35093","35092","3","35095","183759","7698.965625","0.10008655312499999","6.162327375749982E7","801.1025588475007"
"11408","35095","35090","4","35094","183763","7698.746249999999","0.10008370124999999","6.1630972503749825E7","801.2026425487508"
"11409","35094","35093","4","35097","183767","7699.404375","0.100092256875","6.163867190812483E7","801.3027348056257"
"11410","35097","35095","3","35098","183770","7699.623750000001","0.10009510875000001","6.164637153187483E7","801.4028299143757"
"11411","35098","35090","3","35093","183773","7698.526875","0.10008084937499999","6.1654070058749825E7","801.5029107637507"
"11412","35093","35085","6","35091","183779","7698.088124999999","0.10007514562499999","6.166176814687482E7","801.6029859093758"
"11413","35091","35087","8","35095","183787","7698.965625","0.10008655312499999","6.1669467112499826E7","801.7030724625008"
"11414","35095","35094","4","35098","183791","7699.623750000001","0.10009510875000001","6.167716673624983E7","801.8031675712508"
"11415","35098","35091","6","35097","183797","7699.404375","0.100092256875","6.168486614062483E7","801.9032598281258"
"11416","35097","35092","5","35097","183802","7699.404375","0.100092256875","6.169256554499983E7","802.0033520850008"
"11417","35097","35088","7","35095","183809","7698.965625","0.10008655312499999","6.170026451062483E7","802.1034386381258"
"11418","35095","35087","6","35093","183815","7698.526875","0.10008084937499999","6.170796303749983E7","802.2035194875008"
"11419","35093","35086","7","35093","183822","7698.526875","0.10008084937499999","6.171566156437483E7","802.3036003368758"
"11420","35093","35088","9","35097","183831","7699.404375","0.100092256875","6.172336096874983E7","802.4036925937507"
"11421","35097","35095","4","35099","183835","7699.843124999999","0.10009796062499998","6.173106081187483E7","802.5037905543758"
"11422","35099","35090","7","35097","183842","7699.404375","0.100092256875","6.173876021624983E7","802.6038828112507"
"11423","35097","35092","7","35099","183849","7699.843124999999","0.10009796062499998","6.174646005937483E7","802.7039807718758"
"11424","35099","35096","1","35097","183850","7699.404375","0.100092256875","6.175415946374983E7","802.8040730287507"
"11425","35097","35091","4","35095","183854","7698.965625","0.10008655312499999","6.176185842937484E7","802.9041595818758"
"11426","35095","35087","4","35091","183858","7698.088124999999","0.10007514562499999","6.1769556517499834E7","803.0042347275008"
"11427","35091","35082","8","35090","183866","7697.86875","0.10007229374999999","6.177725438624983E7","803.1043070212509"
"11428","35090","35083","9","35092","183875","7698.3075","0.10007799749999999","6.178495269374983E7","803.2043850187508"
"11429","35092","35085","3","35088","183878","7697.43","0.10006659","6.179265012374983E7","803.3044516087508"
"11430","35088","35079","2","35081","183880","7695.894375","0.10004662687499999","6.1800346018124826E7","803.4044982356259"
"11431","35081","35079","1","35080","183881","7695.675","0.100043775","6.180804169312482E7","803.5045420106259"
"11432","35080","35074","7","35081","183888","7695.894375","0.10004662687499999","6.181573758749982E7","803.6045886375009"
"11433","35081","35078","6","35084","183894","7696.5525","0.10005518249999999","6.182343413999982E7","803.7046438200009"
"11434","35084","35082","9","35091","183903","7698.088124999999","0.10007514562499999","6.183113222812482E7","803.804718965626"
"11435","35091","35087","1","35088","183904","7697.43","0.10006659","6.183882965812482E7","803.904785555626"
"11436","35088","35080","7","35087","183911","7697.210625000001","0.100063738125","6.184652686874982E7","804.0048492937509"
"11437","35087","35084","6","35090","183917","7697.86875","0.10007229374999999","6.185422473749982E7","804.1049215875009"
"11438","35090","35084","8","35092","183925","7698.3075","0.10007799749999999","6.1861923044999816E7","804.2049995850009"
"11439","35092","35083","7","35090","183932","7697.86875","0.10007229374999999","6.1869620913749814E7","804.3050718787509"
"11440","35090","35081","4","35085","183936","7696.771875","0.100058034375","6.1877317685624816E7","804.405129913126"
"11441","35085","35077","3","35080","183939","7695.675","0.100043775","6.188501336062481E7","804.505173688126"
"11442","35080","35079","1","35080","183940","7695.675","0.100043775","6.189270903562481E7","804.605217463126"
"11443","35080","35074","3","35077","183943","7695.016875","0.100035219375","6.190040405249981E7","804.7052526825009"
"11444","35077","35076","5","35081","183948","7695.894375","0.10004662687499999","6.1908099946874805E7","804.805299309376"
"11445","35081","35077","3","35080","183951","7695.675","0.100043775","6.19157956218748E7","804.905343084376"
"11446","35080","35076","4","35080","183955","7695.675","0.100043775","6.19234912968748E7","805.005386859376"
"11447","35080","35078","1","35079","183956","7695.455625","0.10004092312499999","6.19311867524998E7","805.105427782501"
"11448","35079","35078","1","35079","183957","7695.455625","0.10004092312499999","6.1938882208124794E7","805.205468705626"
"11449","35079","35070","4","35074","183961","7694.358749999999","0.10002666374999998","6.1946576566874795E7","805.305495369376"
"11450","35074","35065","3","35068","183964","7693.0425","0.10000955249999999","6.195426960937479E7","805.405504921876"
"11451","35068","35063","1","35064","183965","7692.165","0.099998145","6.196196177437479E7","805.5055030668759"
"11452","35064","35062","4","35066","183969","7692.603749999999","0.10000384874999999","6.196965437812479E7","805.6055069156259"
"11453","35066","35057","9","35066","183978","7692.603749999999","0.10000384874999999","6.197734698187479E7","805.705510764376"
"11454","35066","35063","1","35064","183979","7692.165","0.099998145","6.1985039146874785E7","805.8055089093759"
"11455","35064","35057","2","35059","183981","7691.068125","0.09998388562499999","6.199273021499979E7","805.9054927950009"
"11456","35059","35054","5","35059","183986","7691.068125","0.09998388562499999","6.200042128312479E7","806.0054766806259"
"11457","35059","35052","3","35055","183989","7690.190625","0.099972478125","6.200811147374979E7","806.1054491587508"
"11458","35055","35051","8","35059","183997","7691.068125","0.09998388562499999","6.201580254187479E7","806.2054330443758"
"11459","35059","35053","4","35057","184001","7690.629375","0.099978181875","6.202349317124979E7","806.3054112262508"
"11460","35057","35052","3","35055","184004","7690.190625","0.099972478125","6.203118336187479E7","806.4053837043758"
"11461","35055","35048","3","35051","184007","7689.313125","0.099961070625","6.203887267499979E7","806.5053447750008"
"11462","35051","35045","2","35047","184009","7688.435625","0.09994966312499999","6.204656111062479E7","806.6052944381258"
"11463","35047","35038","8","35046","184017","7688.2162499999995","0.09994681124999999","6.205424932687479E7","806.7052412493758"
"11464","35046","35041","5","35046","184022","7688.2162499999995","0.09994681124999999","6.2061937543124795E7","806.8051880606258"
"11465","35046","35045","5","35050","184027","7689.09375","0.09995821875","6.2069626636874795E7","806.9051462793758"
"11466","35050","35043","9","35052","184036","7689.5325","0.0999639225","6.2077316169374794E7","807.0051102018758"
"11467","35052","35051","3","35054","184039","7689.97125","0.09996962624999998","6.208500614062479E7","807.1050798281258"
"11468","35054","35050","8","35058","184047","7690.848750000001","0.09998103375","6.2092696989374794E7","807.2050608618758"
"11469","35058","35053","4","35057","184051","7690.629375","0.099978181875","6.21003876187498E7","807.3050390437509"
"11470","35057","35048","4","35052","184055","7689.5325","0.0999639225","6.2108077151249796E7","807.4050029662509"
"11471","35052","35045","4","35049","184059","7688.874374999999","0.09995536687499999","6.21157660256248E7","807.5049583331258"
"11472","35049","35044","7","35051","184066","7689.313125","0.099961070625","6.2123455338749796E7","807.6049194037508"
"11473","35051","35045","6","35051","184072","7689.313125","0.099961070625","6.2131144651874796E7","807.7048804743758"
"11474","35051","35044","9","35053","184081","7689.751875","0.099966774375","6.2138834403749794E7","807.8048472487509"
"11475","35053","35049","8","35057","184089","7690.629375","0.099978181875","6.21465250331248E7","807.9048254306259"
"11476","35057","35050","7","35057","184096","7690.629375","0.099978181875","6.21542156624998E7","808.004803612501"
"11477","35057","35048","8","35056","184104","7690.41","0.09997532999999999","6.21619060724998E7","808.104778942501"
"11478","35056","35052","8","35060","184112","7691.2875","0.09998673749999999","6.21695973599998E7","808.204765680001"
"11479","35060","35052","4","35056","184116","7690.41","0.09997532999999999","6.2177287769999795E7","808.304741010001"
"11480","35056","35055","7","35062","184123","7691.726250000001","0.09999244125000001","6.2184979496249795E7","808.404733451251"
"11481","35062","35057","2","35059","184125","7691.068125","0.09998388562499999","6.21926705643748E7","808.504717336876"
"11482","35059","35054","5","35059","184130","7691.068125","0.09998388562499999","6.22003616324998E7","808.6047012225009"
"11483","35059","35053","4","35057","184134","7690.629375","0.099978181875","6.22080522618748E7","808.704679404376"
"11484","35057","35053","4","35057","184138","7690.629375","0.099978181875","6.2215742891249806E7","808.804657586251"
"11485","35057","35054","4","35058","184142","7690.848750000001","0.09998103375","6.222343373999981E7","808.904638620001"
"11486","35058","35056","4","35060","184146","7691.2875","0.09998673749999999","6.223112502749981E7","809.004625357501"
"11487","35060","35052","5","35057","184151","7690.629375","0.099978181875","6.223881565687481E7","809.1046035393761"
"11488","35057","35055","8","35063","184159","7691.945625","0.099995293125","6.224650760249981E7","809.204598832501"
"11489","35063","35061","2","35063","184161","7691.945625","0.099995293125","6.225419954812481E7","809.304594125626"
"11490","35063","35061","3","35064","184164","7692.165","0.099998145","6.226189171312481E7","809.4045922706259"
"11491","35064","35061","5","35066","184169","7692.603749999999","0.10000384874999999","6.226958431687481E7","809.504596119376"
"11492","35066","35061","4","35065","184173","7692.384375","0.10000099687499998","6.227727670124981E7","809.6045971162509"
"11493","35065","35060","4","35064","184177","7692.165","0.099998145","6.228496886624981E7","809.7045952612509"
"11494","35064","35061","1","35062","184178","7691.726250000001","0.09999244125000001","6.229266059249981E7","809.804587702501"
"11495","35062","35053","8","35061","184186","7691.506875","0.099989589375","6.230035209937481E7","809.904577291876"
"11496","35061","35053","8","35061","184194","7691.506875","0.099989589375","6.230804360624981E7","810.004566881251"
"11497","35061","35056","2","35058","184196","7690.848750000001","0.09998103375","6.231573445499981E7","810.104547915001"
"11498","35058","35055","1","35056","184197","7690.41","0.09997532999999999","6.232342486499981E7","810.204523245001"
"11499","35056","35053","1","35054","184198","7689.97125","0.09996962624999998","6.2331114836249806E7","810.304492871251"
"11500","35054","35053","3","35056","184201","7690.41","0.09997532999999999","6.23388052462498E7","810.404468201251"
"11501","35056","35047","4","35051","184205","7689.313125","0.099961070625","6.23464945593748E7","810.504429271876"
"11502","35051","35046","1","35047","184206","7688.435625","0.09994966312499999","6.23541829949998E7","810.604378935001"
"11503","35047","35046","2","35048","184208","7688.655000000001","0.099952515","6.2361871649999805E7","810.7043314500011"
"11504","35048","35040","9","35049","184217","7688.874374999999","0.09995536687499999","6.2369560524374805E7","810.804286816876"
"11505","35049","35040","9","35049","184226","7688.874374999999","0.09995536687499999","6.2377249398749806E7","810.904242183751"
"11506","35049","35046","6","35052","184232","7689.5325","0.0999639225","6.2384938931249805E7","811.004206106251"
"11507","35052","35048","4","35052","184236","7689.5325","0.0999639225","6.23926284637498E7","811.104170028751"
"11508","35052","35048","7","35055","184243","7690.190625","0.099972478125","6.24003186543748E7","811.204142506876"
"11509","35055","35051","8","35059","184251","7691.068125","0.09998388562499999","6.24080097224998E7","811.304126392501"
"11510","35059","35052","7","35059","184258","7691.068125","0.09998388562499999","6.2415700790624805E7","811.4041102781259"
"11511","35059","35058","7","35065","184265","7692.384375","0.10000099687499998","6.24233931749998E7","811.5041112750009"
"11512","35065","35064","2","35066","184267","7692.603749999999","0.10000384874999999","6.24310857787498E7","811.604115123751"
"11513","35066","35061","3","35064","184270","7692.165","0.099998145","6.24387779437498E7","811.7041132687509"
"11514","35064","35063","6","35069","184276","7693.261874999999","0.10001240437499999","6.2446471205624804E7","811.8041256731259"
"11515","35069","35061","5","35066","184281","7692.603749999999","0.10000384874999999","6.24541638093748E7","811.9041295218759"
"11516","35066","35065","7","35072","184288","7693.92","0.10002095999999999","6.24618577293748E7","812.004150481876"
"11517","35072","35064","1","35065","184289","7692.384375","0.10000099687499998","6.24695501137498E7","812.104151478751"
"11518","35065","35063","4","35067","184293","7692.823125","0.10000670062499999","6.24772429368748E7","812.204158179376"
"11519","35067","35062","8","35070","184301","7693.48125","0.10001525624999999","6.24849364181248E7","812.304173435626"
"11520","35070","35065","4","35069","184305","7693.261874999999","0.10001240437499999","6.2492629679999806E7","812.404185840001"
"11521","35069","35068","7","35075","184312","7694.578125","0.100029515625","6.2500324258124806E7","812.504215355626"
"11522","35075","35073","1","35074","184313","7694.358749999999","0.10002666374999998","6.250801861687481E7","812.604242019376"
"11523","35074","35069","4","35073","184317","7694.139375000001","0.10002381187500001","6.251571275624981E7","812.704265831251"
"11524","35073","35072","9","35081","184326","7695.894375","0.10004662687499999","6.2523408650624804E7","812.804312458126"
"11525","35081","35080","6","35086","184332","7696.99125","0.10006088625","6.2531105641874805E7","812.904373344376"
"11526","35086","35080","6","35086","184338","7696.99125","0.10006088625","6.2538802633124806E7","813.0044342306261"
"11527","35086","35083","2","35085","184340","7696.771875","0.100058034375","6.254649940499981E7","813.1044922650011"
"11528","35085","35081","4","35085","184344","7696.771875","0.100058034375","6.255419617687481E7","813.2045502993761"
"11529","35085","35079","8","35087","184352","7697.210625000001","0.100063738125","6.256189338749981E7","813.3046140375011"
"11530","35087","35080","6","35086","184358","7696.99125","0.10006088625","6.256959037874981E7","813.4046749237511"
"11531","35086","35080","8","35088","184366","7697.43","0.10006659","6.257728780874981E7","813.5047415137511"
"11532","35088","35082","7","35089","184373","7697.649375","0.100069441875","6.258498545812481E7","813.6048109556261"
"11533","35089","35087","9","35096","184382","7699.1849999999995","0.10008940499999999","6.259268464312481E7","813.7049003606261"
"11534","35096","35093","9","35102","184391","7700.50125","0.10010651625","6.260038514437481E7","813.8050068768761"
"11535","35102","35094","8","35102","184399","7700.50125","0.10010651625","6.260808564562481E7","813.905113393126"
"11536","35102","35094","9","35103","184408","7700.720625","0.10010936812499999","6.261578636624981E7","814.005222761251"
"11537","35103","35095","8","35103","184416","7700.720625","0.10010936812499999","6.2623487086874805E7","814.105332129376"
"11538","35103","35102","3","35105","184419","7701.159375","0.100115071875","6.26311882462498E7","814.2054472012511"
"11539","35105","35101","9","35110","184428","7702.25625","0.10012933125","6.2638890502499804E7","814.305576532501"
"11540","35110","35109","9","35118","184437","7704.01125","0.10015214624999999","6.26465945137498E7","814.4057286787511"
"11541","35118","35111","8","35119","184445","7704.230624999999","0.10015499812499998","6.2654298744374804E7","814.5058836768761"
"11542","35119","35110","1","35111","184446","7702.475625","0.100132183125","6.2662001219999805E7","814.6060158600011"
"11543","35111","35110","9","35119","184455","7704.230624999999","0.10015499812499998","6.266970545062481E7","814.7061708581261"
"11544","35119","35114","9","35123","184464","7705.108125000001","0.100166405625","6.267741055874981E7","814.8063372637512"
"11545","35123","35114","3","35117","184467","7703.791875","0.10014929437499999","6.268511435062481E7","814.9064865581262"
"11546","35117","35114","3","35117","184470","7703.791875","0.10014929437499999","6.2692818142499804E7","815.0066358525012"
"11547","35117","35109","8","35117","184478","7703.791875","0.10014929437499999","6.27005219343748E7","815.1067851468762"
"11548","35117","35108","3","35111","184481","7702.475625","0.100132183125","6.27082244099998E7","815.2069173300011"
"11549","35111","35107","9","35116","184490","7703.572499999999","0.10014644249999999","6.27159279824998E7","815.3070637725011"
"11550","35116","35108","4","35112","184494","7702.695000000001","0.100135035","6.27236306774998E7","815.4071988075011"
"11551","35112","35111","9","35120","184503","7704.45","0.10015784999999999","6.2731335127499804E7","815.5073566575011"
"11552","35120","35116","8","35124","184511","7705.327499999999","0.10016925749999998","6.2739040454999804E7","815.6075259150011"
"11553","35124","35117","2","35119","184513","7704.230624999999","0.10015499812499998","6.274674468562481E7","815.7076809131262"
"11554","35119","35117","1","35118","184514","7704.01125","0.10015214624999999","6.2754448696874805E7","815.8078330593762"
"11555","35118","35111","8","35119","184522","7704.230624999999","0.10015499812499998","6.276215292749981E7","815.9079880575013"
"11556","35119","35112","1","35113","184523","7702.914375","0.100137886875","6.276985584187481E7","816.0081259443763"
"11557","35113","35111","6","35117","184529","7703.791875","0.10014929437499999","6.2777559633749805E7","816.1082752387513"
"11558","35117","35116","5","35121","184534","7704.6693749999995","0.100160701875","6.278526430312481E7","816.2084359406263"
"11559","35121","35115","3","35118","184537","7704.01125","0.10015214624999999","6.2792968314374804E7","816.3085880868763"
"11560","35118","35111","9","35120","184546","7704.45","0.10015784999999999","6.280067276437481E7","816.4087459368762"
"11561","35120","35116","5","35121","184551","7704.6693749999995","0.100160701875","6.280837743374981E7","816.5089066387512"
"11562","35121","35115","3","35118","184554","7704.01125","0.10015214624999999","6.281608144499981E7","816.6090587850013"
"11563","35118","35113","2","35115","184556","7703.353125","0.10014359062499999","6.2823784798124805E7","816.7092023756262"
"11564","35115","35108","1","35109","184557","7702.036875","0.100126479375","6.283148683499981E7","816.8093288550012"
"11565","35109","35108","8","35116","184565","7703.572499999999","0.10014644249999999","6.2839190407499805E7","816.9094752975012"
"11566","35116","35107","6","35113","184571","7702.914375","0.100137886875","6.2846893321874805E7","817.0096131843762"
"11567","35113","35111","5","35116","184576","7703.572499999999","0.10014644249999999","6.28545968943748E7","817.1097596268762"
"11568","35116","35107","7","35114","184583","7703.13375","0.10014073875","6.28623000281248E7","817.2099003656263"
"11569","35114","35112","2","35114","184585","7703.13375","0.10014073875","6.28700031618748E7","817.3100411043763"
"11570","35114","35108","7","35115","184592","7703.353125","0.10014359062499999","6.28777065149998E7","817.4101846950012"
"11571","35115","35114","3","35117","184595","7703.791875","0.10014929437499999","6.28854103068748E7","817.5103339893762"
"11572","35117","35114","6","35120","184601","7704.45","0.10015784999999999","6.28931147568748E7","817.6104918393762"
"11573","35120","35111","9","35120","184610","7704.45","0.10015784999999999","6.29008192068748E7","817.7106496893762"
"11574","35120","35113","4","35117","184614","7703.791875","0.10014929437499999","6.29085229987498E7","817.8107989837512"
"11575","35117","35116","3","35119","184617","7704.230624999999","0.10015499812499998","6.29162272293748E7","817.9109539818762"
"11576","35119","35118","4","35122","184621","7704.88875","0.10016355375","6.2923932118124805E7","818.0111175356262"
"11577","35122","35118","8","35126","184629","7705.76625","0.10017496124999999","6.2931637884374805E7","818.1112924968762"
"11578","35126","35124","4","35128","184633","7706.205","0.10018066499999999","6.29393440893748E7","818.2114731618763"
"11579","35128","35123","5","35128","184638","7706.205","0.10018066499999999","6.29470502943748E7","818.3116538268763"
"11580","35128","35121","6","35127","184644","7705.985625","0.100177813125","6.29547562799998E7","818.4118316400013"
"11581","35127","35124","5","35129","184649","7706.424375","0.10018351687499999","6.29624627043748E7","818.5120151568763"
"11582","35129","35128","4","35132","184653","7707.0825","0.10019207249999999","6.29701697868748E7","818.6122072293763"
"11583","35132","35128","8","35136","184661","7707.96","0.10020348","6.29778777468748E7","818.7124107093763"
"11584","35136","35128","3","35131","184664","7706.863125","0.10018922062499999","6.29855846099998E7","818.8125999300013"
"11585","35131","35124","3","35127","184667","7705.985625","0.100177813125","6.29932905956248E7","818.9127777431263"
"11586","35127","35123","8","35131","184675","7706.863125","0.10018922062499999","6.300099745874979E7","819.0129669637513"
"11587","35131","35122","1","35123","184676","7705.108125000001","0.100166405625","6.3008702566874795E7","819.1131333693763"
"11588","35123","35114","4","35118","184680","7704.01125","0.10015214624999999","6.301640657812479E7","819.2132855156264"
"11589","35118","35111","7","35118","184687","7704.01125","0.10015214624999999","6.302411058937479E7","819.3134376618764"
"11590","35118","35114","3","35117","184690","7703.791875","0.10014929437499999","6.3031814381249785E7","819.4135869562514"
"11591","35117","35113","3","35116","184693","7703.572499999999","0.10014644249999999","6.303951795374978E7","819.5137333987514"
"11592","35116","35108","9","35117","184702","7703.791875","0.10014929437499999","6.304722174562478E7","819.6138826931264"
"11593","35117","35112","8","35120","184710","7704.45","0.10015784999999999","6.305492619562478E7","819.7140405431263"
"11594","35120","35119","3","35122","184713","7704.88875","0.10016355375","6.3062631084374785E7","819.8142040968763"
"11595","35122","35121","4","35125","184717","7705.546875","0.100172109375","6.3070336631249785E7","819.9143762062513"
"11596","35125","35118","1","35119","184718","7704.230624999999","0.10015499812499998","6.307804086187479E7","820.0145312043763"
"11597","35119","35110","4","35114","184722","7703.13375","0.10014073875","6.308574399562479E7","820.1146719431264"
"11598","35114","35107","7","35114","184729","7703.13375","0.10014073875","6.309344712937479E7","820.2148126818764"
"11599","35114","35108","8","35116","184737","7703.572499999999","0.10014644249999999","6.3101150701874785E7","820.3149591243764"
"11600","35116","35110","3","35113","184740","7702.914375","0.100137886875","6.3108853616249785E7","820.4150970112514"
"11601","35113","35105","9","35114","184749","7703.13375","0.10014073875","6.3116556749999784E7","820.5152377500015"
"11602","35114","35108","8","35116","184757","7703.572499999999","0.10014644249999999","6.312426032249978E7","820.6153841925014"
"11603","35116","35114","9","35123","184766","7705.108125000001","0.100166405625","6.313196543062478E7","820.7155505981265"
"11604","35123","35120","5","35125","184771","7705.546875","0.100172109375","6.313967097749978E7","820.8157227075014"
"11605","35125","35119","8","35127","184779","7705.985625","0.100177813125","6.314737696312478E7","820.9159005206265"
"11606","35127","35121","8","35129","184787","7706.424375","0.10018351687499999","6.315508338749978E7","821.0160840375014"
"11607","35129","35121","4","35125","184791","7705.546875","0.100172109375","6.316278893437478E7","821.1162561468764"
"11608","35125","35119","1","35120","184792","7704.45","0.10015784999999999","6.317049338437478E7","821.2164139968763"
"11609","35120","35115","8","35123","184800","7705.108125000001","0.100166405625","6.317819849249978E7","821.3165804025014"
"11610","35123","35118","9","35127","184809","7705.985625","0.100177813125","6.318590447812478E7","821.4167582156264"
"11611","35127","35119","7","35126","184816","7705.76625","0.10017496124999999","6.319361024437478E7","821.5169331768764"
"11612","35126","35119","1","35120","184817","7704.45","0.10015784999999999","6.3201314694374785E7","821.6170910268763"
"11613","35120","35115","2","35117","184819","7703.791875","0.10014929437499999","6.320901848624978E7","821.7172403212513"
"11614","35117","35114","3","35117","184822","7703.791875","0.10014929437499999","6.321672227812478E7","821.8173896156263"
"11615","35117","35109","9","35118","184831","7704.01125","0.10015214624999999","6.3224426289374776E7","821.9175417618764"
"11616","35118","35114","8","35122","184839","7704.88875","0.10016355375","6.323213117812478E7","822.0177053156264"
"11617","35122","35113","7","35120","184846","7704.45","0.10015784999999999","6.323983562812478E7","822.1178631656263"
"11618","35120","35112","2","35114","184848","7703.13375","0.10014073875","6.324753876187478E7","822.2180039043764"
"11619","35114","35105","8","35113","184856","7702.914375","0.100137886875","6.325524167624978E7","822.3181417912514"
"11620","35113","35109","5","35114","184861","7703.13375","0.10014073875","6.326294480999978E7","822.4182825300014"
"11621","35114","35111","6","35117","184867","7703.791875","0.10014929437499999","6.3270648601874776E7","822.5184318243764"
"11622","35117","35113","2","35115","184869","7703.353125","0.10014359062499999","6.3278351954999775E7","822.6185754150014"
"11623","35115","35110","9","35119","184878","7704.230624999999","0.10015499812499998","6.328605618562478E7","822.7187304131264"
"11624","35119","35115","6","35121","184884","7704.6693749999995","0.100160701875","6.329376085499978E7","822.8188911150014"
"11625","35121","35119","8","35127","184892","7705.985625","0.100177813125","6.330146684062478E7","822.9190689281264"
"11626","35127","35126","7","35133","184899","7707.301875000001","0.10019492437500001","6.330917414249978E7","823.0192638525015"
"11627","35133","35129","8","35137","184907","7708.179375000001","0.100206331875","6.331688232187478E7","823.1194701843765"
"11628","35137","35129","4","35133","184911","7707.301875000001","0.10019492437500001","6.3324589623749785E7","823.2196651087515"
"11629","35133","35124","6","35130","184917","7706.64375","0.10018636874999999","6.333229626749978E7","823.3198514775015"
"11630","35130","35127","1","35128","184918","7706.205","0.10018066499999999","6.334000247249978E7","823.4200321425016"
"11631","35128","35123","1","35124","184919","7705.327499999999","0.10016925749999998","6.334770779999978E7","823.5202014000016"
"11632","35124","35115","8","35123","184927","7705.108125000001","0.100166405625","6.335541290812478E7","823.6203678056266"
"11633","35123","35122","4","35126","184931","7705.76625","0.10017496124999999","6.336311867437478E7","823.7205427668766"
"11634","35126","35118","3","35121","184934","7704.6693749999995","0.100160701875","6.3370823343749784E7","823.8207034687516"
"11635","35121","35116","4","35120","184938","7704.45","0.10015784999999999","6.337852779374979E7","823.9208613187516"
"11636","35120","35119","5","35124","184943","7705.327499999999","0.10016925749999998","6.338623312124979E7","824.0210305762516"
"11637","35124","35117","5","35122","184948","7704.88875","0.10016355375","6.339393800999979E7","824.1211941300016"
"11638","35122","35116","8","35124","184956","7705.327499999999","0.10016925749999998","6.340164333749979E7","824.2213633875017"
"11639","35124","35121","5","35126","184961","7705.76625","0.10017496124999999","6.340934910374979E7","824.3215383487517"
"11640","35126","35118","9","35127","184970","7705.985625","0.100177813125","6.341705508937479E7","824.4217161618767"
"11641","35127","35119","5","35124","184975","7705.327499999999","0.10016925749999998","6.342476041687479E7","824.5218854193768"
"11642","35124","35116","7","35123","184982","7705.108125000001","0.100166405625","6.343246552499979E7","824.6220518250018"
"11643","35123","35116","9","35125","184991","7705.546875","0.100172109375","6.344017107187479E7","824.7222239343768"
"11644","35125","35122","4","35126","184995","7705.76625","0.10017496124999999","6.344787683812479E7","824.8223988956267"
"11645","35126","35125","8","35133","185003","7707.301875000001","0.10019492437500001","6.345558413999979E7","824.9225938200018"
"11646","35133","35128","6","35134","185009","7707.52125","0.10019777625","6.3463291661249794E7","825.0227915962517"
"11647","35134","35132","1","35133","185010","7707.301875000001","0.10019492437500001","6.34709989631248E7","825.1229865206268"
"11648","35133","35127","3","35130","185013","7706.64375","0.10018636874999999","6.3478705606874794E7","825.2231728893768"
"11649","35130","35122","5","35127","185018","7705.985625","0.100177813125","6.348641159249979E7","825.3233507025018"
"11650","35127","35123","9","35132","185027","7707.0825","0.10019207249999999","6.3494118674999796E7","825.4235427750018"
"11651","35132","35129","4","35133","185031","7707.301875000001","0.10019492437500001","6.35018259768748E7","825.5237376993769"
"11652","35133","35125","3","35128","185034","7706.205","0.10018066499999999","6.35095321818748E7","825.6239183643769"
"11653","35128","35121","3","35124","185037","7705.327499999999","0.10016925749999998","6.35172375093748E7","825.724087621877"
"11654","35124","35117","7","35124","185044","7705.327499999999","0.10016925749999998","6.35249428368748E7","825.824256879377"
"11655","35124","35117","3","35120","185047","7704.45","0.10015784999999999","6.35326472868748E7","825.924414729377"
"11656","35120","35112","5","35117","185052","7703.791875","0.10014929437499999","6.35403510787498E7","826.024564023752"
"11657","35117","35111","7","35118","185059","7704.01125","0.10015214624999999","6.3548055089999795E7","826.124716170002"
"11658","35118","35116","1","35117","185060","7703.791875","0.10014929437499999","6.355575888187479E7","826.224865464377"
"11659","35117","35115","9","35124","185069","7705.327499999999","0.10016925749999998","6.356346420937479E7","826.325034721877"
"11660","35124","35121","9","35130","185078","7706.64375","0.10018636874999999","6.357117085312479E7","826.425221090627"
"11661","35130","35126","7","35133","185085","7707.301875000001","0.10019492437500001","6.357887815499979E7","826.5254160150021"
"11662","35133","35132","9","35141","185094","7709.056874999999","0.10021773937499999","6.358658721187479E7","826.6256337543771"
"11663","35141","35139","6","35145","185100","7709.934375","0.100229146875","6.359429714624979E7","826.7258629012521"
"11664","35145","35143","7","35150","185107","7711.03125","0.10024340625","6.360200817749979E7","826.8261063075021"
"11665","35150","35141","7","35148","185114","7710.592500000001","0.1002377025","6.3609718769999795E7","826.926344010002"
"11666","35148","35142","9","35151","185123","7711.250625","0.10024625812499999","6.3617430020624794E7","827.026590268127"
"11667","35151","35145","4","35149","185127","7710.811874999999","0.10024055437499998","6.3625140832499795E7","827.126830822502"
"11668","35149","35140","1","35141","185128","7709.056874999999","0.10021773937499999","6.363284988937479E7","827.227048561877"
"11669","35141","35135","9","35144","185137","7709.714999999999","0.10022629499999998","6.3640559604374796E7","827.327274856877"
"11670","35144","35139","6","35145","185143","7709.934375","0.100229146875","6.36482695387498E7","827.427504003752"
"11671","35145","35141","9","35150","185152","7711.03125","0.10024340625","6.36559805699998E7","827.527747410002"
"11672","35150","35143","1","35144","185153","7709.714999999999","0.10022629499999998","6.36636902849998E7","827.627973705002"
"11673","35144","35141","1","35142","185154","7709.27625","0.10022059124999999","6.36713995612498E7","827.728194296252"
"11674","35142","35139","8","35147","185162","7710.373125","0.100234850625","6.36791099343748E7","827.828429146877"
"11675","35147","35143","4","35147","185166","7710.373125","0.100234850625","6.36868203074998E7","827.9286639975021"
"11676","35147","35139","5","35144","185171","7709.714999999999","0.10022629499999998","6.369453002249981E7","828.0288902925021"
"11677","35144","35137","4","35141","185175","7709.056874999999","0.10021773937499999","6.3702239079374805E7","828.1291080318771"
"11678","35141","35136","3","35139","185178","7708.618125","0.10021203562499999","6.3709947697499804E7","828.229320067502"
"11679","35139","35138","5","35143","185183","7709.495625","0.10022344312499999","6.37176571931248E7","828.329543510627"
"11680","35143","35134","1","35135","185184","7707.740625","0.100200628125","6.37253649337498E7","828.429744138752"
"11681","35135","35126","9","35135","185193","7707.740625","0.100200628125","6.3733072674374804E7","828.529944766877"
"11682","35135","35131","1","35132","185194","7707.0825","0.10019207249999999","6.374077975687481E7","828.630136839377"
"11683","35132","35130","5","35135","185199","7707.740625","0.100200628125","6.374848749749981E7","828.730337467502"
"11684","35135","35132","9","35141","185208","7709.056874999999","0.10021773937499999","6.375619655437481E7","828.830555206877"
"11685","35141","35132","3","35135","185211","7707.740625","0.100200628125","6.376390429499981E7","828.930755835002"
"11686","35135","35129","7","35136","185218","7707.96","0.10020348","6.377161225499981E7","829.030959315002"
"11687","35136","35134","7","35141","185225","7709.056874999999","0.10021773937499999","6.377932131187481E7","829.131177054377"
"11688","35141","35132","4","35136","185229","7707.96","0.10020348","6.378702927187481E7","829.231380534377"
"11689","35136","35130","5","35135","185234","7707.740625","0.100200628125","6.379473701249981E7","829.331581162502"
"11690","35135","35128","1","35129","185235","7706.424375","0.10018351687499999","6.380244343687481E7","829.4317646793769"
"11691","35129","35124","6","35130","185241","7706.64375","0.10018636874999999","6.3810150080624804E7","829.5319510481269"
"11692","35130","35129","5","35134","185246","7707.52125","0.10019777625","6.3817857601874806E7","829.6321488243768"
"11693","35134","35128","5","35133","185251","7707.301875000001","0.10019492437500001","6.382556490374981E7","829.7323437487519"
"11694","35133","35124","4","35128","185255","7706.205","0.10018066499999999","6.383327110874981E7","829.8325244137519"
"11695","35128","35122","3","35125","185258","7705.546875","0.100172109375","6.384097665562481E7","829.9326965231269"
"11696","35125","35123","8","35131","185266","7706.863125","0.10018922062499999","6.38486835187498E7","830.0328857437519"
"11697","35131","35124","4","35128","185270","7706.205","0.10018066499999999","6.38563897237498E7","830.1330664087519"
"11698","35128","35127","6","35133","185276","7707.301875000001","0.10019492437500001","6.3864097025624804E7","830.233261333127"
"11699","35133","35130","8","35138","185284","7708.39875","0.10020918375","6.3871805424374804E7","830.333470516877"
"11700","35138","35137","9","35146","185293","7710.1537499999995","0.10023199874999998","6.387951557812481E7","830.433702515627"
"11701","35146","35144","8","35152","185301","7711.47","0.10024911","6.3887227048124805E7","830.5339516256271"
"11702","35152","35148","5","35153","185306","7711.689375","0.10025196187499999","6.38949387374998E7","830.634203587502"
"11703","35153","35146","6","35152","185312","7711.47","0.10024911","6.39026502074998E7","830.7344526975021"
"11704","35152","35146","1","35147","185313","7710.373125","0.100234850625","6.3910360580624804E7","830.8346875481271"
"11705","35147","35144","8","35152","185321","7711.47","0.10024911","6.39180720506248E7","830.9349366581272"
"11706","35152","35143","1","35144","185322","7709.714999999999","0.10022629499999998","6.392578176562481E7","831.0351629531272"
"11707","35144","35143","2","35145","185324","7709.934375","0.100229146875","6.393349169999981E7","831.1353921000022"
"11708","35145","35141","9","35150","185333","7711.03125","0.10024340625","6.394120273124981E7","831.2356355062522"
"11709","35150","35149","2","35151","185335","7711.250625","0.10024625812499999","6.394891398187481E7","831.3358817643772"
"11710","35151","35145","2","35147","185337","7710.373125","0.100234850625","6.395662435499981E7","831.4361166150022"
"11711","35147","35145","4","35149","185341","7710.811874999999","0.10024055437499998","6.396433516687481E7","831.5363571693772"
"11712","35149","35141","8","35149","185349","7710.811874999999","0.10024055437499998","6.397204597874981E7","831.6365977237522"
"11713","35149","35143","2","35145","185351","7709.934375","0.100229146875","6.3979755913124815E7","831.7368268706272"
"11714","35145","35143","9","35152","185360","7711.47","0.10024911","6.398746738312481E7","831.8370759806272"
"11715","35152","35146","7","35153","185367","7711.689375","0.10025196187499999","6.399517907249981E7","831.9373279425022"
"11716","35153","35146","7","35153","185374","7711.689375","0.10025196187499999","6.400289076187481E7","832.0375799043771"
"11717","35153","35147","5","35152","185379","7711.47","0.10024911","6.401060223187481E7","832.1378290143772"
"11718","35152","35143","7","35150","185386","7711.03125","0.10024340625","6.401831326312481E7","832.2380724206272"
"11719","35150","35148","4","35152","185390","7711.47","0.10024911","6.402602473312481E7","832.3383215306272"
"11720","35152","35147","8","35155","185398","7712.128125","0.10025766562499999","6.4033736861249804E7","832.4385791962522"
"11721","35155","35149","8","35157","185406","7712.566875","0.100263369375","6.404144942812481E7","832.5388425656273"
"11722","35157","35148","3","35151","185409","7711.250625","0.10024625812499999","6.404916067874981E7","832.6390888237523"
"11723","35151","35144","7","35151","185416","7711.250625","0.10024625812499999","6.405687192937481E7","832.7393350818774"
"11724","35151","35146","3","35149","185419","7710.811874999999","0.10024055437499998","6.406458274124981E7","832.8395756362523"
"11725","35149","35148","2","35150","185421","7711.03125","0.10024340625","6.407229377249981E7","832.9398190425023"
"11726","35150","35142","3","35145","185424","7709.934375","0.100229146875","6.408000370687481E7","833.0400481893773"
"11727","35145","35138","7","35145","185431","7709.934375","0.100229146875","6.408771364124981E7","833.1402773362523"
"11728","35145","35142","7","35149","185438","7710.811874999999","0.10024055437499998","6.4095424453124814E7","833.2405178906273"
"11729","35149","35147","6","35153","185444","7711.689375","0.10025196187499999","6.410313614249981E7","833.3407698525023"
"11730","35153","35151","1","35152","185445","7711.47","0.10024911","6.411084761249981E7","833.4410189625023"
"11731","35152","35149","7","35156","185452","7712.3475","0.1002605175","6.411855995999981E7","833.5412794800023"
"11732","35156","35151","2","35153","185454","7711.689375","0.10025196187499999","6.4126271649374805E7","833.6415314418773"
"11733","35153","35146","9","35155","185463","7712.128125","0.10025766562499999","6.41339837774998E7","833.7417891075023"
"11734","35155","35151","2","35153","185465","7711.689375","0.10025196187499999","6.41416954668748E7","833.8420410693773"
"11735","35153","35150","4","35154","185469","7711.90875","0.10025481374999999","6.41494073756248E7","833.9422958831273"
"11736","35154","35145","4","35149","185473","7710.811874999999","0.10024055437499998","6.41571181874998E7","834.0425364375022"
"11737","35149","35143","1","35144","185474","7709.714999999999","0.10022629499999998","6.41648279024998E7","834.1427627325022"
"11738","35144","35136","2","35138","185476","7708.39875","0.10020918375","6.41725363012498E7","834.2429719162523"
"11739","35138","35135","2","35137","185478","7708.179375000001","0.100206331875","6.41802444806248E7","834.3431782481273"
"11740","35137","35136","6","35142","185484","7709.27625","0.10022059124999999","6.41879537568748E7","834.4433988393773"
"11741","35142","35137","1","35138","185485","7708.39875","0.10020918375","6.41956621556248E7","834.5436080231274"
"11742","35138","35129","1","35130","185486","7706.64375","0.10018636874999999","6.42033687993748E7","834.6437943918773"
"11743","35130","35124","5","35129","185491","7706.424375","0.10018351687499999","6.4211075223749794E7","834.7439779087523"
"11744","35129","35123","9","35132","185500","7707.0825","0.10019207249999999","6.42187823062498E7","834.8441699812523"
"11745","35132","35130","4","35134","185504","7707.52125","0.10019777625","6.42264898274998E7","834.9443677575023"
"11746","35134","35125","5","35130","185509","7706.64375","0.10018636874999999","6.42341964712498E7","835.0445541262523"
"11747","35130","35123","8","35131","185517","7706.863125","0.10018922062499999","6.424190333437479E7","835.1447433468772"
"11748","35131","35124","7","35131","185524","7706.863125","0.10018922062499999","6.424961019749979E7","835.2449325675022"
"11749","35131","35123","8","35131","185532","7706.863125","0.10018922062499999","6.4257317060624786E7","835.3451217881272"
"11750","35131","35128","5","35133","185537","7707.301875000001","0.10019492437500001","6.426502436249979E7","835.4453167125023"
"11751","35133","35128","4","35132","185541","7707.0825","0.10019207249999999","6.427273144499979E7","835.5455087850023"
"11752","35132","35123","1","35124","185542","7705.327499999999","0.10016925749999998","6.428043677249979E7","835.6456780425024"
"11753","35124","35119","2","35121","185544","7704.6693749999995","0.100160701875","6.4288141441874795E7","835.7458387443774"
"11754","35121","35112","3","35115","185547","7703.353125","0.10014359062499999","6.429584479499979E7","835.8459823350023"
"11755","35115","35106","2","35108","185549","7701.817500000001","0.1001236275","6.4303546612499796E7","835.9461059625023"
"11756","35108","35106","9","35115","185558","7703.353125","0.10014359062499999","6.4311249965624794E7","836.0462495531273"
"11757","35115","35112","9","35121","185567","7704.6693749999995","0.100160701875","6.43189546349998E7","836.1464102550023"
"11758","35121","35120","1","35121","185568","7704.6693749999995","0.100160701875","6.43266593043748E7","836.2465709568772"
"11759","35121","35117","8","35125","185576","7705.546875","0.100172109375","6.43343648512498E7","836.3467430662522"
"11760","35125","35124","2","35126","185578","7705.76625","0.10017496124999999","6.43420706174998E7","836.4469180275022"
"11761","35126","35119","6","35125","185584","7705.546875","0.100172109375","6.43497761643748E7","836.5470901368772"
"11762","35125","35118","4","35122","185588","7704.88875","0.10016355375","6.43574810531248E7","836.6472536906272"
"11763","35122","35117","7","35124","185595","7705.327499999999","0.10016925749999998","6.43651863806248E7","836.7474229481272"
"11764","35124","35118","7","35125","185602","7705.546875","0.100172109375","6.43728919274998E7","836.8475950575022"
"11765","35125","35122","8","35130","185610","7706.64375","0.10018636874999999","6.43805985712498E7","836.9477814262522"
"11766","35130","35128","9","35137","185619","7708.179375000001","0.100206331875","6.43883067506248E7","837.0479877581272"
"11767","35137","35129","7","35136","185626","7707.96","0.10020348","6.43960147106248E7","837.1481912381272"
"11768","35136","35134","6","35140","185632","7708.8375","0.10021488749999999","6.44037235481248E7","837.2484061256272"
"11769","35140","35137","1","35138","185633","7708.39875","0.10020918375","6.44114319468748E7","837.3486153093772"
"11770","35138","35134","6","35140","185639","7708.8375","0.10021488749999999","6.4419140784374796E7","837.4488301968772"
"11771","35140","35131","5","35136","185644","7707.96","0.10020348","6.44268487443748E7","837.5490336768772"
"11772","35136","35134","5","35139","185649","7708.618125","0.10021203562499999","6.4434557362499796E7","837.6492457125022"
"11773","35139","35134","4","35138","185653","7708.39875","0.10020918375","6.4442265761249796E7","837.7494548962522"
"11774","35138","35137","7","35144","185660","7709.714999999999","0.10022629499999998","6.44499754762498E7","837.8496811912522"
"11775","35144","35140","5","35145","185665","7709.934375","0.100229146875","6.44576854106248E7","837.9499103381272"
"11776","35145","35138","8","35146","185673","7710.1537499999995","0.10023199874999998","6.4465395564374804E7","838.0501423368772"
"11777","35146","35139","3","35142","185676","7709.27625","0.10022059124999999","6.44731048406248E7","838.1503629281273"
"11778","35142","35135","9","35144","185685","7709.714999999999","0.10022629499999998","6.4480814555624805E7","838.2505892231272"
"11779","35144","35135","1","35136","185686","7707.96","0.10020348","6.448852251562481E7","838.3507927031272"
"11780","35136","35129","5","35134","185691","7707.52125","0.10019777625","6.449623003687481E7","838.4509904793772"
"11781","35134","35126","7","35133","185698","7707.301875000001","0.10019492437500001","6.450393733874981E7","838.5511854037522"
"11782","35133","35132","6","35138","185704","7708.39875","0.10020918375","6.451164573749981E7","838.6513945875023"
"11783","35138","35129","9","35138","185713","7708.39875","0.10020918375","6.451935413624981E7","838.7516037712523"
"11784","35138","35135","2","35137","185715","7708.179375000001","0.100206331875","6.452706231562481E7","838.8518101031274"
"11785","35137","35134","9","35143","185724","7709.495625","0.10022344312499999","6.453477181124981E7","838.9520335462523"
"11786","35143","35139","7","35146","185731","7710.1537499999995","0.10023199874999998","6.454248196499981E7","839.0522655450023"
"11787","35146","35141","1","35142","185732","7709.27625","0.10022059124999999","6.455019124124981E7","839.1524861362524"
"11788","35142","35137","4","35141","185736","7709.056874999999","0.10021773937499999","6.4557900298124805E7","839.2527038756274"
"11789","35141","35139","3","35142","185739","7709.27625","0.10022059124999999","6.45656095743748E7","839.3529244668774"
"11790","35142","35135","5","35140","185744","7708.8375","0.10021488749999999","6.45733184118748E7","839.4531393543774"
"11791","35140","35136","6","35142","185750","7709.27625","0.10022059124999999","6.45810276881248E7","839.5533599456274"
"11792","35142","35141","9","35150","185759","7711.03125","0.10024340625","6.45887387193748E7","839.6536033518775"
"11793","35150","35144","6","35150","185765","7711.03125","0.10024340625","6.45964497506248E7","839.7538467581275"
"11794","35150","35147","3","35150","185768","7711.03125","0.10024340625","6.46041607818748E7","839.8540901643775"
"11795","35150","35142","2","35144","185770","7709.714999999999","0.10022629499999998","6.46118704968748E7","839.9543164593774"
"11796","35144","35135","1","35136","185771","7707.96","0.10020348","6.46195784568748E7","840.0545199393774"
"11797","35136","35134","8","35142","185779","7709.27625","0.10022059124999999","6.46272877331248E7","840.1547405306275"
"11798","35142","35139","8","35147","185787","7710.373125","0.100234850625","6.46349981062498E7","840.2549753812525"
"11799","35147","35145","5","35150","185792","7711.03125","0.10024340625","6.46427091374998E7","840.3552187875025"
"11800","35150","35146","7","35153","185799","7711.689375","0.10025196187499999","6.46504208268748E7","840.4554707493775"
"11801","35153","35151","9","35160","185808","7713.225","0.100271925","6.46581340518748E7","840.5557426743775"
"11802","35160","35156","1","35157","185809","7712.566875","0.100263369375","6.4665846618749805E7","840.6560060437525"
"11803","35157","35150","3","35153","185812","7711.689375","0.10025196187499999","6.46735583081248E7","840.7562580056275"
"11804","35153","35145","9","35154","185821","7711.90875","0.10025481374999999","6.46812702168748E7","840.8565128193775"
"11805","35154","35150","4","35154","185825","7711.90875","0.10025481374999999","6.46889821256248E7","840.9567676331275"
"11806","35154","35147","2","35149","185827","7710.811874999999","0.10024055437499998","6.46966929374998E7","841.0570081875024"
"11807","35149","35141","9","35150","185836","7711.03125","0.10024340625","6.47044039687498E7","841.1572515937524"
"11808","35150","35145","5","35150","185841","7711.03125","0.10024340625","6.47121149999998E7","841.2574950000025"
"11809","35150","35141","6","35147","185847","7710.373125","0.100234850625","6.47198253731248E7","841.3577298506275"
"11810","35147","35145","5","35150","185852","7711.03125","0.10024340625","6.47275364043748E7","841.4579732568775"
"11811","35150","35149","9","35158","185861","7712.786250000001","0.10026622125000001","6.47352491906248E7","841.5582394781275"
"11812","35158","35151","2","35153","185863","7711.689375","0.10025196187499999","6.47429608799998E7","841.6584914400024"
"11813","35153","35148","5","35153","185868","7711.689375","0.10025196187499999","6.47506725693748E7","841.7587434018774"
"11814","35153","35150","6","35156","185874","7712.3475","0.1002605175","6.4758384916874796E7","841.8590039193774"
"11815","35156","35148","1","35149","185875","7710.811874999999","0.10024055437499998","6.47660957287498E7","841.9592444737524"
"11816","35149","35142","2","35144","185877","7709.714999999999","0.10022629499999998","6.47738054437498E7","842.0594707687524"
"11817","35144","35140","7","35147","185884","7710.373125","0.100234850625","6.47815158168748E7","842.1597056193774"
"11818","35147","35143","4","35147","185888","7710.373125","0.100234850625","6.4789226189999804E7","842.2599404700024"
"11819","35147","35145","2","35147","185890","7710.373125","0.100234850625","6.4796936563124806E7","842.3601753206275"
"11820","35147","35144","3","35147","185893","7710.373125","0.100234850625","6.480464693624981E7","842.4604101712525"
"11821","35147","35140","5","35145","185898","7709.934375","0.100229146875","6.481235687062481E7","842.5606393181275"
"11822","35145","35138","4","35142","185902","7709.27625","0.10022059124999999","6.482006614687481E7","842.6608599093776"
"11823","35142","35137","7","35144","185909","7709.714999999999","0.10022629499999998","6.482777586187481E7","842.7610862043775"
"11824","35144","35136","7","35143","185916","7709.495625","0.10022344312499999","6.483548535749981E7","842.8613096475025"
"11825","35143","35134","5","35139","185921","7708.618125","0.10021203562499999","6.484319397562481E7","842.9615216831274"
"11826","35139","35133","7","35140","185928","7708.8375","0.10021488749999999","6.4850902813124806E7","843.0617365706274"
"11827","35140","35134","5","35139","185933","7708.618125","0.10021203562499999","6.4858611431249805E7","843.1619486062524"
"11828","35139","35132","6","35138","185939","7708.39875","0.10020918375","6.4866319829999804E7","843.2621577900024"
"11829","35138","35134","8","35142","185947","7709.27625","0.10022059124999999","6.48740291062498E7","843.3623783812525"
"11830","35142","35134","5","35139","185952","7708.618125","0.10021203562499999","6.48817377243748E7","843.4625904168774"
"11831","35139","35135","7","35142","185959","7709.27625","0.10022059124999999","6.48894470006248E7","843.5628110081275"
"11832","35142","35134","4","35138","185963","7708.39875","0.10020918375","6.48971553993748E7","843.6630201918775"
"11833","35138","35135","1","35136","185964","7707.96","0.10020348","6.49048633593748E7","843.7632236718775"
"11834","35136","35134","1","35135","185965","7707.740625","0.100200628125","6.49125710999998E7","843.8634243000025"
"11835","35135","35133","1","35134","185966","7707.52125","0.10019777625","6.49202786212498E7","843.9636220762525"
"11836","35134","35131","4","35135","185970","7707.740625","0.100200628125","6.4927986361874804E7","844.0638227043775"
"11837","35135","35131","8","35139","185978","7708.618125","0.10021203562499999","6.49356949799998E7","844.1640347400024"
"11838","35139","35138","6","35144","185984","7709.714999999999","0.10022629499999998","6.494340469499981E7","844.2642610350024"
"11839","35144","35138","9","35147","185993","7710.373125","0.100234850625","6.495111506812481E7","844.3644958856274"
"11840","35147","35141","8","35149","186001","7710.811874999999","0.10024055437499998","6.495882587999981E7","844.4647364400024"
"11841","35149","35140","6","35146","186007","7710.1537499999995","0.10023199874999998","6.496653603374981E7","844.5649684387524"
"11842","35146","35144","1","35145","186008","7709.934375","0.100229146875","6.4974245968124814E7","844.6651975856274"
"11843","35145","35139","6","35145","186014","7709.934375","0.100229146875","6.498195590249982E7","844.7654267325024"
"11844","35145","35144","8","35152","186022","7711.47","0.10024911","6.4989667372499816E7","844.8656758425025"
"11845","35152","35144","6","35150","186028","7711.03125","0.10024340625","6.4997378403749816E7","844.9659192487525"
"11846","35150","35141","6","35147","186034","7710.373125","0.100234850625","6.500508877687482E7","845.0661540993775"
"11847","35147","35140","2","35142","186036","7709.27625","0.10022059124999999","6.5012798053124815E7","845.1663746906275"
"11848","35142","35134","2","35136","186038","7707.96","0.10020348","6.5020506013124816E7","845.2665781706276"
"11849","35136","35127","9","35136","186047","7707.96","0.10020348","6.502821397312482E7","845.3667816506276"
"11850","35136","35133","3","35136","186050","7707.96","0.10020348","6.503592193312482E7","845.4669851306276"
"11851","35136","35128","4","35132","186054","7707.0825","0.10019207249999999","6.504362901562482E7","845.5671772031276"
"11852","35132","35123","2","35125","186056","7705.546875","0.100172109375","6.505133456249982E7","845.6673493125026"
"11853","35125","35123","1","35124","186057","7705.327499999999","0.10016925749999998","6.505903988999982E7","845.7675185700026"
"11854","35124","35115","8","35123","186065","7705.108125000001","0.100166405625","6.506674499812482E7","845.8676849756276"
"11855","35123","35119","2","35121","186067","7704.6693749999995","0.100160701875","6.5074449667499825E7","845.9678456775026"
"11856","35121","35112","9","35121","186076","7704.6693749999995","0.100160701875","6.508215433687483E7","846.0680063793776"
"11857","35121","35116","8","35124","186084","7705.327499999999","0.10016925749999998","6.508985966437483E7","846.1681756368777"
"11858","35124","35122","1","35123","186085","7705.108125000001","0.100166405625","6.509756477249983E7","846.2683420425027"
"11859","35123","35121","4","35125","186089","7705.546875","0.100172109375","6.510527031937483E7","846.3685141518777"
"11860","35125","35116","6","35122","186095","7704.88875","0.10016355375","6.511297520812483E7","846.4686777056277"
"11861","35122","35114","7","35121","186102","7704.6693749999995","0.100160701875","6.512067987749983E7","846.5688384075027"
"11862","35121","35120","5","35125","186107","7705.546875","0.100172109375","6.512838542437483E7","846.6690105168776"
"11863","35125","35119","5","35124","186112","7705.327499999999","0.10016925749999998","6.5136090751874834E7","846.7691797743777"
"11864","35124","35123","1","35124","186113","7705.327499999999","0.10016925749999998","6.5143796079374835E7","846.8693490318777"
"11865","35124","35121","9","35130","186122","7706.64375","0.10018636874999999","6.515150272312483E7","846.9695354006277"
"11866","35130","35128","9","35137","186131","7708.179375000001","0.100206331875","6.515921090249983E7","847.0697417325027"
"11867","35137","35129","4","35133","186135","7707.301875000001","0.10019492437500001","6.5166918204374835E7","847.1699366568778"
"11868","35133","35124","3","35127","186138","7705.985625","0.100177813125","6.517462418999983E7","847.2701144700028"
"11869","35127","35118","1","35119","186139","7704.230624999999","0.10015499812499998","6.518232842062484E7","847.3702694681278"
"11870","35119","35115","5","35120","186144","7704.45","0.10015784999999999","6.519003287062484E7","847.4704273181278"
"11871","35120","35116","3","35119","186147","7704.230624999999","0.10015499812499998","6.5197737101249844E7","847.5705823162529"
"11872","35119","35114","2","35116","186149","7703.572499999999","0.10014644249999999","6.520544067374984E7","847.6707287587528"
"11873","35116","35113","5","35118","186154","7704.01125","0.10015214624999999","6.521314468499984E7","847.7708809050029"
"11874","35118","35113","1","35114","186155","7703.13375","0.10014073875","6.522084781874984E7","847.8710216437529"
"11875","35114","35111","7","35118","186162","7704.01125","0.10015214624999999","6.5228551829999834E7","847.9711737900029"
"11876","35118","35115","6","35121","186168","7704.6693749999995","0.100160701875","6.523625649937484E7","848.0713344918779"
"11877","35121","35118","8","35126","186176","7705.76625","0.10017496124999999","6.5243962265624836E7","848.1715094531279"
"11878","35126","35121","1","35122","186177","7704.88875","0.10016355375","6.525166715437484E7","848.2716730068779"
"11879","35122","35115","2","35117","186179","7703.791875","0.10014929437499999","6.5259370946249835E7","848.3718223012529"
"11880","35117","35112","4","35116","186183","7703.572499999999","0.10014644249999999","6.526707451874983E7","848.4719687437529"
"11881","35116","35114","5","35119","186188","7704.230624999999","0.10015499812499998","6.527477874937484E7","848.5721237418779"
"11882","35119","35110","9","35119","186197","7704.230624999999","0.10015499812499998","6.528248297999984E7","848.672278740003"
"11883","35119","35117","5","35122","186202","7704.88875","0.10016355375","6.529018786874984E7","848.772442293753"
"11884","35122","35116","1","35117","186203","7703.791875","0.10014929437499999","6.529789166062484E7","848.872591588128"
"11885","35117","35116","2","35118","186205","7704.01125","0.10015214624999999","6.5305595671874836E7","848.972743734378"
"11886","35118","35111","1","35112","186206","7702.695000000001","0.100135035","6.531329836687484E7","849.072878769378"
"11887","35112","35103","6","35109","186212","7702.036875","0.100126479375","6.532100040374984E7","849.173005248753"
"11888","35109","35104","3","35107","186215","7701.598125","0.100120775625","6.532870200187484E7","849.273126024378"
"11889","35107","35105","4","35109","186219","7702.036875","0.100126479375","6.5336404038749844E7","849.3732525037531"
"11890","35109","35106","1","35107","186220","7701.598125","0.100120775625","6.534410563687485E7","849.473373279378"
"11891","35107","35098","5","35103","186225","7700.720625","0.10010936812499999","6.5351806357499845E7","849.573482647503"
"11892","35103","35098","8","35106","186233","7701.37875","0.10011792374999999","6.535950773624984E7","849.673600571253"
"11893","35106","35099","6","35105","186239","7701.159375","0.100115071875","6.536720889562484E7","849.7737156431281"
"11894","35105","35099","6","35105","186245","7701.159375","0.100115071875","6.5374910054999836E7","849.8738307150031"
"11895","35105","35103","4","35107","186249","7701.598125","0.100120775625","6.538261165312484E7","849.9739514906281"
"11896","35107","35106","7","35113","186256","7702.914375","0.100137886875","6.539031456749984E7","850.0740893775031"
"11897","35113","35108","2","35110","186258","7702.25625","0.10012933125","6.539801682374984E7","850.1742187087531"
"11898","35110","35101","7","35108","186265","7701.817500000001","0.1001236275","6.540571864124984E7","850.2743423362531"
"11899","35108","35102","8","35110","186273","7702.25625","0.10012933125","6.5413420897499844E7","850.374471667503"
"11900","35110","35108","5","35113","186278","7702.914375","0.100137886875","6.5421123811874844E7","850.474609554378"
"11901","35113","35109","6","35115","186284","7703.353125","0.10014359062499999","6.542882716499984E7","850.574753145003"
"11902","35115","35109","9","35118","186293","7704.01125","0.10015214624999999","6.543653117624984E7","850.674905291253"
"11903","35118","35113","4","35117","186297","7703.791875","0.10014929437499999","6.544423496812484E7","850.775054585628"
"11904","35117","35109","1","35110","186298","7702.25625","0.10012933125","6.545193722437484E7","850.875183916878"
"11905","35110","35106","7","35113","186305","7702.914375","0.100137886875","6.545964013874984E7","850.975321803753"
"11906","35113","35106","6","35112","186311","7702.695000000001","0.100135035","6.546734283374984E7","851.075456838753"
"11907","35112","35108","1","35109","186312","7702.036875","0.100126479375","6.547504487062484E7","851.175583318128"
"11908","35109","35106","2","35108","186314","7701.817500000001","0.1001236275","6.548274668812484E7","851.275706945628"
"11909","35108","35102","8","35110","186322","7702.25625","0.10012933125","6.5490448944374844E7","851.375836276878"
"11910","35110","35101","4","35105","186326","7701.159375","0.100115071875","6.549815010374984E7","851.475951348753"
"11911","35105","35102","1","35103","186327","7700.720625","0.10010936812499999","6.550585082437484E7","851.576060716878"
"11912","35103","35102","4","35106","186331","7701.37875","0.10011792374999999","6.5513552203124836E7","851.676178640628"
"11913","35106","35105","1","35106","186332","7701.37875","0.10011792374999999","6.552125358187483E7","851.776296564378"
"11914","35106","35097","3","35100","186335","7700.0625","0.1001008125","6.552895364437483E7","851.876397376878"
"11915","35100","35097","9","35106","186344","7701.37875","0.10011792374999999","6.553665502312483E7","851.976515300628"
"11916","35106","35097","4","35101","186348","7700.281875","0.10010366437499998","6.554435530499983E7","852.0766189650029"
"11917","35101","35097","8","35105","186356","7701.159375","0.100115071875","6.5552056464374825E7","852.176734036878"
"11918","35105","35099","1","35100","186357","7700.0625","0.1001008125","6.5559756526874825E7","852.276834849378"
"11919","35100","35093","3","35096","186360","7699.1849999999995","0.10008940499999999","6.556745571187483E7","852.376924254378"
"11920","35096","35087","5","35092","186365","7698.3075","0.10007799749999999","6.5575154019374825E7","852.4770022518779"
"11921","35092","35090","1","35091","186366","7698.088124999999","0.10007514562499999","6.558285210749982E7","852.577077397503"
"11922","35091","35087","5","35092","186371","7698.3075","0.10007799749999999","6.559055041499982E7","852.677155395003"
"11923","35092","35083","1","35084","186372","7696.5525","0.10005518249999999","6.559824696749982E7","852.777210577503"
"11924","35084","35081","5","35086","186377","7696.99125","0.10006088625","6.560594395874982E7","852.877271463753"
"11925","35086","35083","3","35086","186380","7696.99125","0.10006088625","6.5613640949999824E7","852.977332350003"
"11926","35086","35081","4","35085","186384","7696.771875","0.100058034375","6.5621337721874826E7","853.0773903843781"
"11927","35085","35079","7","35086","186391","7696.99125","0.10006088625","6.562903471312483E7","853.1774512706281"
"11928","35086","35083","6","35089","186397","7697.649375","0.100069441875","6.5636732362499826E7","853.2775207125031"
"11929","35089","35080","4","35084","186401","7696.5525","0.10005518249999999","6.564442891499983E7","853.3775758950031"
"11930","35084","35077","3","35080","186404","7695.675","0.100043775","6.5652124589999825E7","853.4776196700032"
"11931","35080","35071","5","35076","186409","7694.7975","0.10003236749999998","6.5659819387499824E7","853.5776520375032"
"11932","35076","35069","5","35074","186414","7694.358749999999","0.10002666374999998","6.5667513746249825E7","853.6776787012532"
"11933","35074","35070","8","35078","186422","7695.23625","0.10003807125","6.567520898249982E7","853.7777167725031"
"11934","35078","35073","7","35080","186429","7695.675","0.100043775","6.568290465749982E7","853.8777605475032"
"11935","35080","35079","2","35081","186431","7695.894375","0.10004662687499999","6.569060055187482E7","853.9778071743782"
"11936","35081","35074","7","35081","186438","7695.894375","0.10004662687499999","6.569829644624981E7","854.0778538012532"
"11937","35081","35079","7","35086","186445","7696.99125","0.10006088625","6.5705993437499814E7","854.1779146875033"
"11938","35086","35079","6","35085","186451","7696.771875","0.100058034375","6.5713690209374815E7","854.2779727218783"
"11939","35085","35079","9","35088","186460","7697.43","0.10006659","6.5721387639374815E7","854.3780393118783"
"11940","35088","35083","1","35084","186461","7696.5525","0.10005518249999999","6.572908419187482E7","854.4780944943783"
"11941","35084","35081","8","35089","186469","7697.649375","0.100069441875","6.5736781841249816E7","854.5781639362533"
"11942","35089","35086","3","35089","186472","7697.649375","0.100069441875","6.5744479490624815E7","854.6782333781283"
"11943","35089","35086","9","35095","186481","7698.965625","0.10008655312499999","6.575217845624982E7","854.7783199312533"
"11944","35095","35094","4","35098","186485","7699.623750000001","0.10009510875000001","6.575987807999982E7","854.8784150400033"
"11945","35098","35089","9","35098","186494","7699.623750000001","0.10009510875000001","6.576757770374982E7","854.9785101487533"
"11946","35098","35089","9","35098","186503","7699.623750000001","0.10009510875000001","6.577527732749982E7","855.0786052575033"
"11947","35098","35095","9","35104","186512","7700.94","0.10011221999999999","6.578297826749982E7","855.1787174775034"
"11948","35104","35101","2","35103","186514","7700.720625","0.10010936812499999","6.579067898812482E7","855.2788268456284"
"11949","35103","35101","3","35104","186517","7700.94","0.10011221999999999","6.5798379928124815E7","855.3789390656284"
"11950","35104","35096","9","35105","186526","7701.159375","0.100115071875","6.580608108749981E7","855.4790541375035"
"11951","35105","35104","7","35111","186533","7702.475625","0.100132183125","6.581378356312481E7","855.5791863206284"
"11952","35111","35102","9","35111","186542","7702.475625","0.100132183125","6.5821486038749814E7","855.6793185037534"
"11953","35111","35109","6","35115","186548","7703.353125","0.10014359062499999","6.582918939187481E7","855.7794620943783"
"11954","35115","35113","6","35119","186554","7704.230624999999","0.10015499812499998","6.5836893622499816E7","855.8796170925034"
"11955","35119","35117","6","35123","186560","7705.108125000001","0.100166405625","6.584459873062482E7","855.9797834981284"
"11956","35123","35114","8","35122","186568","7704.88875","0.10016355375","6.585230361937482E7","856.0799470518784"
"11957","35122","35113","5","35118","186573","7704.01125","0.10015214624999999","6.5860007630624816E7","856.1800991981285"
"11958","35118","35117","8","35125","186581","7705.546875","0.100172109375","6.5867713177499816E7","856.2802713075034"
"11959","35125","35121","9","35130","186590","7706.64375","0.10018636874999999","6.587541982124981E7","856.3804576762534"
"11960","35130","35125","9","35134","186599","7707.52125","0.10019777625","6.5883127342499815E7","856.4806554525034"
"11961","35134","35129","3","35132","186602","7707.0825","0.10019207249999999","6.589083442499982E7","856.5808475250034"
"11962","35132","35124","3","35127","186605","7705.985625","0.100177813125","6.589854041062482E7","856.6810253381284"
"11963","35127","35122","6","35128","186611","7706.205","0.10018066499999999","6.5906246615624815E7","856.7812060031284"
"11964","35128","35124","9","35133","186620","7707.301875000001","0.10019492437500001","6.591395391749982E7","856.8814009275035"
"11965","35133","35131","2","35133","186622","7707.301875000001","0.10019492437500001","6.592166121937482E7","856.9815958518785"
"11966","35133","35124","1","35125","186623","7705.546875","0.100172109375","6.592936676624982E7","857.0817679612535"
"11967","35125","35124","1","35125","186624","7705.546875","0.100172109375","6.593707231312482E7","857.1819400706285"
"11968","35125","35124","1","35125","186625","7705.546875","0.100172109375","6.594477785999982E7","857.2821121800034"
"11969","35125","35122","8","35130","186633","7706.64375","0.10018636874999999","6.595248450374982E7","857.3822985487534"
"11970","35130","35129","2","35131","186635","7706.863125","0.10018922062499999","6.5960191366874814E7","857.4824877693784"
"11971","35131","35128","8","35136","186643","7707.96","0.10020348","6.5967899326874815E7","857.5826912493784"
"11972","35136","35127","8","35135","186651","7707.740625","0.100200628125","6.597560706749982E7","857.6828918775034"
"11973","35135","35133","7","35140","186658","7708.8375","0.10021488749999999","6.5983315904999815E7","857.7831067650034"
"11974","35140","35136","8","35144","186666","7709.714999999999","0.10022629499999998","6.599102561999982E7","857.8833330600033"
"11975","35144","35143","2","35145","186668","7709.934375","0.100229146875","6.599873555437482E7","857.9835622068783"
"11976","35145","35144","5","35149","186673","7710.811874999999","0.10024055437499998","6.600644636624982E7","858.0838027612533"
"11977","35149","35141","9","35150","186682","7711.03125","0.10024340625","6.601415739749982E7","858.1840461675033"
"11978","35150","35144","4","35148","186686","7710.592500000001","0.1002377025","6.602186798999982E7","858.2842838700033"
"11979","35148","35145","6","35151","186692","7711.250625","0.10024625812499999","6.602957924062482E7","858.3845301281283"
"11980","35151","35145","9","35154","186701","7711.90875","0.10025481374999999","6.603729114937482E7","858.4847849418783"
"11981","35154","35153","2","35155","186703","7712.128125","0.10025766562499999","6.604500327749982E7","858.5850426075033"
"11982","35155","35147","2","35149","186705","7710.811874999999","0.10024055437499998","6.605271408937482E7","858.6852831618783"
"11983","35149","35143","8","35151","186713","7711.250625","0.10024625812499999","6.606042533999982E7","858.7855294200033"
"11984","35151","35148","8","35156","186721","7712.3475","0.1002605175","6.6068137687499814E7","858.8857899375033"
"11985","35156","35151","4","35155","186725","7712.128125","0.10025766562499999","6.607584981562481E7","858.9860476031283"
"11986","35155","35146","6","35152","186731","7711.47","0.10024911","6.608356128562481E7","859.0862967131284"
"11987","35152","35151","3","35154","186734","7711.90875","0.10025481374999999","6.609127319437481E7","859.1865515268784"
"11988","35154","35150","1","35151","186735","7711.250625","0.10024625812499999","6.609898444499981E7","859.2867977850034"
"11989","35151","35145","6","35151","186741","7711.250625","0.10024625812499999","6.6106695695624806E7","859.3870440431284"
"11990","35151","35147","5","35152","186746","7711.47","0.10024911","6.6114407165624805E7","859.4872931531285"
"11991","35152","35144","8","35152","186754","7711.47","0.10024911","6.61221186356248E7","859.5875422631285"
"11992","35152","35143","9","35152","186763","7711.47","0.10024911","6.61298301056248E7","859.6877913731286"
"11993","35152","35143","4","35147","186767","7710.373125","0.100234850625","6.6137540478749804E7","859.7880262237536"
"11994","35147","35146","6","35152","186773","7711.47","0.10024911","6.61452519487498E7","859.8882753337537"
"11995","35152","35146","9","35155","186782","7712.128125","0.10025766562499999","6.61529640768748E7","859.9885329993787"
"11996","35155","35152","5","35157","186787","7712.566875","0.100263369375","6.61606766437498E7","860.0887963687537"
"11997","35157","35151","4","35155","186791","7712.128125","0.10025766562499999","6.61683887718748E7","860.1890540343787"
"11998","35155","35149","3","35152","186794","7711.47","0.10024911","6.61761002418748E7","860.2893031443788"
"11999","35152","35146","1","35147","186795","7710.373125","0.100234850625","6.61838106149998E7","860.3895379950038"
"12000","35147","35144","4","35148","186799","7710.592500000001","0.1002377025","6.61915212074998E7","860.4897756975038"
"12001","35148","35139","7","35146","186806","7710.1537499999995","0.10023199874999998","6.6199231361249804E7","860.5900076962538"
"12002","35146","35140","6","35146","186812","7710.1537499999995","0.10023199874999998","6.620694151499981E7","860.6902396950038"
"12003","35146","35142","4","35146","186816","7710.1537499999995","0.10023199874999998","6.621465166874981E7","860.7904716937538"
"12004","35146","35138","1","35139","186817","7708.618125","0.10021203562499999","6.622236028687481E7","860.8906837293788"
"12005","35139","35134","5","35139","186822","7708.618125","0.10021203562499999","6.623006890499981E7","860.9908957650038"
"12006","35139","35138","7","35145","186829","7709.934375","0.100229146875","6.623777883937481E7","861.0911249118788"
"12007","35145","35139","1","35140","186830","7708.8375","0.10021488749999999","6.624548767687481E7","861.1913397993787"
"12008","35140","35137","2","35139","186832","7708.618125","0.10021203562499999","6.625319629499981E7","861.2915518350037"
"12009","35139","35136","2","35138","186834","7708.39875","0.10020918375","6.626090469374981E7","861.3917610187538"
"12010","35138","35130","4","35134","186838","7707.52125","0.10019777625","6.626861221499981E7","861.4919587950037"
"12011","35134","35133","5","35138","186843","7708.39875","0.10020918375","6.627632061374981E7","861.5921679787538"
"12012","35138","35130","4","35134","186847","7707.52125","0.10019777625","6.628402813499981E7","861.6923657550037"
"12013","35134","35125","7","35132","186854","7707.0825","0.10019207249999999","6.6291735217499815E7","861.7925578275037"
"12014","35132","35127","4","35131","186858","7706.863125","0.10018922062499999","6.629944208062481E7","861.8927470481287"
"12015","35131","35123","2","35125","186860","7705.546875","0.100172109375","6.630714762749981E7","861.9929191575037"
"12016","35125","35116","7","35123","186867","7705.108125000001","0.100166405625","6.631485273562481E7","862.0930855631287"
"12017","35123","35116","3","35119","186870","7704.230624999999","0.10015499812499998","6.6322556966249816E7","862.1932405612538"
"12018","35119","35114","7","35121","186877","7704.6693749999995","0.100160701875","6.633026163562482E7","862.2934012631288"
"12019","35121","35117","9","35126","186886","7705.76625","0.10017496124999999","6.633796740187482E7","862.3935762243788"
"12020","35126","35124","2","35126","186888","7705.76625","0.10017496124999999","6.634567316812482E7","862.4937511856288"
"12021","35126","35123","2","35125","186890","7705.546875","0.100172109375","6.635337871499982E7","862.5939232950037"
"12022","35125","35120","6","35126","186896","7705.76625","0.10017496124999999","6.636108448124982E7","862.6940982562537"
"12023","35126","35117","7","35124","186903","7705.327499999999","0.10016925749999998","6.636878980874982E7","862.7942675137538"
"12024","35124","35120","2","35122","186905","7704.88875","0.10016355375","6.637649469749982E7","862.8944310675038"
"12025","35122","35115","9","35124","186914","7705.327499999999","0.10016925749999998","6.638420002499982E7","862.9946003250038"
"12026","35124","35117","2","35119","186916","7704.230624999999","0.10015499812499998","6.639190425562482E7","863.0947553231289"
"12027","35119","35110","2","35112","186918","7702.695000000001","0.100135035","6.639960695062482E7","863.1948903581289"
"12028","35112","35106","4","35110","186922","7702.25625","0.10012933125","6.6407309206874825E7","863.2950196893788"
"12029","35110","35104","8","35112","186930","7702.695000000001","0.100135035","6.6415011901874825E7","863.3951547243788"
"12030","35112","35110","5","35115","186935","7703.353125","0.10014359062499999","6.6422715254999824E7","863.4952983150038"
"12031","35115","35110","4","35114","186939","7703.13375","0.10014073875","6.643041838874982E7","863.5954390537538"
"12032","35114","35106","2","35108","186941","7701.817500000001","0.1001236275","6.6438120206249826E7","863.6955626812538"
"12033","35108","35103","7","35110","186948","7702.25625","0.10012933125","6.644582246249983E7","863.7956920125038"
"12034","35110","35105","4","35109","186952","7702.036875","0.100126479375","6.645352449937483E7","863.8958184918788"
"12035","35109","35105","4","35109","186956","7702.036875","0.100126479375","6.646122653624983E7","863.9959449712538"
"12036","35109","35100","2","35102","186958","7700.50125","0.10010651625","6.646892703749983E7","864.0960514875038"
"12037","35102","35099","4","35103","186962","7700.720625","0.10010936812499999","6.647662775812483E7","864.1961608556288"
"12038","35103","35102","9","35111","186971","7702.475625","0.100132183125","6.648433023374983E7","864.2962930387538"
"12039","35111","35107","7","35114","186978","7703.13375","0.10014073875","6.649203336749983E7","864.3964337775038"
"12040","35114","35112","2","35114","186980","7703.13375","0.10014073875","6.649973650124983E7","864.4965745162539"
"12041","35114","35110","5","35115","186985","7703.353125","0.10014359062499999","6.6507439854374826E7","864.5967181068788"
"12042","35115","35111","5","35116","186990","7703.572499999999","0.10014644249999999","6.6515143426874824E7","864.6968645493788"
"12043","35116","35113","7","35120","186997","7704.45","0.10015784999999999","6.652284787687483E7","864.7970223993788"
"12044","35120","35115","8","35123","187005","7705.108125000001","0.100166405625","6.653055298499983E7","864.8971888050038"
"12045","35123","35119","3","35122","187008","7704.88875","0.10016355375","6.653825787374983E7","864.9973523587538"
"12046","35122","35119","5","35124","187013","7705.327499999999","0.10016925749999998","6.654596320124983E7","865.0975216162539"
"12047","35124","35115","2","35117","187015","7703.791875","0.10014929437499999","6.655366699312483E7","865.1976709106289"
"12048","35117","35112","9","35121","187024","7704.6693749999995","0.100160701875","6.656137166249983E7","865.2978316125038"
"12049","35121","35112","4","35116","187028","7703.572499999999","0.10014644249999999","6.656907523499983E7","865.3979780550038"
"12050","35116","35112","5","35117","187033","7703.791875","0.10014929437499999","6.6576779026874825E7","865.4981273493788"
"12051","35117","35113","2","35115","187035","7703.353125","0.10014359062499999","6.6584482379999824E7","865.5982709400038"
"12052","35115","35106","5","35111","187040","7702.475625","0.100132183125","6.6592184855624825E7","865.6984031231287"
"12053","35111","35108","6","35114","187046","7703.13375","0.10014073875","6.6599887989374824E7","865.7985438618788"
"12054","35114","35110","9","35119","187055","7704.230624999999","0.10015499812499998","6.660759221999983E7","865.8986988600038"
"12055","35119","35115","8","35123","187063","7705.108125000001","0.100166405625","6.661529732812483E7","865.9988652656289"
"12056","35123","35120","8","35128","187071","7706.205","0.10018066499999999","6.662300353312483E7","866.0990459306289"
"12057","35128","35125","5","35130","187076","7706.64375","0.10018636874999999","6.6630710176874824E7","866.1992322993789"
"12058","35130","35124","3","35127","187079","7705.985625","0.100177813125","6.663841616249982E7","866.2994101125039"
"12059","35127","35122","4","35126","187083","7705.76625","0.10017496124999999","6.664612192874982E7","866.3995850737539"
"12060","35126","35125","6","35131","187089","7706.863125","0.10018922062499999","6.665382879187482E7","866.4997742943789"
"12061","35131","35129","7","35136","187096","7707.96","0.10020348","6.666153675187482E7","866.5999777743789"
"12062","35136","35132","8","35140","187104","7708.8375","0.10021488749999999","6.666924558937482E7","866.7001926618789"
"12063","35140","35135","5","35140","187109","7708.8375","0.10021488749999999","6.667695442687482E7","866.8004075493789"
"12064","35140","35133","7","35140","187116","7708.8375","0.10021488749999999","6.6684663264374815E7","866.9006224368788"
"12065","35140","35136","6","35142","187122","7709.27625","0.10022059124999999","6.669237254062481E7","867.0008430281289"
"12066","35142","35137","7","35144","187129","7709.714999999999","0.10022629499999998","6.6700082255624816E7","867.1010693231289"
"12067","35144","35139","9","35148","187138","7710.592500000001","0.1002377025","6.670779284812482E7","867.2013070256288"
"12068","35148","35140","5","35145","187143","7709.934375","0.100229146875","6.671550278249982E7","867.3015361725038"
"12069","35145","35136","2","35138","187145","7708.39875","0.10020918375","6.672321118124982E7","867.4017453562539"
"12070","35138","35133","5","35138","187150","7708.39875","0.10020918375","6.673091957999982E7","867.5019545400039"
"12071","35138","35132","6","35138","187156","7708.39875","0.10020918375","6.673862797874982E7","867.602163723754"
"12072","35138","35135","2","35137","187158","7708.179375000001","0.100206331875","6.674633615812482E7","867.702370055629"
"12073","35137","35136","9","35145","187167","7709.934375","0.100229146875","6.675404609249982E7","867.802599202504"
"12074","35145","35142","8","35150","187175","7711.03125","0.10024340625","6.676175712374982E7","867.902842608754"
"12075","35150","35142","2","35144","187177","7709.714999999999","0.10022629499999998","6.6769466838749826E7","868.003068903754"
"12076","35144","35135","6","35141","187183","7709.056874999999","0.10021773937499999","6.6777175895624824E7","868.103286643129"
"12077","35141","35140","4","35144","187187","7709.714999999999","0.10022629499999998","6.678488561062483E7","868.2035129381289"
"12078","35144","35142","3","35145","187190","7709.934375","0.100229146875","6.679259554499983E7","868.3037420850039"
"12079","35145","35138","5","35143","187195","7709.495625","0.10022344312499999","6.680030504062483E7","868.4039655281289"
"12080","35143","35140","3","35143","187198","7709.495625","0.10022344312499999","6.6808014536249824E7","868.5041889712538"
"12081","35143","35135","6","35141","187204","7709.056874999999","0.10021773937499999","6.681572359312482E7","868.6044067106288"
"12082","35141","35134","3","35137","187207","7708.179375000001","0.100206331875","6.682343177249982E7","868.7046130425039"
"12083","35137","35132","4","35136","187211","7707.96","0.10020348","6.683113973249982E7","868.8048165225039"
"12084","35136","35128","7","35135","187218","7707.740625","0.100200628125","6.6838847473124824E7","868.9050171506289"
"12085","35135","35130","9","35139","187227","7708.618125","0.10021203562499999","6.684655609124982E7","869.0052291862538"
"12086","35139","35134","5","35139","187232","7708.618125","0.10021203562499999","6.685426470937482E7","869.1054412218788"
"12087","35139","35137","6","35143","187238","7709.495625","0.10022344312499999","6.686197420499982E7","869.2056646650037"
"12088","35143","35139","2","35141","187240","7709.056874999999","0.10021773937499999","6.686968326187482E7","869.3058824043787"
"12089","35141","35140","1","35141","187241","7709.056874999999","0.10021773937499999","6.6877392318749815E7","869.4061001437537"
"12090","35141","35134","5","35139","187246","7708.618125","0.10021203562499999","6.6885100936874814E7","869.5063121793787"
"12091","35139","35135","6","35141","187252","7709.056874999999","0.10021773937499999","6.689280999374981E7","869.6065299187537"
"12092","35141","35136","5","35141","187257","7709.056874999999","0.10021773937499999","6.690051905062481E7","869.7067476581287"
"12093","35141","35136","4","35140","187261","7708.8375","0.10021488749999999","6.690822788812481E7","869.8069625456287"
"12094","35140","35131","8","35139","187269","7708.618125","0.10021203562499999","6.691593650624981E7","869.9071745812537"
"12095","35139","35135","4","35139","187273","7708.618125","0.10021203562499999","6.692364512437481E7","870.0073866168786"
"12096","35139","35138","4","35142","187277","7709.27625","0.10022059124999999","6.6931354400624804E7","870.1076072081287"
"12097","35142","35137","9","35146","187286","7710.1537499999995","0.10023199874999998","6.693906455437481E7","870.2078392068787"
"12098","35146","35137","2","35139","187288","7708.618125","0.10021203562499999","6.6946773172499806E7","870.3080512425037"
"12099","35139","35133","9","35142","187297","7709.27625","0.10022059124999999","6.69544824487498E7","870.4082718337537"
"12100","35142","35138","4","35142","187301","7709.27625","0.10022059124999999","6.69621917249998E7","870.5084924250037"
"12101","35142","35137","5","35142","187306","7709.27625","0.10022059124999999","6.69699010012498E7","870.6087130162538"
"12102","35142","35135","3","35138","187309","7708.39875","0.10020918375","6.69776093999998E7","870.7089222000038"
"12103","35138","35131","8","35139","187317","7708.618125","0.10021203562499999","6.69853180181248E7","870.8091342356288"
"12104","35139","35138","9","35147","187326","7710.373125","0.100234850625","6.69930283912498E7","870.9093690862538"
"12105","35147","35139","7","35146","187333","7710.1537499999995","0.10023199874999998","6.70007385449998E7","871.0096010850039"
"12106","35146","35138","7","35145","187340","7709.934375","0.100229146875","6.70084484793748E7","871.1098302318788"
"12107","35145","35142","1","35143","187341","7709.495625","0.10022344312499999","6.70161579749998E7","871.2100536750038"
"12108","35143","35138","3","35141","187344","7709.056874999999","0.10021773937499999","6.70238670318748E7","871.3102714143788"
"12109","35141","35136","4","35140","187348","7708.8375","0.10021488749999999","6.70315758693748E7","871.4104863018788"
"12110","35140","35134","9","35143","187357","7709.495625","0.10022344312499999","6.703928536499979E7","871.5107097450037"
"12111","35143","35134","5","35139","187362","7708.618125","0.10021203562499999","6.704699398312479E7","871.6109217806287"
"12112","35139","35134","2","35136","187364","7707.96","0.10020348","6.705470194312479E7","871.7111252606287"
"12113","35136","35130","9","35139","187373","7708.618125","0.10021203562499999","6.706241056124979E7","871.8113372962537"
"12114","35139","35136","2","35138","187375","7708.39875","0.10020918375","6.707011895999979E7","871.9115464800037"
"12115","35138","35130","3","35133","187378","7707.301875000001","0.10019492437500001","6.7077826261874795E7","872.0117414043788"
"12116","35133","35129","5","35134","187383","7707.52125","0.10019777625","6.70855337831248E7","872.1119391806287"
"12117","35134","35127","1","35128","187384","7706.205","0.10018066499999999","6.7093239988124795E7","872.2121198456288"
"12118","35128","35123","8","35131","187392","7706.863125","0.10018922062499999","6.710094685124979E7","872.3123090662538"
"12119","35131","35126","9","35135","187401","7707.740625","0.100200628125","6.710865459187479E7","872.4125096943787"
"12120","35135","35133","5","35138","187406","7708.39875","0.10020918375","6.71163629906248E7","872.5127188781288"
"12121","35138","35136","1","35137","187407","7708.179375000001","0.100206331875","6.71240711699998E7","872.6129252100038"
"12122","35137","35128","1","35129","187408","7706.424375","0.10018351687499999","6.713177759437479E7","872.7131087268788"
"12123","35129","35123","9","35132","187417","7707.0825","0.10019207249999999","6.713948467687479E7","872.8133007993788"
"12124","35132","35129","5","35134","187422","7707.52125","0.10019777625","6.714719219812478E7","872.9134985756288"
"12125","35134","35130","7","35137","187429","7708.179375000001","0.100206331875","6.715490037749977E7","873.0137049075038"
"12126","35137","35131","1","35132","187430","7707.0825","0.10019207249999999","6.716260745999977E7","873.1138969800038"
"12127","35132","35123","3","35126","187433","7705.76625","0.10017496124999999","6.717031322624977E7","873.2140719412538"
"12128","35126","35122","7","35129","187440","7706.424375","0.10018351687499999","6.717801965062477E7","873.3142554581287"
"12129","35129","35127","1","35128","187441","7706.205","0.10018066499999999","6.718572585562477E7","873.4144361231288"
"12130","35128","35125","8","35133","187449","7707.301875000001","0.10019492437500001","6.719343315749976E7","873.5146310475038"
"12131","35133","35132","4","35136","187453","7707.96","0.10020348","6.720114111749975E7","873.6148345275038"
"12132","35136","35135","7","35142","187460","7709.27625","0.10022059124999999","6.720885039374976E7","873.7150551187539"
"12133","35142","35133","3","35136","187463","7707.96","0.10020348","6.721655835374975E7","873.8152585987539"
"12134","35136","35133","5","35138","187468","7708.39875","0.10020918375","6.722426675249976E7","873.9154677825039"
"12135","35138","35135","4","35139","187472","7708.618125","0.10021203562499999","6.723197537062477E7","874.0156798181289"
"12136","35139","35136","5","35141","187477","7709.056874999999","0.10021773937499999","6.723968442749977E7","874.1158975575039"
"12137","35141","35133","1","35134","187478","7707.52125","0.10019777625","6.724739194874977E7","874.2160953337539"
"12138","35134","35130","1","35131","187479","7706.863125","0.10018922062499999","6.725509881187476E7","874.3162845543789"
"12139","35131","35129","1","35130","187480","7706.64375","0.10018636874999999","6.726280545562476E7","874.4164709231288"
"12140","35130","35129","9","35138","187489","7708.39875","0.10020918375","6.727051385437477E7","874.5166801068789"
"12141","35138","35134","9","35143","187498","7709.495625","0.10022344312499999","6.727822334999977E7","874.6169035500038"
"12142","35143","35134","4","35138","187502","7708.39875","0.10020918375","6.728593174874978E7","874.7171127337539"
"12143","35138","35131","1","35132","187503","7707.0825","0.10019207249999999","6.729363883124977E7","874.8173048062539"
"12144","35132","35129","8","35137","187511","7708.179375000001","0.100206331875","6.730134701062477E7","874.9175111381289"
"12145","35137","35135","7","35142","187518","7709.27625","0.10022059124999999","6.730905628687477E7","875.017731729379"
"12146","35142","35136","6","35142","187524","7709.27625","0.10022059124999999","6.731676556312478E7","875.117952320629"
"12147","35142","35134","5","35139","187529","7708.618125","0.10021203562499999","6.732447418124978E7","875.218164356254"
"12148","35139","35132","4","35136","187533","7707.96","0.10020348","6.733218214124978E7","875.318367836254"
"12149","35136","35128","7","35135","187540","7707.740625","0.100200628125","6.733988988187477E7","875.418568464379"
"12150","35135","35126","7","35133","187547","7707.301875000001","0.10019492437500001","6.734759718374977E7","875.518763388754"
"12151","35133","35132","4","35136","187551","7707.96","0.10020348","6.735530514374976E7","875.618966868754"
"12152","35136","35128","5","35133","187556","7707.301875000001","0.10019492437500001","6.736301244562475E7","875.719161793129"
"12153","35133","35124","3","35127","187559","7705.985625","0.100177813125","6.737071843124975E7","875.8193396062541"
"12154","35127","35122","5","35127","187564","7705.985625","0.100177813125","6.737842441687475E7","875.9195174193791"
"12155","35127","35123","6","35129","187570","7706.424375","0.10018351687499999","6.738613084124975E7","876.019700936254"
"12156","35129","35121","7","35128","187577","7706.205","0.10018066499999999","6.739383704624975E7","876.1198816012541"
"12157","35128","35122","4","35126","187581","7705.76625","0.10017496124999999","6.740154281249975E7","876.220056562504"
"12158","35126","35122","7","35129","187588","7706.424375","0.10018351687499999","6.740924923687474E7","876.320240079379"
"12159","35129","35127","3","35130","187591","7706.64375","0.10018636874999999","6.741695588062474E7","876.420426448129"
"12160","35130","35124","8","35132","187599","7707.0825","0.10019207249999999","6.742466296312474E7","876.520618520629"
"12161","35132","35125","6","35131","187605","7706.863125","0.10018922062499999","6.743236982624973E7","876.620807741254"
"12162","35131","35129","7","35136","187612","7707.96","0.10020348","6.744007778624973E7","876.721011221254"
"12163","35136","35132","2","35134","187614","7707.52125","0.10019777625","6.744778530749972E7","876.821208997504"
"12164","35134","35131","9","35140","187623","7708.8375","0.10021488749999999","6.745549414499973E7","876.921423885004"
"12165","35140","35136","7","35143","187630","7709.495625","0.10022344312499999","6.746320364062473E7","877.0216473281289"
"12166","35143","35136","3","35139","187633","7708.618125","0.10021203562499999","6.747091225874974E7","877.1218593637539"
"12167","35139","35138","1","35139","187634","7708.618125","0.10021203562499999","6.747862087687474E7","877.2220713993788"
"12168","35139","35133","6","35139","187640","7708.618125","0.10021203562499999","6.748632949499975E7","877.3222834350038"
"12169","35139","35138","4","35142","187644","7709.27625","0.10022059124999999","6.749403877124976E7","877.4225040262538"
"12170","35142","35135","9","35144","187653","7709.714999999999","0.10022629499999998","6.750174848624976E7","877.5227303212538"
"12171","35144","35139","4","35143","187657","7709.495625","0.10022344312499999","6.750945798187476E7","877.6229537643787"
"12172","35143","35136","3","35139","187660","7708.618125","0.10021203562499999","6.751716659999977E7","877.7231658000037"
"12173","35139","35135","4","35139","187664","7708.618125","0.10021203562499999","6.752487521812478E7","877.8233778356287"
"12174","35139","35134","6","35140","187670","7708.8375","0.10021488749999999","6.753258405562478E7","877.9235927231286"
"12175","35140","35135","2","35137","187672","7708.179375000001","0.100206331875","6.754029223499978E7","878.0237990550037"
"12176","35137","35130","9","35139","187681","7708.618125","0.10021203562499999","6.754800085312478E7","878.1240110906286"
"12177","35139","35131","5","35136","187686","7707.96","0.10020348","6.755570881312478E7","878.2242145706286"
"12178","35136","35134","5","35139","187691","7708.618125","0.10021203562499999","6.756341743124978E7","878.3244266062536"
"12179","35139","35135","9","35144","187700","7709.714999999999","0.10022629499999998","6.757112714624979E7","878.4246529012536"
"12180","35144","35142","7","35149","187707","7710.811874999999","0.10024055437499998","6.757883795812479E7","878.5248934556286"
"12181","35149","35143","9","35152","187716","7711.47","0.10024911","6.758654942812479E7","878.6251425656286"
"12182","35152","35151","3","35154","187719","7711.90875","0.10025481374999999","6.759426133687478E7","878.7253973793786"
"12183","35154","35152","6","35158","187725","7712.786250000001","0.10026622125000001","6.760197412312478E7","878.8256636006286"
"12184","35158","35157","1","35158","187726","7712.786250000001","0.10026622125000001","6.760968690937477E7","878.9259298218785"
"12185","35158","35151","5","35156","187731","7712.3475","0.1002605175","6.761739925687477E7","879.0261903393786"
"12186","35156","35154","6","35160","187737","7713.225","0.100271925","6.762511248187476E7","879.1264622643786"
"12187","35160","35151","7","35158","187744","7712.786250000001","0.10026622125000001","6.763282526812476E7","879.2267284856285"
"12188","35158","35154","2","35156","187746","7712.3475","0.1002605175","6.764053761562476E7","879.3269890031286"
"12189","35156","35153","7","35160","187753","7713.225","0.100271925","6.764825084062475E7","879.4272609281286"
"12190","35160","35158","2","35160","187755","7713.225","0.100271925","6.765596406562474E7","879.5275328531286"
"12191","35160","35152","1","35153","187756","7711.689375","0.10025196187499999","6.766367575499974E7","879.6277848150036"
"12192","35153","35152","9","35161","187765","7713.444375","0.100274776875","6.767138919937474E7","879.7280595918786"
"12193","35161","35157","5","35162","187770","7713.663750000001","0.10027762875","6.767910286312473E7","879.8283372206286"
"12194","35162","35157","9","35166","187779","7714.541249999999","0.10028903624999999","6.768681740437473E7","879.9286262568786"
"12195","35166","35162","3","35165","187782","7714.321875","0.10028618437499999","6.769453172624974E7","880.0289124412536"
"12196","35165","35158","7","35165","187789","7714.321875","0.10028618437499999","6.770224604812475E7","880.1291986256286"
"12197","35165","35163","7","35170","187796","7715.41875","0.10030044375","6.770996146687475E7","880.2294990693787"
"12198","35170","35164","4","35168","187800","7714.98","0.10029474","6.771767644687475E7","880.3297938093787"
"12199","35168","35159","4","35163","187804","7713.883125","0.100280480625","6.772539032999976E7","880.4300742900036"
"12200","35163","35162","8","35170","187812","7715.41875","0.10030044375","6.773310574874976E7","880.5303747337537"
"12201","35170","35168","9","35177","187821","7716.954375","0.100320406875","6.774082270312476E7","880.6306951406286"
"12202","35177","35172","1","35173","187822","7716.076875000001","0.100308999375","6.774853877999976E7","880.7310041400036"
"12203","35173","35164","3","35167","187825","7714.760625","0.10029188812499999","6.775625354062477E7","880.8312960281286"
"12204","35167","35164","4","35168","187829","7714.98","0.10029474","6.776396852062477E7","880.9315907681286"
"12205","35168","35163","9","35172","187838","7715.8575","0.1003061475","6.777168437812477E7","881.0318969156285"
"12206","35172","35171","6","35177","187844","7716.954375","0.100320406875","6.777940133249977E7","881.1322173225035"
"12207","35177","35176","6","35182","187850","7718.05125","0.10033466625","6.778711938374977E7","881.2325519887535"
"12208","35182","35176","5","35181","187855","7717.831875","0.100331814375","6.779483721562476E7","881.3328838031284"
"12209","35181","35175","4","35179","187859","7717.393125","0.10032611062499999","6.780255460874976E7","881.4332099137534"
"12210","35179","35172","6","35178","187865","7717.17375","0.10032325874999999","6.781027178249976E7","881.5335331725034"
"12211","35178","35176","8","35184","187873","7718.49","0.10034036999999998","6.781799027249976E7","881.6338735425035"
"12212","35184","35176","7","35183","187880","7718.270625000001","0.10033751812500001","6.782570854312475E7","881.7342110606285"
"12213","35183","35178","5","35183","187885","7718.270625000001","0.10033751812500001","6.783342681374975E7","881.8345485787535"
"12214","35183","35177","9","35186","187894","7718.92875","0.10034607375","6.784114574249974E7","881.9348946525034"
"12215","35186","35182","5","35187","187899","7719.148125000001","0.100348925625","6.784886489062473E7","882.0352435781284"
"12216","35187","35184","7","35191","187906","7720.025624999999","0.10036033312499998","6.785658491624974E7","882.1356039112534"
"12217","35191","35183","5","35188","187911","7719.3675","0.1003517775","6.786430428374974E7","882.2359556887534"
"12218","35188","35183","5","35188","187916","7719.3675","0.1003517775","6.787202365124975E7","882.3363074662534"
"12219","35188","35181","9","35190","187925","7719.80625","0.10035748124999999","6.787974345749976E7","882.4366649475033"
"12220","35190","35186","4","35190","187929","7719.80625","0.10035748124999999","6.788746326374976E7","882.5370224287533"
"12221","35190","35182","8","35190","187937","7719.80625","0.10035748124999999","6.789518306999977E7","882.6373799100032"
"12222","35190","35187","1","35188","187938","7719.3675","0.1003517775","6.790290243749978E7","882.7377316875032"
"12223","35188","35187","1","35188","187939","7719.3675","0.1003517775","6.791062180499978E7","882.8380834650033"
"12224","35188","35184","7","35191","187946","7720.025624999999","0.10036033312499998","6.791834183062479E7","882.9384437981282"
"12225","35191","35187","7","35194","187953","7720.683749999999","0.10036888874999998","6.79260625143748E7","883.0388126868783"
"12226","35194","35189","1","35190","187954","7719.80625","0.10035748124999999","6.79337823206248E7","883.1391701681282"
"12227","35190","35188","1","35189","187955","7719.586875","0.10035462937499999","6.79415019074998E7","883.2395247975032"
"12228","35189","35188","8","35196","187963","7721.1224999999995","0.10037459249999998","6.794922302999981E7","883.3398993900032"
"12229","35196","35195","2","35197","187965","7721.341875","0.100377444375","6.795694437187481E7","883.4402768343782"
"12230","35197","35196","8","35204","187973","7722.8775","0.1003974075","6.79646672493748E7","883.5406742418783"
"12231","35204","35201","6","35207","187979","7723.535625","0.100405963125","6.79723907849998E7","883.6410802050033"
"12232","35207","35199","9","35208","187988","7723.755000000001","0.10040881500000001","6.79801145399998E7","883.7414890200033"
"12233","35208","35200","9","35209","187997","7723.974375","0.10041166687499999","6.79878385143748E7","883.8419006868783"
"12234","35209","35207","8","35215","188005","7725.290625","0.10042877812499999","6.79955638049998E7","883.9423294650032"
"12235","35215","35214","6","35220","188011","7726.3875","0.10044303749999998","6.80032901924998E7","884.0427725025032"
"12236","35220","35214","4","35218","188015","7725.94875","0.10043733374999998","6.80110161412498E7","884.1432098362533"
"12237","35218","35215","2","35217","188017","7725.729375","0.100434481875","6.801874187062481E7","884.2436443181283"
"12238","35217","35214","1","35215","188018","7725.290625","0.10042877812499999","6.802646716124982E7","884.3440730962533"
"12239","35215","35209","1","35210","188019","7724.19375","0.10041451875","6.803419135499981E7","884.4444876150033"
"12240","35210","35202","1","35203","188020","7722.658125","0.10039455562499999","6.804191401312481E7","884.5448821706283"
"12241","35203","35197","9","35206","188029","7723.31625","0.10040311125","6.80496373293748E7","884.6452852818783"
"12242","35206","35203","4","35207","188033","7723.535625","0.100405963125","6.80573608649998E7","884.7456912450033"
"12243","35207","35198","3","35201","188036","7722.219375","0.10038885187499999","6.80650830843748E7","884.8460800968783"
"12244","35201","35197","3","35200","188039","7722.0","0.10038599999999999","6.80728050843748E7","884.9464660968782"
"12245","35200","35197","1","35198","188040","7721.561250000001","0.10038029625","6.80805266456248E7","885.0468463931282"
"12246","35198","35189","3","35192","188043","7720.245","0.100363185","6.80882468906248E7","885.1472095781282"
"12247","35192","35184","6","35190","188049","7719.80625","0.10035748124999999","6.809596669687481E7","885.2475670593782"
"12248","35190","35183","4","35187","188053","7719.148125000001","0.100348925625","6.81036858449998E7","885.3479159850032"
"12249","35187","35181","3","35184","188056","7718.49","0.10034036999999998","6.81114043349998E7","885.4482563550032"
"12250","35184","35176","6","35182","188062","7718.05125","0.10033466625","6.81191223862498E7","885.5485910212532"
"12251","35182","35177","6","35183","188068","7718.270625000001","0.10033751812500001","6.812684065687479E7","885.6489285393782"
"12252","35183","35176","9","35185","188077","7718.709375","0.100343221875","6.813455936624978E7","885.7492717612532"
"12253","35185","35180","8","35188","188085","7719.3675","0.1003517775","6.814227873374979E7","885.8496235387532"
"12254","35188","35187","8","35195","188093","7720.903125","0.100371740625","6.81499996368748E7","885.9499952793782"
"12255","35195","35186","6","35192","188099","7720.245","0.100363185","6.81577198818748E7","886.0503584643782"
"12256","35192","35191","9","35200","188108","7722.0","0.10038599999999999","6.81654418818748E7","886.1507444643781"
"12257","35200","35194","1","35195","188109","7720.903125","0.100371740625","6.81731627849998E7","886.2511162050031"
"12258","35195","35190","4","35194","188113","7720.683749999999","0.10036888874999998","6.81808834687498E7","886.3514850937531"
"12259","35194","35192","3","35195","188116","7720.903125","0.100371740625","6.818860437187481E7","886.4518568343781"
"12260","35195","35189","6","35195","188122","7720.903125","0.100371740625","6.819632527499981E7","886.552228575003"
"12261","35195","35188","4","35192","188126","7720.245","0.100363185","6.820404551999982E7","886.652591760003"
"12262","35192","35184","4","35188","188130","7719.3675","0.1003517775","6.821176488749982E7","886.752943537503"
"12263","35188","35184","6","35190","188136","7719.80625","0.10035748124999999","6.821948469374983E7","886.853301018753"
"12264","35190","35186","3","35189","188139","7719.586875","0.10035462937499999","6.822720428062484E7","886.953655648128"
"12265","35189","35187","8","35195","188147","7720.903125","0.100371740625","6.823492518374984E7","887.054027388753"
"12266","35195","35193","3","35196","188150","7721.1224999999995","0.10037459249999998","6.824264630624984E7","887.1544019812529"
"12267","35196","35191","3","35194","188153","7720.683749999999","0.10036888874999998","6.825036698999985E7","887.254770870003"
"12268","35194","35188","3","35191","188156","7720.025624999999","0.10036033312499998","6.825808701562485E7","887.3551312031279"
"12269","35191","35189","8","35197","188164","7721.341875","0.100377444375","6.826580835749985E7","887.4555086475029"
"12270","35197","35196","4","35200","188168","7722.0","0.10038599999999999","6.827353035749985E7","887.5558946475029"
"12271","35200","35193","7","35200","188175","7722.0","0.10038599999999999","6.828125235749985E7","887.6562806475029"
"12272","35200","35197","6","35203","188181","7722.658125","0.10039455562499999","6.828897501562485E7","887.7566752031279"
"12273","35203","35194","7","35201","188188","7722.219375","0.10038885187499999","6.829669723499985E7","887.8570640550029"
"12274","35201","35197","3","35200","188191","7722.0","0.10038599999999999","6.830441923499985E7","887.9574500550028"
"12275","35200","35192","2","35194","188193","7720.683749999999","0.10036888874999998","6.831213991874985E7","888.0578189437529"
"12276","35194","35189","9","35198","188202","7721.561250000001","0.10038029625","6.831986147999986E7","888.1581992400029"
"12277","35198","35191","2","35193","188204","7720.464375","0.100366036875","6.832758194437486E7","888.2585652768779"
"12278","35193","35190","6","35196","188210","7721.1224999999995","0.10037459249999998","6.833530306687486E7","888.3589398693779"
"12279","35196","35193","2","35195","188212","7720.903125","0.100371740625","6.834302396999986E7","888.4593116100028"
"12280","35195","35193","7","35200","188219","7722.0","0.10038599999999999","6.835074596999986E7","888.5596976100028"
"12281","35200","35194","6","35200","188225","7722.0","0.10038599999999999","6.835846796999986E7","888.6600836100027"
"12282","35200","35195","1","35196","188226","7721.1224999999995","0.10037459249999998","6.836618909249987E7","888.7604582025027"
"12283","35196","35194","9","35203","188235","7722.658125","0.10039455562499999","6.837391175062487E7","888.8608527581277"
"12284","35203","35194","5","35199","188240","7721.780624999999","0.10038314812499999","6.838163353124987E7","888.9612359062528"
"12285","35199","35196","3","35199","188243","7721.780624999999","0.10038314812499999","6.838935531187487E7","889.0616190543778"
"12286","35199","35198","8","35206","188251","7723.31625","0.10040311125","6.839707862812486E7","889.1620221656278"
"12287","35206","35198","4","35202","188255","7722.43875","0.10039170374999999","6.840480106687486E7","889.2624138693778"
"12288","35202","35195","7","35202","188262","7722.43875","0.10039170374999999","6.841252350562486E7","889.3628055731278"
"12289","35202","35199","6","35205","188268","7723.096875","0.100400259375","6.842024660249986E7","889.4632058325028"
"12290","35205","35198","1","35199","188269","7721.780624999999","0.10038314812499999","6.842796838312486E7","889.5635889806279"
"12291","35199","35197","9","35206","188278","7723.31625","0.10040311125","6.843569169937485E7","889.6639920918778"
"12292","35206","35202","4","35206","188282","7723.31625","0.10040311125","6.844341501562485E7","889.7643952031278"
"12293","35206","35200","9","35209","188291","7723.974375","0.10041166687499999","6.845113898999985E7","889.8648068700028"
"12294","35209","35204","2","35206","188293","7723.31625","0.10040311125","6.845886230624984E7","889.9652099812528"
"12295","35206","35203","8","35211","188301","7724.413125","0.10041737062499999","6.846658671937484E7","890.0656273518778"
"12296","35211","35208","7","35215","188308","7725.290625","0.10042877812499999","6.847431200999984E7","890.1660561300027"
"12297","35215","35208","7","35215","188315","7725.290625","0.10042877812499999","6.848203730062485E7","890.2664849081277"
"12298","35215","35211","6","35217","188321","7725.729375","0.100434481875","6.848976302999985E7","890.3669193900027"
"12299","35217","35208","5","35213","188326","7724.851875","0.100423074375","6.849748788187486E7","890.4673424643778"
"12300","35213","35212","7","35219","188333","7726.168124999999","0.10044018562499998","6.850521404999986E7","890.5677826500028"
"12301","35219","35218","5","35223","188338","7727.045625000001","0.100451593125","6.851294109562486E7","890.6682342431277"
"12302","35223","35215","2","35217","188340","7725.729375","0.100434481875","6.852066682499987E7","890.7686687250027"
"12303","35217","35214","6","35220","188346","7726.3875","0.10044303749999998","6.852839321249987E7","890.8691117625027"
"12304","35220","35211","2","35213","188348","7724.851875","0.100423074375","6.853611806437488E7","890.9695348368778"
"12305","35213","35210","4","35214","188352","7725.07125","0.10042592624999999","6.854384313562489E7","891.0699607631277"
"12306","35214","35205","7","35212","188359","7724.632500000001","0.1004202225","6.855156776812488E7","891.1703809856277"
"12307","35212","35205","9","35214","188368","7725.07125","0.10042592624999999","6.855929283937488E7","891.2708069118777"
"12308","35214","35209","2","35211","188370","7724.413125","0.10041737062499999","6.856701725249988E7","891.3712242825027"
"12309","35211","35205","2","35207","188372","7723.535625","0.100405963125","6.857474078812487E7","891.4716302456277"
"12310","35207","35201","1","35202","188373","7722.43875","0.10039170374999999","6.858246322687487E7","891.5720219493777"
"12311","35202","35193","8","35201","188381","7722.219375","0.10038885187499999","6.859018544624987E7","891.6724108012527"
"12312","35201","35197","4","35201","188385","7722.219375","0.10038885187499999","6.859790766562487E7","891.7727996531277"
"12313","35201","35198","1","35199","188386","7721.780624999999","0.10038314812499999","6.860562944624987E7","891.8731828012527"
"12314","35199","35195","8","35203","188394","7722.658125","0.10039455562499999","6.861335210437487E7","891.9735773568777"
"12315","35203","35194","3","35197","188397","7721.341875","0.100377444375","6.862107344624987E7","892.0739548012527"
"12316","35197","35196","6","35202","188403","7722.43875","0.10039170374999999","6.862879588499987E7","892.1743465050027"
"12317","35202","35199","4","35203","188407","7722.658125","0.10039455562499999","6.863651854312487E7","892.2747410606278"
"12318","35203","35200","6","35206","188413","7723.31625","0.10040311125","6.864424185937487E7","892.3751441718778"
"12319","35206","35202","8","35210","188421","7724.19375","0.10041451875","6.865196605312486E7","892.4755586906277"
"12320","35210","35204","2","35206","188423","7723.31625","0.10040311125","6.865968936937486E7","892.5759618018777"
"12321","35206","35202","3","35205","188426","7723.096875","0.100400259375","6.866741246624985E7","892.6763620612527"
"12322","35205","35204","5","35209","188431","7723.974375","0.10041166687499999","6.867513644062485E7","892.7767737281276"
"12323","35209","35205","9","35214","188440","7725.07125","0.10042592624999999","6.868286151187485E7","892.8771996543776"
"12324","35214","35212","5","35217","188445","7725.729375","0.100434481875","6.869058724124986E7","892.9776341362526"
"12325","35217","35208","6","35214","188451","7725.07125","0.10042592624999999","6.869831231249987E7","893.0780600625026"
"12326","35214","35210","7","35217","188458","7725.729375","0.100434481875","6.870603804187487E7","893.1784945443776"
"12327","35217","35210","1","35211","188459","7724.413125","0.10041737062499999","6.871376245499986E7","893.2789119150026"
"12328","35211","35207","5","35212","188464","7724.632500000001","0.1004202225","6.872148708749986E7","893.3793321375026"
"12329","35212","35208","1","35209","188465","7723.974375","0.10041166687499999","6.872921106187485E7","893.4797438043776"
"12330","35209","35207","6","35213","188471","7724.851875","0.100423074375","6.873693591374986E7","893.5801668787526"
"12331","35213","35205","3","35208","188474","7723.755000000001","0.10040881500000001","6.874465966874985E7","893.6805756937526"
"12332","35208","35199","8","35207","188482","7723.535625","0.100405963125","6.875238320437485E7","893.7809816568777"
"12333","35207","35200","9","35209","188491","7723.974375","0.10041166687499999","6.876010717874984E7","893.8813933237526"
"12334","35209","35208","3","35211","188494","7724.413125","0.10041737062499999","6.876783159187484E7","893.9818106943776"
"12335","35211","35202","6","35208","188500","7723.755000000001","0.10040881500000001","6.877555534687483E7","894.0822195093776"
"12336","35208","35202","5","35207","188505","7723.535625","0.100405963125","6.878327888249983E7","894.1826254725027"
"12337","35207","35204","4","35208","188509","7723.755000000001","0.10040881500000001","6.879100263749982E7","894.2830342875027"
"12338","35208","35207","3","35210","188512","7724.19375","0.10041451875","6.879872683124982E7","894.3834488062527"
"12339","35210","35202","5","35207","188517","7723.535625","0.100405963125","6.880645036687481E7","894.4838547693777"
"12340","35207","35201","8","35209","188525","7723.974375","0.10041166687499999","6.881417434124981E7","894.5842664362526"
"12341","35209","35201","9","35210","188534","7724.19375","0.10041451875","6.88218985349998E7","894.6846809550026"
"12342","35210","35204","1","35205","188535","7723.096875","0.100400259375","6.88296216318748E7","894.7850812143776"
"12343","35205","35199","4","35203","188539","7722.658125","0.10039455562499999","6.88373442899998E7","894.8854757700026"
"12344","35203","35195","7","35202","188546","7722.43875","0.10039170374999999","6.88450667287498E7","894.9858674737526"
"12345","35202","35197","5","35202","188551","7722.43875","0.10039170374999999","6.88527891674998E7","895.0862591775026"
"12346","35202","35194","4","35198","188555","7721.561250000001","0.10038029625","6.88605107287498E7","895.1866394737526"
"12347","35198","35197","9","35206","188564","7723.31625","0.10040311125","6.88682340449998E7","895.2870425850026"
"12348","35206","35201","3","35204","188567","7722.8775","0.1003974075","6.887595692249979E7","895.3874399925027"
"12349","35204","35199","2","35201","188569","7722.219375","0.10038885187499999","6.888367914187479E7","895.4878288443776"
"12350","35201","35194","1","35195","188570","7720.903125","0.100371740625","6.88914000449998E7","895.5882005850026"
"12351","35195","35193","2","35195","188572","7720.903125","0.100371740625","6.88991209481248E7","895.6885723256275"
"12352","35195","35188","7","35195","188579","7720.903125","0.100371740625","6.89068418512498E7","895.7889440662525"
"12353","35195","35194","7","35201","188586","7722.219375","0.10038885187499999","6.89145640706248E7","895.8893329181275"
"12354","35201","35196","9","35205","188595","7723.096875","0.100400259375","6.89222871674998E7","895.9897331775024"
"12355","35205","35201","9","35210","188604","7724.19375","0.10041451875","6.893001136124979E7","896.0901476962524"
"12356","35210","35202","7","35209","188611","7723.974375","0.10041166687499999","6.893773533562478E7","896.1905593631274"
"12357","35209","35201","8","35209","188619","7723.974375","0.10041166687499999","6.894545930999978E7","896.2909710300023"
"12358","35209","35204","7","35211","188626","7724.413125","0.10041737062499999","6.895318372312477E7","896.3913884006273"
"12359","35211","35205","2","35207","188628","7723.535625","0.100405963125","6.896090725874977E7","896.4917943637523"
"12360","35207","35204","7","35211","188635","7724.413125","0.10041737062499999","6.896863167187476E7","896.5922117343773"
"12361","35211","35206","8","35214","188643","7725.07125","0.10042592624999999","6.897635674312477E7","896.6926376606273"
"12362","35214","35212","6","35218","188649","7725.94875","0.10043733374999998","6.898408269187477E7","896.7930749943773"
"12363","35218","35209","3","35212","188652","7724.632500000001","0.1004202225","6.899180732437477E7","896.8934952168773"
"12364","35212","35210","1","35211","188653","7724.413125","0.10041737062499999","6.899953173749976E7","896.9939125875023"
"12365","35211","35204","9","35213","188662","7724.851875","0.100423074375","6.900725658937477E7","897.0943356618774"
"12366","35213","35208","2","35210","188664","7724.19375","0.10041451875","6.901498078312476E7","897.1947501806274"
"12367","35210","35205","9","35214","188673","7725.07125","0.10042592624999999","6.902270585437477E7","897.2951761068773"
"12368","35214","35209","2","35211","188675","7724.413125","0.10041737062499999","6.903043026749976E7","897.3955934775023"
"12369","35211","35210","6","35216","188681","7725.509999999999","0.10043162999999998","6.903815577749977E7","897.4960251075023"
"12370","35216","35213","9","35222","188690","7726.82625","0.10044874125","6.904588260374977E7","897.5964738487523"
"12371","35222","35215","5","35220","188695","7726.3875","0.10044303749999998","6.905360899124977E7","897.6969168862523"
"12372","35220","35214","3","35217","188698","7725.729375","0.100434481875","6.906133472062477E7","897.7973513681274"
"12373","35217","35214","3","35217","188701","7725.729375","0.100434481875","6.906906044999978E7","897.8977858500024"
"12374","35217","35210","5","35215","188706","7725.290625","0.10042877812499999","6.907678574062479E7","897.9982146281274"
"12375","35215","35206","6","35212","188712","7724.632500000001","0.1004202225","6.908451037312478E7","898.0986348506274"
"12376","35212","35204","2","35206","188714","7723.31625","0.10040311125","6.909223368937477E7","898.1990379618774"
"12377","35206","35203","4","35207","188718","7723.535625","0.100405963125","6.909995722499977E7","898.2994439250024"
"12378","35207","35204","2","35206","188720","7723.31625","0.10040311125","6.910768054124977E7","898.3998470362524"
"12379","35206","35201","4","35205","188724","7723.096875","0.100400259375","6.911540363812476E7","898.5002472956273"
"12380","35205","35199","1","35200","188725","7722.0","0.10038599999999999","6.912312563812476E7","898.6006332956273"
"12381","35200","35191","9","35200","188734","7722.0","0.10038599999999999","6.913084763812476E7","898.7010192956272"
"12382","35200","35191","4","35195","188738","7720.903125","0.100371740625","6.913856854124977E7","898.8013910362522"
"12383","35195","35190","6","35196","188744","7721.1224999999995","0.10037459249999998","6.914628966374977E7","898.9017656287522"
"12384","35196","35191","3","35194","188747","7720.683749999999","0.10036888874999998","6.915401034749977E7","899.0021345175022"
"12385","35194","35189","8","35197","188755","7721.341875","0.100377444375","6.916173168937477E7","899.1025119618772"
"12386","35197","35188","1","35189","188756","7719.586875","0.10035462937499999","6.916945127624978E7","899.2028665912522"
"12387","35189","35186","9","35195","188765","7720.903125","0.100371740625","6.917717217937478E7","899.3032383318772"
"12388","35195","35188","5","35193","188770","7720.464375","0.100366036875","6.918489264374979E7","899.4036043687522"
"12389","35193","35188","8","35196","188778","7721.1224999999995","0.10037459249999998","6.919261376624979E7","899.5039789612522"
"12390","35196","35188","3","35191","188781","7720.025624999999","0.10036033312499998","6.92003337918748E7","899.6043392943772"
"12391","35191","35187","6","35193","188787","7720.464375","0.100366036875","6.92080542562498E7","899.7047053312522"
"12392","35193","35189","6","35195","188793","7720.903125","0.100371740625","6.92157751593748E7","899.8050770718771"
"12393","35195","35188","3","35191","188796","7720.025624999999","0.10036033312499998","6.922349518499981E7","899.9054374050021"
"12394","35191","35184","8","35192","188804","7720.245","0.100363185","6.923121542999981E7","900.0058005900021"
"12395","35192","35191","7","35198","188811","7721.561250000001","0.10038029625","6.923893699124981E7","900.1061808862521"
"12396","35198","35191","6","35197","188817","7721.341875","0.100377444375","6.924665833312482E7","900.2065583306271"
"12397","35197","35196","3","35199","188820","7721.780624999999","0.10038314812499999","6.925438011374982E7","900.3069414787522"
"12398","35199","35196","5","35201","188825","7722.219375","0.10038885187499999","6.926210233312482E7","900.4073303306271"
"12399","35201","35195","2","35197","188827","7721.341875","0.100377444375","6.926982367499982E7","900.5077077750021"
"12400","35197","35192","1","35193","188828","7720.464375","0.100366036875","6.927754413937482E7","900.6080738118771"
"12401","35193","35191","2","35193","188830","7720.464375","0.100366036875","6.928526460374983E7","900.7084398487522"
"12402","35193","35184","8","35192","188838","7720.245","0.100363185","6.929298484874983E7","900.8088030337522"
"12403","35192","35185","9","35194","188847","7720.683749999999","0.10036888874999998","6.930070553249983E7","900.9091719225022"
"12404","35194","35188","4","35192","188851","7720.245","0.100363185","6.930842577749984E7","901.0095351075022"
"12405","35192","35189","4","35193","188855","7720.464375","0.100366036875","6.931614624187484E7","901.1099011443772"
"12406","35193","35189","9","35198","188864","7721.561250000001","0.10038029625","6.932386780312485E7","901.2102814406272"
"12407","35198","35189","1","35190","188865","7719.80625","0.10035748124999999","6.933158760937485E7","901.3106389218772"
"12408","35190","35183","4","35187","188869","7719.148125000001","0.100348925625","6.933930675749984E7","901.4109878475022"
"12409","35187","35178","4","35182","188873","7718.05125","0.10033466625","6.934702480874984E7","901.5113225137521"
"12410","35182","35180","2","35182","188875","7718.05125","0.10033466625","6.935474285999984E7","901.6116571800021"
"12411","35182","35179","8","35187","188883","7719.148125000001","0.100348925625","6.936246200812483E7","901.7120061056271"
"12412","35187","35186","4","35190","188887","7719.80625","0.10035748124999999","6.937018181437483E7","901.812363586877"
"12413","35190","35182","3","35185","188890","7718.709375","0.100343221875","6.937790052374983E7","901.9127068087521"
"12414","35185","35178","2","35180","188892","7717.6125","0.1003289625","6.938561813624983E7","902.0130357712521"
"12415","35180","35175","9","35184","188901","7718.49","0.10034036999999998","6.939333662624982E7","902.1133761412522"
"12416","35184","35176","4","35180","188905","7717.6125","0.1003289625","6.940105423874982E7","902.2137051037522"
"12417","35180","35178","7","35185","188912","7718.709375","0.100343221875","6.940877294812481E7","902.3140483256273"
"12418","35185","35184","9","35193","188921","7720.464375","0.100366036875","6.941649341249982E7","902.4144143625023"
"12419","35193","35188","4","35192","188925","7720.245","0.100363185","6.942421365749982E7","902.5147775475023"
"12420","35192","35188","1","35189","188926","7719.586875","0.10035462937499999","6.943193324437483E7","902.6151321768773"
"12421","35189","35183","2","35185","188928","7718.709375","0.100343221875","6.943965195374982E7","902.7154753987523"
"12422","35185","35182","8","35190","188936","7719.80625","0.10035748124999999","6.944737175999983E7","902.8158328800023"
"12423","35190","35183","9","35192","188945","7720.245","0.100363185","6.945509200499983E7","902.9161960650023"
"12424","35192","35184","8","35192","188953","7720.245","0.100363185","6.946281224999984E7","903.0165592500023"
"12425","35192","35188","2","35190","188955","7719.80625","0.10035748124999999","6.947053205624984E7","903.1169167312522"
"12426","35190","35187","9","35196","188964","7721.1224999999995","0.10037459249999998","6.947825317874984E7","903.2172913237522"
"12427","35196","35195","8","35203","188972","7722.658125","0.10039455562499999","6.948597583687484E7","903.3176858793772"
"12428","35203","35202","6","35208","188978","7723.755000000001","0.10040881500000001","6.949369959187484E7","903.4180946943773"
"12429","35208","35207","1","35208","188979","7723.755000000001","0.10040881500000001","6.950142334687483E7","903.5185035093773"
"12430","35208","35199","9","35208","188988","7723.755000000001","0.10040881500000001","6.950914710187483E7","903.6189123243773"
"12431","35208","35206","8","35214","188996","7725.07125","0.10042592624999999","6.951687217312483E7","903.7193382506273"
"12432","35214","35212","3","35215","188999","7725.290625","0.10042877812499999","6.952459746374984E7","903.8197670287523"
"12433","35215","35212","6","35218","189005","7725.94875","0.10043733374999998","6.953232341249985E7","903.9202043625023"
"12434","35218","35214","1","35215","189006","7725.290625","0.10042877812499999","6.954004870312485E7","904.0206331406273"
"12435","35215","35206","1","35207","189007","7723.535625","0.100405963125","6.954777223874985E7","904.1210391037523"
"12436","35207","35198","7","35205","189014","7723.096875","0.100400259375","6.955549533562484E7","904.2214393631273"
"12437","35205","35203","1","35204","189015","7722.8775","0.1003974075","6.956321821312484E7","904.3218367706273"
"12438","35204","35197","9","35206","189024","7723.31625","0.10040311125","6.957094152937484E7","904.4222398818773"
"12439","35206","35201","6","35207","189030","7723.535625","0.100405963125","6.957866506499983E7","904.5226458450023"
"12440","35207","35202","4","35206","189034","7723.31625","0.10040311125","6.958638838124983E7","904.6230489562523"
"12441","35206","35199","8","35207","189042","7723.535625","0.100405963125","6.959411191687483E7","904.7234549193773"
"12442","35207","35206","6","35212","189048","7724.632500000001","0.1004202225","6.960183654937482E7","904.8238751418774"
"12443","35212","35211","4","35215","189052","7725.290625","0.10042877812499999","6.960956183999982E7","904.9243039200023"
"12444","35215","35212","8","35220","189060","7726.3875","0.10044303749999998","6.961728822749983E7","905.0247469575023"
"12445","35220","35219","9","35228","189069","7728.1425","0.1004658525","6.962501636999983E7","905.1252128100023"
"12446","35228","35226","8","35234","189077","7729.45875","0.10048296374999999","6.963274582874982E7","905.2256957737522"
"12447","35234","35225","7","35232","189084","7729.02","0.10047726","6.964047484874982E7","905.3261730337523"
"12448","35232","35225","2","35227","189086","7727.923125","0.10046300062499999","6.964820277187482E7","905.4266360343773"
"12449","35227","35224","6","35230","189092","7728.58125","0.10047155625","6.965593135312481E7","905.5271075906273"
"12450","35230","35221","8","35229","189100","7728.361875","0.100468704375","6.966365971499981E7","905.6275762950023"
"12451","35229","35226","7","35233","189107","7729.239375000001","0.10048011187500001","6.96713889543748E7","905.7280564068773"
"12452","35233","35231","4","35235","189111","7729.678125","0.100485815625","6.96791186324998E7","905.8285422225023"
"12453","35235","35232","7","35239","189118","7730.555625","0.100497223125","6.96868491881248E7","905.9290394456273"
"12454","35239","35235","7","35242","189125","7731.21375","0.10050577875","6.969458040187481E7","906.0295452243772"
"12455","35242","35239","5","35244","189130","7731.652499999999","0.10051148249999999","6.970231205437481E7","906.1300567068772"
"12456","35244","35243","4","35247","189134","7732.310625","0.10052003812499999","6.971004436499982E7","906.2305767450022"
"12457","35247","35243","2","35245","189136","7731.871875","0.10051433437499999","6.971777623687482E7","906.3310910793772"
"12458","35245","35243","4","35247","189140","7732.310625","0.10052003812499999","6.972550854749982E7","906.4316111175021"
"12459","35247","35239","1","35240","189141","7730.775","0.100500075","6.973323932249983E7","906.5321111925022"
"12460","35240","35234","9","35243","189150","7731.433125","0.10050863062499998","6.974097075562483E7","906.6326198231271"
"12461","35243","35239","9","35248","189159","7732.530000000001","0.10052289","6.974870328562483E7","906.7331427131271"
"12462","35248","35244","5","35249","189164","7732.749374999999","0.10052574187499999","6.975643603499983E7","906.8336684550021"
"12463","35249","35248","7","35255","189171","7734.065625","0.100542853125","6.976417010062483E7","906.9342113081271"
"12464","35255","35246","8","35254","189179","7733.84625","0.10054000124999998","6.977190394687483E7","907.0347513093772"
"12465","35254","35247","7","35254","189186","7733.84625","0.10054000124999998","6.977963779312482E7","907.1352913106272"
"12466","35254","35245","4","35249","189190","7732.749374999999","0.10052574187499999","6.978737054249983E7","907.2358170525022"
"12467","35249","35245","1","35246","189191","7732.0912499999995","0.10051718624999999","6.979510263374983E7","907.3363342387522"
"12468","35246","35238","7","35245","189198","7731.871875","0.10051433437499999","6.980283450562483E7","907.4368485731272"
"12469","35245","35241","8","35249","189206","7732.749374999999","0.10052574187499999","6.981056725499983E7","907.5373743150022"
"12470","35249","35240","6","35246","189212","7732.0912499999995","0.10051718624999999","6.981829934624983E7","907.6378915012523"
"12471","35246","35245","6","35251","189218","7733.188125","0.100531445625","6.982603253437483E7","907.7384229468773"
"12472","35251","35247","2","35249","189220","7732.749374999999","0.10052574187499999","6.983376528374983E7","907.8389486887523"
"12473","35249","35244","1","35245","189221","7731.871875","0.10051433437499999","6.984149715562484E7","907.9394630231274"
"12474","35245","35243","8","35251","189229","7733.188125","0.100531445625","6.984923034374984E7","908.0399944687524"
"12475","35251","35245","9","35254","189238","7733.84625","0.10054000124999998","6.985696418999983E7","908.1405344700024"
"12476","35254","35249","6","35255","189244","7734.065625","0.100542853125","6.986469825562483E7","908.2410773231275"
"12477","35255","35253","2","35255","189246","7734.065625","0.100542853125","6.987243232124983E7","908.3416201762525"
"12478","35255","35253","3","35256","189249","7734.285","0.10054570499999999","6.988016660624982E7","908.4421658812524"
"12479","35256","35248","4","35252","189253","7733.4075","0.1005342975","6.988790001374982E7","908.5427001787524"
"12480","35252","35247","5","35252","189258","7733.4075","0.1005342975","6.989563342124982E7","908.6432344762524"
"12481","35252","35245","4","35249","189262","7732.749374999999","0.10052574187499999","6.990336617062482E7","908.7437602181274"
"12482","35249","35246","7","35253","189269","7733.626875","0.100537149375","6.991109979749982E7","908.8442973675023"
"12483","35253","35251","2","35253","189271","7733.626875","0.100537149375","6.991883342437482E7","908.9448345168773"
"12484","35253","35250","4","35254","189275","7733.84625","0.10054000124999998","6.992656727062482E7","909.0453745181273"
"12485","35254","35251","3","35254","189278","7733.84625","0.10054000124999998","6.993430111687481E7","909.1459145193774"
"12486","35254","35247","7","35254","189285","7733.84625","0.10054000124999998","6.994203496312481E7","909.2464545206274"
"12487","35254","35252","5","35257","189290","7734.504375","0.100548556875","6.994976946749981E7","909.3470030775023"
"12488","35257","35256","8","35264","189298","7736.04","0.10056852","6.995750550749981E7","909.4475715975024"
"12489","35264","35256","5","35261","189303","7735.381875","0.10055996437499999","6.996524088937481E7","909.5481315618773"
"12490","35261","35252","6","35258","189309","7734.723750000001","0.10055140875","6.99729756131248E7","909.6486829706273"
"12491","35258","35251","6","35257","189315","7734.504375","0.100548556875","6.99807101174998E7","909.7492315275023"
"12492","35257","35250","5","35255","189320","7734.065625","0.100542853125","6.99884441831248E7","909.8497743806273"
"12493","35255","35247","9","35256","189329","7734.285","0.10054570499999999","6.999617846812479E7","909.9503200856273"
"12494","35256","35247","3","35250","189332","7732.96875","0.10052859374999999","7.000391143687479E7","910.0508486793773"
"12495","35250","35247","7","35254","189339","7733.84625","0.10054000124999998","7.001164528312479E7","910.1513886806273"
"12496","35254","35250","7","35257","189346","7734.504375","0.100548556875","7.001937978749979E7","910.2519372375023"
"12497","35257","35255","8","35263","189354","7735.820625","0.100565668125","7.00271156081248E7","910.3525029056273"
"12498","35263","35260","4","35264","189358","7736.04","0.10056852","7.00348516481248E7","910.4530714256273"
"12499","35264","35258","6","35264","189364","7736.04","0.10056852","7.00425876881248E7","910.5536399456273"
"12500","35264","35260","8","35268","189372","7736.9175","0.10057992749999999","7.005032460562481E7","910.6542198731273"
"12501","35268","35267","4","35271","189376","7737.5756249999995","0.10058848312499999","7.005806218124981E7","910.7548083562523"
"12502","35271","35269","3","35272","189379","7737.795","0.10059133499999999","7.006579997624981E7","910.8553996912523"
"12503","35272","35269","5","35274","189384","7738.233749999999","0.10059703874999999","7.007353820999981E7","910.9559967300023"
"12504","35274","35272","7","35279","189391","7739.330625","0.10061129812499998","7.008127754062481E7","911.0566080281274"
"12505","35279","35276","2","35278","189393","7739.11125","0.10060844625","7.008901665187481E7","911.1572164743774"
"12506","35278","35276","1","35277","189394","7738.891875","0.100605594375","7.009675554374981E7","911.2578220687524"
"12507","35277","35272","3","35275","189397","7738.453125","0.100599890625","7.010449399687481E7","911.3584219593773"
"12508","35275","35270","5","35275","189402","7738.453125","0.100599890625","7.011223244999981E7","911.4590218500023"
"12509","35275","35272","1","35273","189403","7738.014375000001","0.100594186875","7.011997046437481E7","911.5596160368773"
"12510","35273","35268","4","35272","189407","7737.795","0.10059133499999999","7.012770825937481E7","911.6602073718773"
"12511","35272","35267","6","35273","189413","7738.014375000001","0.100594186875","7.013544627374981E7","911.7608015587523"
"12512","35273","35268","4","35272","189417","7737.795","0.10059133499999999","7.014318406874982E7","911.8613928937523"
"12513","35272","35270","5","35275","189422","7738.453125","0.100599890625","7.015092252187482E7","911.9619927843772"
"12514","35275","35272","7","35279","189429","7739.330625","0.10061129812499998","7.015866185249981E7","912.0626040825023"
"12515","35279","35276","7","35283","189436","7740.208125000001","0.100622705625","7.016640206062481E7","912.1632267881273"
"12516","35283","35274","2","35276","189438","7738.6725","0.1006027425","7.017414073312481E7","912.2638295306273"
"12517","35276","35269","4","35273","189442","7738.014375000001","0.100594186875","7.018187874749981E7","912.3644237175023"
"12518","35273","35265","4","35269","189446","7737.136874999999","0.10058277937499999","7.018961588437481E7","912.4650064968773"
"12519","35269","35266","5","35271","189451","7737.5756249999995","0.10058848312499999","7.019735345999981E7","912.5655949800023"
"12520","35271","35270","2","35272","189453","7737.795","0.10059133499999999","7.020509125499982E7","912.6661863150023"
"12521","35272","35263","4","35267","189457","7736.698125","0.100577075625","7.021282795312482E7","912.7667633906273"
"12522","35267","35265","9","35274","189466","7738.233749999999","0.10059703874999999","7.022056618687482E7","912.8673604293773"
"12523","35274","35272","1","35273","189467","7738.014375000001","0.100594186875","7.022830420124982E7","912.9679546162523"
"12524","35273","35268","5","35273","189472","7738.014375000001","0.100594186875","7.023604221562482E7","913.0685488031273"
"12525","35273","35271","7","35278","189479","7739.11125","0.10060844625","7.024378132687482E7","913.1691572493773"
"12526","35278","35274","3","35277","189482","7738.891875","0.100605594375","7.025152021874982E7","913.2697628437523"
"12527","35277","35268","4","35272","189486","7737.795","0.10059133499999999","7.025925801374982E7","913.3703541787523"
"12528","35272","35267","2","35269","189488","7737.136874999999","0.10058277937499999","7.026699515062483E7","913.4709369581274"
"12529","35269","35263","8","35271","189496","7737.5756249999995","0.10058848312499999","7.027473272624983E7","913.5715254412523"
"12530","35271","35266","9","35275","189505","7738.453125","0.100599890625","7.028247117937483E7","913.6721253318773"
"12531","35275","35271","3","35274","189508","7738.233749999999","0.10059703874999999","7.029020941312483E7","913.7727223706273"
"12532","35274","35267","2","35269","189510","7737.136874999999","0.10058277937499999","7.029794654999983E7","913.8733051500024"
"12533","35269","35260","8","35268","189518","7736.9175","0.10057992749999999","7.030568346749984E7","913.9738850775024"
"12534","35268","35265","5","35270","189523","7737.35625","0.10058563124999999","7.031342082374984E7","914.0744707087524"
"12535","35270","35261","4","35265","189527","7736.259375","0.100571371875","7.032115708312485E7","914.1750420806275"
"12536","35265","35264","5","35269","189532","7737.136874999999","0.10058277937499999","7.032889421999985E7","914.2756248600025"
"12537","35269","35263","7","35270","189539","7737.35625","0.10058563124999999","7.033663157624985E7","914.3762104912526"
"12538","35270","35265","2","35267","189541","7736.698125","0.100577075625","7.034436827437486E7","914.4767875668775"
"12539","35267","35264","6","35270","189547","7737.35625","0.10058563124999999","7.035210563062486E7","914.5773731981276"
"12540","35270","35261","3","35264","189550","7736.04","0.10056852","7.035984167062487E7","914.6779417181276"
"12541","35264","35262","9","35271","189559","7737.5756249999995","0.10058848312499999","7.036757924624987E7","914.7785302012526"
"12542","35271","35263","9","35272","189568","7737.795","0.10059133499999999","7.037531704124987E7","914.8791215362526"
"12543","35272","35264","7","35271","189575","7737.5756249999995","0.10058848312499999","7.038305461687487E7","914.9797100193775"
"12544","35271","35266","5","35271","189580","7737.5756249999995","0.10058848312499999","7.039079219249988E7","915.0802985025025"
"12545","35271","35264","6","35270","189586","7737.35625","0.10058563124999999","7.039852954874988E7","915.1808841337526"
"12546","35270","35263","8","35271","189594","7737.5756249999995","0.10058848312499999","7.040626712437488E7","915.2814726168775"
"12547","35271","35265","6","35271","189600","7737.5756249999995","0.10058848312499999","7.041400469999988E7","915.3820611000025"
"12548","35271","35266","9","35275","189609","7738.453125","0.100599890625","7.042174315312488E7","915.4826609906274"
"12549","35275","35272","1","35273","189610","7738.014375000001","0.100594186875","7.042948116749988E7","915.5832551775025"
"12550","35273","35269","3","35272","189613","7737.795","0.10059133499999999","7.043721896249989E7","915.6838465125024"
"12551","35272","35271","3","35274","189616","7738.233749999999","0.10059703874999999","7.044495719624989E7","915.7844435512525"
"12552","35274","35273","7","35280","189623","7739.55","0.10061415","7.045269674624988E7","915.8850577012524"
"12553","35280","35278","3","35281","189626","7739.769375","0.10061700187499999","7.046043651562488E7","915.9856747031274"
"12554","35281","35275","1","35276","189627","7738.6725","0.1006027425","7.046817518812488E7","916.0862774456274"
"12555","35276","35268","5","35273","189632","7738.014375000001","0.100594186875","7.047591320249988E7","916.1868716325024"
"12556","35273","35272","1","35273","189633","7738.014375000001","0.100594186875","7.048365121687488E7","916.2874658193774"
"12557","35273","35272","9","35281","189642","7739.769375","0.10061700187499999","7.049139098624988E7","916.3880828212524"
"12558","35281","35272","7","35279","189649","7739.330625","0.10061129812499998","7.049913031687488E7","916.4886941193774"
"12559","35279","35274","6","35280","189655","7739.55","0.10061415","7.050686986687487E7","916.5893082693774"
"12560","35280","35275","9","35284","189664","7740.4275","0.10062555749999999","7.051461029437487E7","916.6899338268774"
"12561","35284","35276","3","35279","189667","7739.330625","0.10061129812499998","7.052234962499987E7","916.7905451250025"
"12562","35279","35273","7","35280","189674","7739.55","0.10061415","7.053008917499986E7","916.8911592750025"
"12563","35280","35279","6","35285","189680","7740.646875","0.100628409375","7.053782982187486E7","916.9917876843774"
"12564","35285","35283","4","35287","189684","7741.085625000001","0.10063411312500001","7.054557090749985E7","917.0924217975024"
"12565","35287","35279","9","35288","189693","7741.305","0.100636965","7.055331221249986E7","917.1930587625025"
"12566","35288","35284","8","35292","189701","7742.1825","0.10064837249999999","7.056105439499986E7","917.2937071350025"
"12567","35292","35291","4","35295","189705","7742.840625","0.10065692812499999","7.056879723562486E7","917.3943640631275"
"12568","35295","35294","3","35297","189708","7743.279375","0.10066263187499999","7.057654051499987E7","917.4950266950025"
"12569","35297","35295","1","35296","189709","7743.0599999999995","0.10065977999999999","7.058428357499987E7","917.5956864750025"
"12570","35296","35294","6","35300","189715","7743.9375","0.1006711875","7.059202751249987E7","917.6963576625025"
"12571","35300","35294","3","35297","189718","7743.279375","0.10066263187499999","7.059977079187487E7","917.7970202943775"
"12572","35297","35294","3","35297","189721","7743.279375","0.10066263187499999","7.060751407124987E7","917.8976829262525"
"12573","35297","35292","2","35294","189723","7742.621249999999","0.10065407624999999","7.061525669249988E7","917.9983370025025"
"12574","35294","35293","8","35301","189731","7744.156875","0.100674039375","7.062300084937488E7","918.0990110418775"
"12575","35301","35299","9","35308","189740","7745.692500000001","0.1006940025","7.063074654187487E7","918.1997050443774"
"12576","35308","35306","8","35314","189748","7747.00875","0.10071111375","7.063849355062488E7","918.3004161581274"
"12577","35314","35308","8","35316","189756","7747.447499999999","0.10071681749999999","7.064624099812488E7","918.4011329756274"
"12578","35316","35314","9","35323","189765","7748.983125000001","0.10073678062500001","7.065398998124988E7","918.5018697562524"
"12579","35323","35318","4","35322","189769","7748.76375","0.10073392874999999","7.066173874499989E7","918.6026036850024"
"12580","35322","35318","9","35327","189778","7749.860625","0.100748188125","7.066948860562488E7","918.7033518731273"
"12581","35327","35324","8","35332","189786","7750.9575","0.1007624475","7.067723956312488E7","918.8041143206273"
"12582","35332","35324","3","35327","189789","7749.860625","0.100748188125","7.068498942374988E7","918.9048625087522"
"12583","35327","35325","9","35334","189798","7751.39625","0.10076815125","7.069274081999987E7","919.0056306600022"
"12584","35334","35328","7","35335","189805","7751.615625","0.100771003125","7.070049243562487E7","919.1064016631273"
"12585","35335","35329","2","35331","189807","7750.738125","0.10075959562499999","7.070824317374986E7","919.2071612587523"
"12586","35331","35324","5","35329","189812","7750.299375","0.10075389187499999","7.071599347312486E7","919.3079151506273"
"12587","35329","35323","2","35325","189814","7749.421875","0.100742484375","7.072374289499986E7","919.4086576350023"
"12588","35325","35318","9","35327","189823","7749.860625","0.100748188125","7.073149275562486E7","919.5094058231273"
"12589","35327","35320","6","35326","189829","7749.64125","0.10074533624999998","7.073924239687486E7","919.6101511593773"
"12590","35326","35321","7","35328","189836","7750.08","0.10075103999999999","7.074699247687486E7","919.7109021993773"
"12591","35328","35323","1","35324","189837","7749.202499999999","0.10073963249999998","7.075474167937486E7","919.8116418318773"
"12592","35324","35316","7","35323","189844","7748.983125000001","0.10073678062500001","7.076249066249986E7","919.9123786125023"
"12593","35323","35322","7","35329","189851","7750.299375","0.10075389187499999","7.077024096187486E7","920.0131325043773"
"12594","35329","35327","8","35335","189859","7751.615625","0.100771003125","7.077799257749985E7","920.1139035075023"
"12595","35335","35326","4","35330","189863","7750.51875","0.10075674375","7.078574309624985E7","920.2146602512523"
"12596","35330","35324","4","35328","189867","7750.08","0.10075103999999999","7.079349317624985E7","920.3154112912523"
"12597","35328","35324","5","35329","189872","7750.299375","0.10075389187499999","7.080124347562484E7","920.4161651831273"
"12598","35329","35323","3","35326","189875","7749.64125","0.10074533624999998","7.080899311687484E7","920.5169105193773"
"12599","35326","35321","6","35327","189881","7749.860625","0.100748188125","7.081674297749984E7","920.6176587075023"
"12600","35327","35324","3","35327","189884","7749.860625","0.100748188125","7.082449283812484E7","920.7184068956273"
"12601","35327","35291","825","36116","190709","7922.947499999999","0.10299831749999998","7.083241578562485E7","920.8214052131273"
"12602","36116","36113","5","36118","190714","7923.38625","0.10300402125","7.084033917187485E7","920.9244092343772"
"12603","36118","36111","7","36118","190721","7923.38625","0.10300402125","7.084826255812486E7","921.0274132556272"
"12604","36118","36115","7","36122","190728","7924.26375","0.10301542875","7.085618682187486E7","921.1304286843772"
"12605","36122","36116","2","36118","190730","7923.38625","0.10300402125","7.086411020812486E7","921.2334327056271"
"12606","36118","36114","3","36117","190733","7923.166875","0.10300116937499999","7.087203337499987E7","921.3364338750022"
"12607","36117","36108","8","36116","190741","7922.947499999999","0.10299831749999998","7.087995632249987E7","921.4394321925022"
"12608","36116","36114","5","36119","190746","7923.605624999999","0.10300687312499998","7.088787992812487E7","921.5424390656271"
"12609","36119","36116","7","36123","190753","7924.483125000001","0.103018280625","7.089580441124988E7","921.6454573462521"
"12610","36123","36116","7","36123","190760","7924.483125000001","0.103018280625","7.090372889437488E7","921.748475626877"
"12611","36123","36117","5","36122","190765","7924.26375","0.10301542875","7.091165315812488E7","921.8514910556271"
"12612","36122","36121","4","36125","190769","7924.921875","0.10302398437499999","7.091957807999988E7","921.9545150400021"
"12613","36125","36117","5","36122","190774","7924.26375","0.10301542875","7.092750234374988E7","922.0575304687521"
"12614","36122","36114","2","36116","190776","7922.947499999999","0.10299831749999998","7.093542529124989E7","922.1605287862521"
"12615","36116","36109","9","36118","190785","7923.38625","0.10300402125","7.094334867749989E7","922.2635328075021"
"12616","36118","36114","8","36122","190793","7924.26375","0.10301542875","7.095127294124989E7","922.3665482362521"
"12617","36122","36115","3","36118","190796","7923.38625","0.10300402125","7.09591963274999E7","922.4695522575021"
"12618","36118","36116","8","36124","190804","7924.702499999999","0.10302113249999999","7.09671210299999E7","922.572573390002"
"12619","36124","36115","8","36123","190812","7924.483125000001","0.103018280625","7.09750455131249E7","922.675591670627"
"12620","36123","36115","1","36116","190813","7922.947499999999","0.10299831749999998","7.09829684606249E7","922.778589988127"
"12621","36116","36113","5","36118","190818","7923.38625","0.10300402125","7.099089184687491E7","922.881594009377"
"12622","36118","36116","1","36117","190819","7923.166875","0.10300116937499999","7.099881501374991E7","922.984595178752"
"12623","36117","36113","2","36115","190821","7922.728125","0.10299546562499999","7.100673774187492E7","923.087590644377"
"12624","36115","36107","2","36109","190823","7921.411875","0.102978354375","7.101465915374991E7","923.1905689987519"
"12625","36109","36104","5","36109","190828","7921.411875","0.102978354375","7.102258056562491E7","923.2935473531269"
"12626","36109","36101","4","36105","190832","7920.534375","0.10296694687499999","7.10305010999999E7","923.3965143000019"
"12627","36105","36101","5","36106","190837","7920.75375","0.10296979875","7.10384218537499E7","923.4994840987519"
"12628","36106","36103","4","36107","190841","7920.973125","0.102972650625","7.10463428268749E7","923.6024567493769"
"12629","36107","36099","9","36108","190850","7921.192500000001","0.10297550250000001","7.105426401937489E7","923.7054322518769"
"12630","36108","36101","6","36107","190856","7920.973125","0.102972650625","7.106218499249989E7","923.8084049025019"
"12631","36107","36098","4","36102","190860","7919.87625","0.10295839125","7.107010486874989E7","923.911363293752"
"12632","36102","36093","6","36099","190866","7919.218124999999","0.10294983562499999","7.107802408687489E7","924.014313129377"
"12633","36099","36090","4","36094","190870","7918.121249999999","0.10293557624999998","7.108594220812489E7","924.117248705627"
"12634","36094","36088","4","36092","190874","7917.6825","0.10292987249999999","7.10938598906249E7","924.220178578127"
"12635","36092","36087","4","36091","190878","7917.463124999999","0.10292702062499999","7.11017773537499E7","924.323105598752"
"12636","36091","36083","2","36085","190880","7916.146875","0.102909909375","7.11096935006249E7","924.426015508127"
"12637","36085","36084","4","36088","190884","7916.805","0.102918465","7.11176103056249E7","924.528933973127"
"12638","36088","36079","2","36081","190886","7915.269375","0.10289850187499999","7.11255255749999E7","924.6318324750019"
"12639","36081","36076","7","36083","190893","7915.708125000001","0.10290420562500001","7.11334412831249E7","924.734736680627"
"12640","36083","36080","9","36089","190902","7917.024375","0.10292131687499999","7.11413583074999E7","924.837657997502"
"12641","36089","36088","7","36095","190909","7918.340625","0.102938428125","7.11492766481249E7","924.940596425627"
"12642","36095","36088","8","36096","190917","7918.5599999999995","0.10294127999999998","7.11571952081249E7","925.0435377056269"
"12643","36096","36087","1","36088","190918","7916.805","0.102918465","7.116511201312491E7","925.146456170627"
"12644","36088","36086","9","36095","190927","7918.340625","0.102938428125","7.117303035374992E7","925.2493945987519"
"12645","36095","36092","5","36097","190932","7918.779375","0.102944131875","7.118094913312492E7","925.3523387306269"
"12646","36097","36095","6","36101","190938","7919.656875","0.10295553937499999","7.118886878999992E7","925.4552942700019"
"12647","36101","36094","4","36098","190942","7918.998750000001","0.10294698375","7.119678778874992E7","925.5582412537519"
"12648","36098","36091","5","36096","190947","7918.5599999999995","0.10294127999999998","7.120470634874992E7","925.6611825337519"
"12649","36096","36088","3","36091","190950","7917.463124999999","0.10292702062499999","7.121262381187493E7","925.7641095543769"
"12650","36091","36085","5","36090","190955","7917.24375","0.10292416874999999","7.122054105562493E7","925.8670337231268"
"12651","36090","36089","4","36093","190959","7917.901875","0.10293272437499999","7.122845895749994E7","925.9699664475019"
"12652","36093","36084","2","36086","190961","7916.36625","0.10291276125","7.123637532374993E7","926.0728792087518"
"12653","36086","36078","1","36079","190962","7914.830625","0.10289279812499999","7.124429015437493E7","926.1757720068769"
"12654","36079","36073","7","36080","190969","7915.05","0.10289564999999999","7.125220520437492E7","926.2786676568769"
"12655","36080","36075","8","36083","190977","7915.708125000001","0.10290420562500001","7.126012091249992E7","926.3815718625019"
"12656","36083","36078","9","36087","190986","7916.585625000001","0.102915613125","7.126803749812491E7","926.4844874756269"
"12657","36087","36082","3","36085","190989","7916.146875","0.102909909375","7.12759536449999E7","926.5873973850019"
"12658","36085","36079","9","36088","190998","7916.805","0.102918465","7.128387044999991E7","926.6903158500019"
"12659","36088","36086","8","36094","191006","7918.121249999999","0.10293557624999998","7.129178857124992E7","926.7932514262519"
"12660","36094","36089","6","36095","191012","7918.340625","0.102938428125","7.129970691187492E7","926.8961898543769"
"12661","36095","36068","898","36966","191910","8109.416249999999","0.10542241124999999","7.130781632812493E7","927.0016122656268"
"12662","36966","36958","1","36959","191911","8107.880625","0.10540244812499999","7.131592420874992E7","927.1070147137518"
"12663","36959","36954","6","36960","191917","8108.1","0.1054053","7.132403230874991E7","927.2124200137519"
"12664","36960","36953","2","36955","191919","8107.003125","0.105391040625","7.133213931187491E7","927.3178110543769"
"12665","36955","36947","9","36956","191928","8107.2225","0.10539389249999999","7.134024653437491E7","927.4232049468769"
"12666","36956","36951","5","36956","191933","8107.2225","0.10539389249999999","7.13483537568749E7","927.528598839377"
"12667","36956","36953","6","36959","191939","8107.880625","0.10540244812499999","7.13564616374999E7","927.634001287502"
"12668","36959","36952","6","36958","191945","8107.661250000001","0.10539959625","7.13645692987499E7","927.739400883752"
"12669","36958","36955","5","36960","191950","8108.1","0.1054053","7.137267739874989E7","927.844806183752"
"12670","36960","36954","9","36963","191959","8108.758125","0.105413855625","7.13807861568749E7","927.950220039377"
"12671","36963","36955","5","36960","191964","8108.1","0.1054053","7.138889425687489E7","928.055625339377"
"12672","36960","36954","7","36961","191971","8108.319375","0.105408151875","7.139700257624988E7","928.161033491252"
"12673","36961","36959","6","36965","191977","8109.196875","0.10541955937499999","7.140511177312489E7","928.2664530506271"
"12674","36965","36957","7","36964","191984","8108.977499999998","0.10541670749999997","7.14132207506249E7","928.3718697581271"
"12675","36964","36962","9","36971","191993","8110.5131249999995","0.10543667062499999","7.14213312637499E7","928.4773064287521"
"12676","36971","36964","5","36969","191998","8110.074374999999","0.10543096687499999","7.14294413381249E7","928.5827373956271"
"12677","36969","36965","8","36973","192006","8110.951875000001","0.10544237437500001","7.14375522899999E7","928.6881797700021"
"12678","36973","36967","4","36971","192010","8110.5131249999995","0.10543667062499999","7.14456628031249E7","928.793616440627"
"12679","36971","36963","1","36964","192011","8108.977499999998","0.10541670749999997","7.145377178062491E7","928.899033148127"
"12680","36964","36957","3","36960","192014","8108.1","0.1054053","7.14618798806249E7","929.0044384481271"
"12681","36960","36958","5","36963","192019","8108.758125","0.105413855625","7.146998863874991E7","929.1098523037521"
"12682","36963","36958","7","36965","192026","8109.196875","0.10541955937499999","7.147809783562492E7","929.2152718631271"
"12683","36965","36963","2","36965","192028","8109.196875","0.10541955937499999","7.148620703249992E7","929.3206914225021"
"12684","36965","36956","4","36960","192032","8108.1","0.1054053","7.149431513249992E7","929.4260967225022"
"12685","36960","36958","6","36964","192038","8108.977499999998","0.10541670749999997","7.150242410999992E7","929.5315134300022"
"12686","36964","36963","4","36967","192042","8109.635625","0.10542526312499999","7.151053374562493E7","929.6369386931271"
"12687","36967","36958","1","36959","192043","8107.880625","0.10540244812499999","7.151864162624992E7","929.7423411412522"
"12688","36959","36955","5","36960","192048","8108.1","0.1054053","7.152674972624992E7","929.8477464412522"
"12689","36960","36958","8","36966","192056","8109.416249999999","0.10542241124999999","7.153485914249992E7","929.9531688525021"
"12690","36966","36960","1","36961","192057","8108.319375","0.105408151875","7.154296746187492E7","930.0585770043772"
"12691","36961","36958","8","36966","192065","8109.416249999999","0.10542241124999999","7.155107687812492E7","930.1639994156271"
"12692","36966","36965","1","36966","192066","8109.416249999999","0.10542241124999999","7.155918629437493E7","930.2694218268771"
"12693","36966","36959","8","36967","192074","8109.635625","0.10542526312499999","7.156729592999993E7","930.374847090002"
"12694","36967","36961","8","36969","192082","8110.074374999999","0.10543096687499999","7.157540600437494E7","930.4802780568771"
"12695","36969","36962","1","36963","192083","8108.758125","0.105413855625","7.158351476249994E7","930.585691912502"
"12696","36963","36962","4","36966","192087","8109.416249999999","0.10542241124999999","7.159162417874995E7","930.691114323752"
"12697","36966","36957","8","36965","192095","8109.196875","0.10541955937499999","7.159973337562495E7","930.796533883127"
"12698","36965","36963","8","36971","192103","8110.5131249999995","0.10543667062499999","7.160784388874996E7","930.901970553752"
"12699","36971","36963","9","36972","192112","8110.7325","0.1054395225","7.161595462124996E7","931.007410076252"
"12700","36972","36971","5","36976","192117","8111.61","0.10545092999999998","7.162406623124996E7","931.1128610062519"
"12701","36976","36972","7","36979","192124","8112.268125","0.10545948562499999","7.163217849937496E7","931.218320491877"
"12702","36979","36970","9","36979","192133","8112.268125","0.10545948562499999","7.164029076749995E7","931.323779977502"
"12703","36979","36972","1","36973","192134","8110.951875000001","0.10544237437500001","7.164840171937495E7","931.429222351877"
"12704","36973","36969","3","36972","192137","8110.7325","0.1054395225","7.165651245187496E7","931.534661874377"
"12705","36972","36969","1","36970","192138","8110.29375","0.10543381874999999","7.166462274562496E7","931.640095693127"
"12706","36970","36962","7","36969","192145","8110.074374999999","0.10543096687499999","7.167273281999996E7","931.745526660002"
"12707","36969","36963","3","36966","192148","8109.416249999999","0.10542241124999999","7.168084223624997E7","931.850949071252"
"12708","36966","36963","4","36967","192152","8109.635625","0.10542526312499999","7.168895187187497E7","931.956374334377"
"12709","36967","36966","9","36975","192161","8111.390625","0.105448078125","7.169706326249997E7","932.061822412502"
"12710","36975","36970","7","36977","192168","8111.829375","0.105453781875","7.170517509187497E7","932.167276194377"
"12711","36977","36972","3","36975","192171","8111.390625","0.105448078125","7.171328648249997E7","932.272724272502"
"12712","36975","36971","4","36975","192175","8111.390625","0.105448078125","7.172139787312497E7","932.3781723506271"
"12713","36975","36973","7","36980","192182","8112.4875","0.10546233749999999","7.172951036062497E7","932.483634688127"
"12714","36980","36974","8","36982","192190","8112.92625","0.10546804125","7.173762328687496E7","932.589102729377"
"12715","36982","36973","3","36976","192193","8111.61","0.10545092999999998","7.174573489687496E7","932.694553659377"
"12716","36976","36969","1","36970","192194","8110.29375","0.10543381874999999","7.175384519062497E7","932.799987478127"
"12717","36970","36964","9","36973","192203","8110.951875000001","0.10544237437500001","7.176195614249997E7","932.905429852502"
"12718","36973","36966","8","36974","192211","8111.171249999999","0.10544522624999998","7.177006731374997E7","933.0108750787521"
"12719","36974","36967","9","36976","192220","8111.61","0.10545092999999998","7.177817892374997E7","933.116326008752"
"12720","36976","36973","3","36976","192223","8111.61","0.10545092999999998","7.178629053374997E7","933.221776938752"
"12721","36976","36948","746","37694","192969","8269.12125","0.10749857624999999","7.179455965499997E7","933.329275515002"
"12722","37694","37691","2","37693","192971","8268.901875","0.10749572437499999","7.180282855687498E7","933.436771239377"
"12723","37693","37686","7","37693","192978","8268.901875","0.10749572437499999","7.181109745874998E7","933.544266963752"
"12724","37693","37688","9","37697","192987","8269.779375","0.107507131875","7.181936723812498E7","933.6517740956269"
"12725","37697","37690","4","37694","192991","8269.12125","0.10749857624999999","7.182763635937499E7","933.7592726718769"
"12726","37694","37690","9","37699","193000","8270.218125","0.10751283562499998","7.183590657749999E7","933.866785507502"
"12727","37699","37694","3","37697","193003","8269.779375","0.107507131875","7.184417635687499E7","933.9742926393769"
"12728","37697","37688","3","37691","193006","8268.463124999998","0.10749002062499997","7.185244482E7","934.081782660002"
"12729","37691","37684","8","37692","193014","8268.682499999999","0.10749287249999998","7.18607135025E7","934.1892755325019"
"12730","37692","37688","1","37689","193015","8268.024374999999","0.10748431687499999","7.1868981526875E7","934.2967598493769"
"12731","37689","37680","8","37688","193023","8267.805","0.107481465","7.187724933187501E7","934.4042413143769"
"12732","37688","37680","2","37682","193025","8266.48875","0.10746435375","7.1885515820625E7","934.5117056681269"
"12733","37682","37681","2","37683","193027","8266.708125000001","0.107467205625","7.189378252875E7","934.6191728737518"
"12734","37683","37677","4","37681","193031","8266.269375","0.10746150187499999","7.1902048798125E7","934.7266343756269"
"12735","37681","37679","2","37681","193033","8266.269375","0.10746150187499999","7.19103150675E7","934.8340958775019"
"12736","37681","37679","7","37686","193040","8267.36625","0.10747576124999998","7.191858243374999E7","934.941571638752"
"12737","37686","37685","3","37688","193043","8267.805","0.107481465","7.192685023875E7","935.0490531037519"
"12738","37688","37683","5","37688","193048","8267.805","0.107481465","7.193511804375E7","935.1565345687519"
"12739","37688","37686","6","37692","193054","8268.682499999999","0.10749287249999998","7.194338672625001E7","935.2640274412519"
"12740","37692","37688","8","37696","193062","8269.56","0.10750427999999998","7.195165628625001E7","935.3715317212518"
"12741","37696","37690","3","37693","193065","8268.901875","0.10749572437499999","7.195992518812501E7","935.4790274456268"
"12742","37693","37690","4","37694","193069","8269.12125","0.10749857624999999","7.196819430937502E7","935.5865260218768"
"12743","37694","37686","3","37689","193072","8268.024374999999","0.10748431687499999","7.197646233375002E7","935.6940103387518"
"12744","37689","37688","8","37696","193080","8269.56","0.10750427999999998","7.198473189375003E7","935.8015146187518"
"12745","37696","37695","4","37699","193084","8270.218125","0.10751283562499998","7.199300211187503E7","935.9090274543768"
"12746","37699","37697","7","37704","193091","8271.315","0.107527095","7.200127342687503E7","936.0165545493768"
"12747","37704","37697","8","37705","193099","8271.534375","0.10752994687499999","7.200954496125002E7","936.1240844962518"
"12748","37705","37698","4","37702","193103","8270.87625","0.10752139124999999","7.201781583750002E7","936.2316058875018"
"12749","37702","37693","8","37701","193111","8270.656874999999","0.10751853937499997","7.202608649437502E7","936.3391244268768"
"12750","37701","37698","7","37705","193118","8271.534375","0.10752994687499999","7.203435802875002E7","936.4466543737518"
"12751","37705","37702","3","37705","193121","8271.534375","0.10752994687499999","7.204262956312501E7","936.5541843206269"
"12752","37705","37704","7","37711","193128","8272.850625","0.10754705812499998","7.205090241375001E7","936.6617313787518"
"12753","37711","37702","5","37707","193133","8271.973125","0.10753565062499999","7.2059174386875E7","936.7692670293768"
"12754","37707","37705","4","37709","193137","8272.411875","0.107541354375","7.206744679875E7","936.8768083837518"
"12755","37709","37704","5","37709","193142","8272.411875","0.107541354375","7.2075719210625E7","936.9843497381269"
"12756","37709","37705","7","37712","193149","8273.07","0.10754990999999998","7.208399228062499E7","937.0918996481269"
"12757","37712","37708","8","37716","193157","8273.947499999998","0.10756131749999998","7.209226622812499E7","937.1994609656268"
"12758","37716","37709","8","37717","193165","8274.166874999999","0.10756416937499998","7.2100540395E7","937.3070251350018"
"12759","37717","37709","1","37710","193166","8272.63125","0.10754420625","7.210881302624999E7","937.4145693412519"
"12760","37710","37709","2","37711","193168","8272.850625","0.10754705812499998","7.211708587687498E7","937.5221163993768"
"12761","37711","37709","6","37715","193174","8273.728125","0.10755846562499999","7.212535960499999E7","937.6296748650018"
"12762","37715","37706","8","37714","193182","8273.508749999999","0.10755561374999999","7.213363311375E7","937.7372304787518"
"12763","37714","37709","3","37712","193185","8273.07","0.10754990999999998","7.214190618374999E7","937.8447803887518"
"12764","37712","37706","5","37711","193190","8272.850625","0.10754705812499998","7.215017903437498E7","937.9523274468768"
"12765","37711","37709","3","37712","193193","8273.07","0.10754990999999998","7.215845210437497E7","938.0598773568768"
"12766","37712","37703","5","37708","193198","8272.192500000001","0.10753850250000001","7.216672429687497E7","938.1674158593768"
"12767","37708","37701","6","37707","193204","8271.973125","0.10753565062499999","7.217499626999997E7","938.2749515100018"
"12768","37707","37702","9","37711","193213","8272.850625","0.10754705812499998","7.218326912062496E7","938.3824985681267"
"12769","37711","37708","3","37711","193216","8272.850625","0.10754705812499998","7.219154197124995E7","938.4900456262517"
"12770","37711","37703","2","37705","193218","8271.534375","0.10752994687499999","7.219981350562495E7","938.5975755731267"
"12771","37705","37704","9","37713","193227","8273.289375","0.107552761875","7.220808679499996E7","938.7051283350017"
"12772","37713","37705","5","37710","193232","8272.63125","0.10754420625","7.221635942624995E7","938.8126725412518"
"12773","37710","37703","8","37711","193240","8272.850625","0.10754705812499998","7.222463227687494E7","938.9202195993768"
"12774","37711","37709","4","37713","193244","8273.289375","0.107552761875","7.223290556624995E7","939.0277723612518"
"12775","37713","37712","5","37717","193249","8274.166874999999","0.10756416937499998","7.224117973312496E7","939.1353365306268"
"12776","37717","37709","7","37716","193256","8273.947499999998","0.10756131749999998","7.224945368062496E7","939.2428978481267"
"12777","37716","37708","6","37714","193262","8273.508749999999","0.10755561374999999","7.225772718937497E7","939.3504534618768"
"12778","37714","37713","3","37716","193265","8273.947499999998","0.10756131749999998","7.226600113687497E7","939.4580147793768"
"12779","37716","37712","7","37719","193272","8274.605625","0.10756987312499999","7.227427574249998E7","939.5655846525018"
"12780","37719","37713","2","37715","193274","8273.728125","0.10755846562499999","7.228254947062498E7","939.6731431181267"
"12781","37715","37698","741","38439","194015","8432.555624999999","0.10962322312499997","7.229098202624999E7","939.7827663412518"
"12782","38439","38435","5","38440","194020","8432.775","0.10962607499999999","7.229941480125E7","939.8923924162518"
"12783","38440","38437","4","38441","194024","8432.994374999998","0.10962892687499998","7.2307847795625E7","940.0020213431268"
"12784","38441","38435","1","38436","194025","8431.8975","0.10961466749999998","7.2316279693125E7","940.1116360106267"
"12785","38436","38430","2","38432","194027","8431.02","0.10960326","7.232471071312499E7","940.2212392706267"
"12786","38432","38430","7","38437","194034","8432.116875","0.10961751937499999","7.233314282999998E7","940.3308567900017"
"12787","38437","38434","4","38438","194038","8432.33625","0.10962037125","7.234157516624999E7","940.4404771612517"
"12788","38438","38430","2","38432","194040","8431.02","0.10960326","7.235000618624999E7","940.5500804212517"
"12789","38432","38429","8","38437","194048","8432.116875","0.10961751937499999","7.235843830312498E7","940.6596979406266"
"12790","38437","38428","1","38429","194049","8430.361875","0.109594704375","7.236686866499998E7","940.7692926450017"
"12791","38429","38426","9","38435","194058","8431.678125","0.109611815625","7.237530034312497E7","940.8789044606267"
"12792","38435","38428","3","38431","194061","8430.800625","0.10960040812499999","7.238373114374997E7","940.9885048687516"
"12793","38431","38425","1","38426","194062","8429.703749999999","0.10958614874999997","7.239216084749997E7","941.0980910175017"
"12794","38426","38422","6","38428","194068","8430.1425","0.10959185249999999","7.240059098999996E7","941.2076828700017"
"12795","38428","38427","4","38431","194072","8430.800625","0.10960040812499999","7.240902179062496E7","941.3172832781266"
"12796","38431","38430","7","38437","194079","8432.116875","0.10961751937499999","7.241745390749995E7","941.4269007975016"
"12797","38437","38429","6","38435","194085","8431.678125","0.109611815625","7.242588558562495E7","941.5365126131267"
"12798","38435","38429","7","38436","194092","8431.8975","0.10961466749999998","7.243431748312494E7","941.6461272806266"
"12799","38436","38434","2","38436","194094","8431.8975","0.10961466749999998","7.244274938062494E7","941.7557419481266"
"12800","38436","38430","4","38434","194098","8431.45875","0.10960896375","7.245118083937493E7","941.8653509118766"
"12801","38434","38425","2","38427","194100","8429.923125","0.10958900062499999","7.245961076249993E7","941.9749399125016"
"12802","38427","38422","6","38428","194106","8430.1425","0.10959185249999999","7.246804090499993E7","942.0845317650015"
"12803","38428","38426","9","38435","194115","8431.678125","0.109611815625","7.247647258312492E7","942.1941435806266"
"12804","38435","38431","6","38437","194121","8432.116875","0.10961751937499999","7.248490469999991E7","942.3037611000016"
"12805","38437","38434","9","38443","194130","8433.433125","0.10963463062499999","7.249333813312492E7","942.4133957306266"
"12806","38443","38440","2","38442","194132","8433.213749999999","0.10963177874999998","7.250177134687492E7","942.5230275093766"
"12807","38442","38438","5","38443","194137","8433.433125","0.10963463062499999","7.251020477999993E7","942.6326621400016"
"12808","38443","38438","5","38443","194142","8433.433125","0.10963463062499999","7.251863821312493E7","942.7422967706266"
"12809","38443","38441","5","38446","194147","8434.09125","0.10964318624999998","7.252707230437493E7","942.8519399568765"
"12810","38446","38444","2","38446","194149","8434.09125","0.10964318624999998","7.253550639562494E7","942.9615831431265"
"12811","38446","38438","1","38439","194150","8432.555624999999","0.10962322312499997","7.254393895124994E7","943.0712063662515"
"12812","38439","38433","8","38441","194158","8432.994374999998","0.10962892687499998","7.255237194562495E7","943.1808352931265"
"12813","38441","38433","1","38434","194159","8431.45875","0.10960896375","7.256080340437494E7","943.2904442568765"
"12814","38434","38431","1","38432","194160","8431.02","0.10960326","7.256923442437494E7","943.4000475168765"
"12815","38432","38428","8","38436","194168","8431.8975","0.10961466749999998","7.257766632187493E7","943.5096621843765"
"12816","38436","38434","8","38442","194176","8433.213749999999","0.10963177874999998","7.258609953562494E7","943.6192939631264"
"12817","38442","38433","8","38441","194184","8432.994374999998","0.10962892687499998","7.259453252999994E7","943.7289228900014"
"12818","38441","38440","9","38449","194193","8434.749375","0.10965174187499999","7.260296727937494E7","943.8385746318764"
"12819","38449","38442","7","38449","194200","8434.749375","0.10965174187499999","7.261140202874994E7","943.9482263737515"
"12820","38449","38446","1","38447","194201","8434.310625","0.109646038125","7.261983633937494E7","944.0578724118765"
"12821","38447","38440","8","38448","194209","8434.53","0.10964889","7.262827086937495E7","944.1675213018765"
"12822","38448","38442","1","38443","194210","8433.433125","0.10963463062499999","7.263670430249995E7","944.2771559325015"
"12823","38443","38438","5","38443","194215","8433.433125","0.10963463062499999","7.264513773562495E7","944.3867905631265"
"12824","38443","38436","3","38439","194218","8432.555624999999","0.10962322312499997","7.265357029124996E7","944.4964137862515"
"12825","38439","38430","4","38434","194222","8431.45875","0.10960896375","7.266200174999996E7","944.6060227500016"
"12826","38434","38429","5","38434","194227","8431.45875","0.10960896375","7.267043320874995E7","944.7156317137516"
"12827","38434","38429","8","38437","194235","8432.116875","0.10961751937499999","7.267886532562494E7","944.8252492331266"
"12828","38437","38435","1","38436","194236","8431.8975","0.10961466749999998","7.268729722312494E7","944.9348639006265"
"12829","38436","38433","2","38435","194238","8431.678125","0.109611815625","7.269572890124993E7","945.0444757162516"
"12830","38435","38430","9","38439","194247","8432.555624999999","0.10962322312499997","7.270416145687494E7","945.1540989393766"
"12831","38439","38430","8","38438","194255","8432.33625","0.10962037125","7.271259379312494E7","945.2637193106266"
"12832","38438","38433","3","38436","194258","8431.8975","0.10961466749999998","7.272102569062494E7","945.3733339781265"
"12833","38436","38427","1","38428","194259","8430.1425","0.10959185249999999","7.272945583312494E7","945.4829258306265"
"12834","38428","38420","1","38421","194260","8428.606875","0.10957188937499998","7.273788443999994E7","945.5924977200016"
"12835","38421","38412","7","38419","194267","8428.168125","0.10956618562499999","7.274631260812494E7","945.7020639056266"
"12836","38419","38414","8","38422","194275","8428.82625","0.10957474125","7.275474143437494E7","945.8116386468765"
"12837","38422","38421","8","38429","194283","8430.361875","0.109594704375","7.276317179624994E7","945.9212333512515"
"12838","38429","38428","3","38431","194286","8430.800625","0.10960040812499999","7.277160259687494E7","946.0308337593765"
"12839","38431","38424","7","38431","194293","8430.800625","0.10960040812499999","7.278003339749993E7","946.1404341675014"
"12840","38431","38430","6","38436","194299","8431.8975","0.10961466749999998","7.278846529499993E7","946.2500488350014"
"12841","38436","38410","607","39017","194906","8559.354374999999","0.11127160687499998","7.279702464937493E7","946.3613204418764"
"12842","39017","39015","2","39017","194908","8559.354374999999","0.11127160687499998","7.280558400374994E7","946.4725920487514"
"12843","39017","39016","3","39019","194911","8559.793125","0.111277310625","7.281414379687494E7","946.5838693593764"
"12844","39019","39016","6","39022","194917","8560.45125","0.11128586624999999","7.282270424812494E7","946.6951552256264"
"12845","39022","39018","8","39026","194925","8561.328749999999","0.11129727374999998","7.283126557687494E7","946.8064524993764"
"12846","39026","39024","7","39031","194932","8562.425625","0.11131153312499999","7.283982800249994E7","946.9177640325014"
"12847","39031","39029","1","39030","194933","8562.20625","0.11130868124999999","7.284839020874994E7","947.0290727137514"
"12848","39030","39021","5","39026","194938","8561.328749999999","0.11129727374999998","7.285695153749993E7","947.1403699875013"
"12849","39026","39018","9","39027","194947","8561.548125","0.11130012562499998","7.286551308562493E7","947.2516701131264"
"12850","39027","39025","9","39034","194956","8563.08375","0.11132008874999999","7.287407616937493E7","947.3629902018763"
"12851","39034","39026","5","39031","194961","8562.425625","0.11131153312499999","7.288263859499992E7","947.4743017350013"
"12852","39031","39023","9","39032","194970","8562.645","0.111314385","7.289120123999992E7","947.5856161200013"
"12853","39032","39023","8","39031","194978","8562.425625","0.11131153312499999","7.289976366562492E7","947.6969276531263"
"12854","39031","39028","9","39037","194987","8563.741875","0.111328644375","7.290832740749991E7","947.8082562975013"
"12855","39037","39036","1","39037","194988","8563.741875","0.111328644375","7.29168911493749E7","947.9195849418763"
"12856","39037","39033","2","39035","194990","8563.303125","0.11132294062499999","7.29254544524999E7","948.0309078825013"
"12857","39035","39030","5","39035","194995","8563.303125","0.11132294062499999","7.293401775562489E7","948.1422308231263"
"12858","39035","39031","9","39040","195004","8564.4","0.11133719999999998","7.29425821556249E7","948.2535680231263"
"12859","39040","39031","1","39032","195005","8562.645","0.111314385","7.295114480062489E7","948.3648824081263"
"12860","39032","39025","1","39026","195006","8561.328749999999","0.11129727374999998","7.295970612937489E7","948.4761796818763"
"12861","39026","39022","3","39025","195009","8561.109375","0.111294421875","7.296826723874989E7","948.5874741037512"
"12862","39025","39017","2","39019","195011","8559.793125","0.111277310625","7.29768270318749E7","948.6987514143763"
"12863","39019","39010","1","39011","195012","8558.038125","0.11125449562499998","7.298538506999989E7","948.8100059100012"
"12864","39011","39005","1","39006","195013","8556.94125","0.11124023624999999","7.299394201124988E7","948.9212461462512"
"12865","39006","39003","7","39010","195020","8557.81875","0.11125164375","7.300249982999988E7","949.0324977900012"
"12866","39010","39006","3","39009","195023","8557.599375","0.11124879187499999","7.301105742937487E7","949.1437465818763"
"12867","39009","39004","8","39012","195031","8558.2575","0.11125734749999999","7.301961568687487E7","949.2550039293762"
"12868","39012","39007","8","39015","195039","8558.915625","0.11126590312499998","7.302817460249987E7","949.3662698325012"
"12869","39015","39009","7","39016","195046","8559.134999999998","0.11126875499999997","7.303673373749988E7","949.4775385875012"
"12870","39016","39011","2","39013","195048","8558.476875","0.111260199375","7.304529221437488E7","949.5887987868762"
"12871","39013","39007","1","39008","195049","8557.380000000001","0.11124594","7.305384959437488E7","949.7000447268762"
"12872","39008","39000","5","39005","195054","8556.721875","0.11123738437499998","7.306240631624988E7","949.8112821112512"
"12873","39005","38998","6","39004","195060","8556.5025","0.1112345325","7.307096281874987E7","949.9225166437512"
"12874","39004","38997","5","39002","195065","8556.06375","0.11122882874999998","7.307951888249987E7","950.0337454725012"
"12875","39002","38998","1","38999","195066","8555.405625","0.11122027312499999","7.308807428812487E7","950.1449657456262"
"12876","38999","38991","9","39000","195075","8555.625","0.11122312499999999","7.309662991312487E7","950.2561888706263"
"12877","39000","38994","6","39000","195081","8555.625","0.11122312499999999","7.310518553812487E7","950.3674119956263"
"12878","39000","38991","7","38998","195088","8555.18625","0.11121742125","7.311374072437488E7","950.4786294168763"
"12879","38998","38997","8","39005","195096","8556.721875","0.11123738437499998","7.312229744624987E7","950.5898668012513"
"12880","39005","38997","8","39005","195104","8556.721875","0.11123738437499998","7.313085416812487E7","950.7011041856264"
"12881","39005","39002","7","39009","195111","8557.599375","0.11124879187499999","7.313941176749986E7","950.8123529775014"
"12882","39009","39007","6","39013","195117","8558.476875","0.111260199375","7.314797024437487E7","950.9236131768764"
"12883","39013","39009","3","39012","195120","8558.2575","0.11125734749999999","7.315652850187486E7","951.0348705243764"
"12884","39012","39005","8","39013","195128","8558.476875","0.111260199375","7.316508697874987E7","951.1461307237514"
"12885","39013","39010","7","39017","195135","8559.354374999999","0.11127160687499998","7.317364633312488E7","951.2574023306264"
"12886","39017","39014","1","39015","195136","8558.915625","0.11126590312499998","7.318220524874988E7","951.3686682337514"
"12887","39015","39013","1","39014","195137","8558.696249999999","0.11126305124999998","7.319076394499989E7","951.4799312850014"
"12888","39014","39008","3","39011","195140","8558.038125","0.11125449562499998","7.319932198312488E7","951.5911857806263"
"12889","39011","39007","2","39009","195142","8557.599375","0.11124879187499999","7.320787958249988E7","951.7024345725014"
"12890","39009","39003","7","39010","195149","8557.81875","0.11125164375","7.321643740124987E7","951.8136862162514"
"12891","39010","39006","8","39014","195157","8558.696249999999","0.11126305124999998","7.322499609749988E7","951.9249492675015"
"12892","39014","39007","3","39010","195160","8557.81875","0.11125164375","7.323355391624987E7","952.0362009112515"
"12893","39010","39002","7","39009","195167","8557.599375","0.11124879187499999","7.324211151562487E7","952.1474497031265"
"12894","39009","39002","7","39009","195174","8557.599375","0.11124879187499999","7.325066911499986E7","952.2586984950016"
"12895","39009","39001","9","39010","195183","8557.81875","0.11125164375","7.325922693374985E7","952.3699501387516"
"12896","39010","39006","8","39014","195191","8558.696249999999","0.11126305124999998","7.326778562999986E7","952.4812131900017"
"12897","39014","39005","4","39009","195195","8557.599375","0.11124879187499999","7.327634322937486E7","952.5924619818767"
"12898","39009","39001","7","39008","195202","8557.380000000001","0.11124594","7.328490060937485E7","952.7037079218767"
"12899","39008","39007","8","39015","195210","8558.915625","0.11126590312499998","7.329345952499986E7","952.8149738250016"
"12900","39015","39008","3","39011","195213","8558.038125","0.11125449562499998","7.330201756312485E7","952.9262283206266"
"12901","39011","38970","962","39932","196175","8760.0825","0.1138810725","7.331077764562485E7","953.0401093931266"
"12902","39932","39923","3","39926","196178","8758.766249999999","0.11386396124999998","7.331953641187485E7","953.1539733543766"
"12903","39926","39924","8","39932","196186","8760.0825","0.1138810725","7.332829649437484E7","953.2678544268766"
"12904","39932","39927","9","39936","196195","8760.96","0.11389247999999998","7.333705745437483E7","953.3817469068766"
"12905","39936","39933","1","39934","196196","8760.52125","0.11388677624999999","7.334581797562483E7","953.4956336831266"
"12906","39934","39933","8","39941","196204","8762.056874999998","0.11390673937499997","7.335458003249983E7","953.6095404225016"
"12907","39941","39934","9","39943","196213","8762.495625","0.11391244312499998","7.336334252812484E7","953.7234528656265"
"12908","39943","39937","1","39938","196214","8761.39875","0.11389818374999999","7.337210392687485E7","953.8373510493766"
"12909","39938","39937","6","39943","196220","8762.495625","0.11391244312499998","7.338086642249985E7","953.9512634925015"
"12910","39943","39935","7","39942","196227","8762.276249999999","0.11390959124999998","7.338962869874986E7","954.0651730837516"
"12911","39942","39936","2","39938","196229","8761.39875","0.11389818374999999","7.339839009749986E7","954.1790712675016"
"12912","39938","39934","1","39935","196230","8760.740625","0.113889628125","7.340715083812486E7","954.2929608956266"
"12913","39935","39932","3","39935","196233","8760.740625","0.113889628125","7.341591157874985E7","954.4068505237516"
"12914","39935","39930","6","39936","196239","8760.96","0.11389247999999998","7.342467253874984E7","954.5207430037516"
"12915","39936","39930","1","39931","196240","8759.863125","0.11387822062499998","7.343343240187484E7","954.6346212243766"
"12916","39931","39928","1","39929","196241","8759.424375","0.113872516875","7.344219182624984E7","954.7484937412515"
"12917","39929","39923","7","39930","196248","8759.64375","0.11387536874999998","7.345095146999983E7","954.8623691100015"
"12918","39930","39922","2","39924","196250","8758.3275","0.11385825749999999","7.345970979749984E7","954.9762273675016"
"12919","39924","39923","4","39927","196254","8758.985625","0.11386681312499998","7.346846878312483E7","955.0900941806266"
"12920","39927","39920","9","39929","196263","8759.424375","0.113872516875","7.347722820749983E7","955.2039666975015"
"12921","39929","39924","4","39928","196267","8759.205","0.113869665","7.348598741249983E7","955.3178363625016"
"12922","39928","39920","7","39927","196274","8758.985625","0.11386681312499998","7.349474639812483E7","955.4317031756266"
"12923","39927","39923","6","39929","196280","8759.424375","0.113872516875","7.350350582249983E7","955.5455756925015"
"12924","39929","39920","7","39927","196287","8758.985625","0.11386681312499998","7.351226480812483E7","955.6594425056265"
"12925","39927","39922","1","39923","196288","8758.108125","0.113855405625","7.352102291624983E7","955.7732979112516"
"12926","39923","39921","5","39926","196293","8758.766249999999","0.11386396124999998","7.352978168249983E7","955.8871618725016"
"12927","39926","39924","2","39926","196295","8758.766249999999","0.11386396124999998","7.353854044874983E7","956.0010258337516"
"12928","39926","39924","2","39926","196297","8758.766249999999","0.11386396124999998","7.354729921499982E7","956.1148897950015"
"12929","39926","39923","6","39929","196303","8759.424375","0.113872516875","7.355605863937482E7","956.2287623118765"
"12930","39929","39923","3","39926","196306","8758.766249999999","0.11386396124999998","7.356481740562482E7","956.3426262731265"
"12931","39926","39923","7","39930","196313","8759.64375","0.11387536874999998","7.357357704937482E7","956.4565016418765"
"12932","39930","39927","2","39929","196315","8759.424375","0.113872516875","7.358233647374982E7","956.5703741587514"
"12933","39929","39922","9","39931","196324","8759.863125","0.11387822062499998","7.359109633687481E7","956.6842523793764"
"12934","39931","39929","1","39930","196325","8759.64375","0.11387536874999998","7.359985598062481E7","956.7981277481264"
"12935","39930","39925","5","39930","196330","8759.64375","0.11387536874999998","7.36086156243748E7","956.9120031168763"
"12936","39930","39929","6","39935","196336","8760.740625","0.113889628125","7.36173763649998E7","957.0258927450013"
"12937","39935","39928","5","39933","196341","8760.301875000001","0.113883924375","7.36261366668748E7","957.1397766693764"
"12938","39933","39924","7","39931","196348","8759.863125","0.11387822062499998","7.36348965299998E7","957.2536548900014"
"12939","39931","39922","3","39925","196351","8758.546875","0.11386110937499999","7.36436550768748E7","957.3675159993763"
"12940","39925","39920","8","39928","196359","8759.205","0.113869665","7.365241428187479E7","957.4813856643764"
"12941","39928","39924","9","39933","196368","8760.301875000001","0.113883924375","7.366117458374979E7","957.5952695887514"
"12942","39933","39927","3","39930","196371","8759.64375","0.11387536874999998","7.366993422749978E7","957.7091449575014"
"12943","39930","39924","5","39929","196376","8759.424375","0.113872516875","7.367869365187478E7","957.8230174743763"
"12944","39929","39928","7","39935","196383","8760.740625","0.113889628125","7.368745439249977E7","957.9369071025013"
"12945","39935","39929","1","39930","196384","8759.64375","0.11387536874999998","7.369621403624977E7","958.0507824712513"
"12946","39930","39926","8","39934","196392","8760.52125","0.11388677624999999","7.370497455749977E7","958.1646692475013"
"12947","39934","39932","6","39938","196398","8761.39875","0.11389818374999999","7.371373595624977E7","958.2785674312513"
"12948","39938","39934","1","39935","196399","8760.740625","0.113889628125","7.372249669687477E7","958.3924570593763"
"12949","39935","39929","8","39937","196407","8761.179375","0.11389533187499999","7.373125787624976E7","958.5063523912513"
"12950","39937","39934","9","39943","196416","8762.495625","0.11391244312499998","7.374002037187476E7","958.6202648343763"
"12951","39943","39937","1","39938","196417","8761.39875","0.11389818374999999","7.374878177062477E7","958.7341630181263"
"12952","39938","39934","9","39943","196426","8762.495625","0.11391244312499998","7.375754426624978E7","958.8480754612513"
"12953","39943","39940","6","39946","196432","8763.15375","0.11392099874999999","7.376630741999978E7","958.9619964600013"
"12954","39946","39938","6","39944","196438","8762.715","0.113915295","7.377507013499978E7","959.0759117550012"
"12955","39944","39939","7","39946","196445","8763.15375","0.11392099874999999","7.378383328874978E7","959.1898327537513"
"12956","39946","39937","9","39946","196454","8763.15375","0.11392099874999999","7.379259644249979E7","959.3037537525013"
"12957","39946","39944","7","39951","196461","8764.250624999999","0.11393525812499998","7.380136069312479E7","959.4176890106263"
"12958","39951","39942","9","39951","196470","8764.250624999999","0.11393525812499998","7.381012494374979E7","959.5316242687513"
"12959","39951","39943","5","39948","196475","8763.5925","0.1139267025","7.381888853624979E7","959.6455509712513"
"12960","39948","39940","6","39946","196481","8763.15375","0.11392099874999999","7.382765168999979E7","959.7594719700013"
"12961","39946","39913","534","40447","197015","8873.060625","0.11534978812499999","7.383652475062479E7","959.8748217581262"
"12962","40447","40444","6","40450","197021","8873.71875","0.11535834375","7.384539846937479E7","959.9901801018763"
"12963","40450","40445","3","40448","197024","8873.28","0.11535264","7.385427174937479E7","960.1055327418762"
"12964","40448","40444","4","40448","197028","8873.28","0.11535264","7.38631450293748E7","960.2208853818762"
"12965","40448","40441","2","40443","197030","8872.183125","0.11533838062499999","7.38720172124998E7","960.3362237625012"
"12966","40443","40436","1","40437","197031","8870.866875","0.115321269375","7.388088807937479E7","960.4515450318762"
"12967","40437","40430","7","40437","197038","8870.866875","0.115321269375","7.388975894624978E7","960.5668663012513"
"12968","40437","40433","2","40435","197040","8870.428125","0.11531556562499999","7.389862937437478E7","960.6821818668762"
"12969","40435","40426","1","40427","197041","8868.673125","0.11529275062499998","7.390749804749978E7","960.7974746175013"
"12970","40427","40419","5","40424","197046","8868.015","0.11528419499999999","7.391636606249978E7","960.9127588125012"
"12971","40424","40419","1","40420","197047","8867.1375","0.1152727875","7.392523319999978E7","961.0280316000012"
"12972","40420","40419","6","40425","197053","8868.234375","0.115287046875","7.393410143437478E7","961.1433186468762"
"12973","40425","40423","7","40430","197060","8869.33125","0.11530130624999999","7.394297076562478E7","961.2586199531262"
"12974","40430","40428","6","40434","197066","8870.20875","0.11531271374999999","7.395184097437477E7","961.3739326668762"
"12975","40434","40430","2","40432","197068","8869.77","0.11530701","7.396071074437477E7","961.4892396768762"
"12976","40432","40428","5","40433","197073","8869.989375000001","0.115309861875","7.396958073374976E7","961.6045495387511"
"12977","40433","40427","5","40432","197078","8869.77","0.11530701","7.397845050374976E7","961.7198565487512"
"12978","40432","40429","8","40437","197086","8870.866875","0.115321269375","7.398732137062475E7","961.8351778181262"
"12979","40437","40433","4","40437","197090","8870.866875","0.115321269375","7.399619223749974E7","961.9504990875013"
"12980","40437","40428","5","40433","197095","8869.989375000001","0.115309861875","7.400506222687474E7","962.0658089493762"
"12981","40433","40424","7","40431","197102","8869.550625","0.11530415812499999","7.401393177749974E7","962.1811131075012"
"12982","40431","40426","4","40430","197106","8869.33125","0.11530130624999999","7.402280110874973E7","962.2964144137512"
"12983","40430","40426","8","40434","197114","8870.20875","0.11531271374999999","7.403167131749973E7","962.4117271275012"
"12984","40434","40425","2","40427","197116","8868.673125","0.11529275062499998","7.404053999062473E7","962.5270198781262"
"12985","40427","40418","8","40426","197124","8868.453749999999","0.11528989874999998","7.404940844437473E7","962.6423097768762"
"12986","40426","40417","7","40424","197131","8868.015","0.11528419499999999","7.405827645937473E7","962.7575939718762"
"12987","40424","40417","8","40425","197139","8868.234375","0.115287046875","7.406714469374973E7","962.8728810187512"
"12988","40425","40422","2","40424","197141","8868.015","0.11528419499999999","7.407601270874973E7","962.9881652137511"
"12989","40424","40420","9","40429","197150","8869.111875","0.115298454375","7.408488182062472E7","963.1034636681261"
"12990","40429","40427","8","40435","197158","8870.428125","0.11531556562499999","7.409375224874972E7","963.2187792337511"
"12991","40435","40428","3","40431","197161","8869.550625","0.11530415812499999","7.410262179937471E7","963.3340833918761"
"12992","40431","40425","2","40427","197163","8868.673125","0.11529275062499998","7.411149047249971E7","963.4493761425011"
"12993","40427","40419","2","40421","197165","8867.356875","0.11527563937499999","7.412035782937472E7","963.5646517818761"
"12994","40421","40420","4","40424","197169","8868.015","0.11528419499999999","7.412922584437472E7","963.6799359768761"
"12995","40424","40423","9","40432","197178","8869.77","0.11530701","7.413809561437471E7","963.7952429868761"
"12996","40432","40429","9","40438","197187","8871.08625","0.11532412125","7.414696670062472E7","963.9105671081261"
"12997","40438","40430","9","40439","197196","8871.305624999999","0.11532697312499998","7.415583800624973E7","964.0258940812511"
"12998","40439","40433","9","40442","197205","8871.963749999999","0.11533552874999999","7.416470996999973E7","964.1412296100011"
"12999","40442","40437","4","40441","197209","8871.744374999998","0.11533267687499997","7.417358171437474E7","964.2565622868761"
"13000","40441","40435","2","40437","197211","8870.866875","0.115321269375","7.418245258124973E7","964.3718835562512"
"13001","40437","40430","1","40431","197212","8869.550625","0.11530415812499999","7.419132213187473E7","964.4871877143762"
"13002","40431","40430","1","40431","197213","8869.550625","0.11530415812499999","7.420019168249972E7","964.6024918725012"
"13003","40431","40425","6","40431","197219","8869.550625","0.11530415812499999","7.420906123312472E7","964.7177960306262"
"13004","40431","40423","9","40432","197228","8869.77","0.11530701","7.421793100312471E7","964.8331030406263"
"13005","40432","40430","2","40432","197230","8869.77","0.11530701","7.422680077312471E7","964.9484100506263"
"13006","40432","40425","6","40431","197236","8869.550625","0.11530415812499999","7.42356703237497E7","965.0637142087513"
"13007","40431","40425","2","40427","197238","8868.673125","0.11529275062499998","7.42445389968747E7","965.1790069593764"
"13008","40427","40424","7","40431","197245","8869.550625","0.11530415812499999","7.42534085474997E7","965.2943111175014"
"13009","40431","40422","1","40423","197246","8867.795625","0.115281343125","7.42622763431247E7","965.4095924606264"
"13010","40423","40415","6","40421","197252","8867.356875","0.11527563937499999","7.42711436999997E7","965.5248681000014"
"13011","40421","40414","1","40415","197253","8866.040625","0.11525852812499998","7.428000974062471E7","965.6401266281264"
"13012","40415","40412","8","40420","197261","8867.1375","0.1152727875","7.428887687812471E7","965.7553994156264"
"13013","40420","40415","4","40419","197265","8866.918125","0.115269935625","7.429774379624972E7","965.8706693512513"
"13014","40419","40415","9","40424","197274","8868.015","0.11528419499999999","7.430661181124972E7","965.9859535462513"
"13015","40424","40420","3","40423","197277","8867.795625","0.115281343125","7.431547960687472E7","966.1012348893763"
"13016","40423","40414","5","40419","197282","8866.918125","0.115269935625","7.432434652499972E7","966.2165048250013"
"13017","40419","40416","9","40425","197291","8868.234375","0.115287046875","7.433321475937472E7","966.3317918718762"
"13018","40425","40423","3","40426","197294","8868.453749999999","0.11528989874999998","7.434208321312472E7","966.4470817706263"
"13019","40426","40423","6","40429","197300","8869.111875","0.115298454375","7.435095232499972E7","966.5623802250012"
"13020","40429","40428","1","40429","197301","8869.111875","0.115298454375","7.435982143687472E7","966.6776786793762"
"13021","40429","40387","977","41364","198278","9074.227499999999","0.11796495749999998","7.436889566437472E7","966.7956436368762"
"13022","41364","41359","7","41366","198285","9074.666249999998","0.11797066124999997","7.437797033062473E7","966.9136142981262"
"13023","41366","41362","3","41365","198288","9074.446875","0.11796780937499998","7.438704477749974E7","967.0315821075012"
"13024","41365","41364","7","41371","198295","9075.763125","0.11798492062499999","7.439612054062474E7","967.1495670281262"
"13025","41371","41365","2","41367","198297","9074.885624999999","0.11797351312499998","7.440519542624974E7","967.2675405412512"
"13026","41367","41365","5","41370","198302","9075.54375","0.11798206875","7.441427096999975E7","967.3855226100012"
"13027","41370","41363","9","41372","198311","9075.9825","0.11798777249999999","7.442334695249975E7","967.5035103825012"
"13028","41372","41363","3","41366","198314","9074.666249999998","0.11797066124999997","7.443242161874975E7","967.6214810437511"
"13029","41366","41358","6","41364","198320","9074.227499999999","0.11796495749999998","7.444149584624976E7","967.7394460012512"
"13030","41364","41355","4","41359","198324","9073.130625","0.11795069812499999","7.445056897687475E7","967.8573966993762"
"13031","41359","41355","4","41359","198328","9073.130625","0.11795069812499999","7.445964210749975E7","967.9753473975012"
"13032","41359","41353","7","41360","198335","9073.35","0.11795355","7.446871545749974E7","968.0933009475012"
"13033","41360","41356","9","41365","198344","9074.446875","0.11796780937499998","7.447778990437475E7","968.2112687568763"
"13034","41365","41357","2","41359","198346","9073.130625","0.11795069812499999","7.448686303499974E7","968.3292194550013"
"13035","41359","41356","2","41358","198348","9072.911250000001","0.11794784625","7.449593594624974E7","968.4471673012513"
"13036","41358","41354","7","41361","198355","9073.569375","0.11795640187499998","7.450500951562473E7","968.5651237031262"
"13037","41361","41352","1","41353","198356","9071.814375","0.117933586875","7.451408132999973E7","968.6830572900012"
"13038","41353","41349","7","41356","198363","9072.4725","0.11794214249999999","7.452315380249973E7","968.8009994325013"
"13039","41356","41351","6","41357","198369","9072.691875","0.117944994375","7.453222649437472E7","968.9189444268762"
"13040","41357","41351","9","41360","198378","9073.35","0.11795355","7.454129984437472E7","969.0368979768763"
"13041","41360","41359","7","41366","198385","9074.666249999998","0.11797066124999997","7.455037451062472E7","969.1548686381262"
"13042","41366","41359","5","41364","198390","9074.227499999999","0.11796495749999998","7.455944873812473E7","969.2728335956263"
"13043","41364","41362","4","41366","198394","9074.666249999998","0.11797066124999997","7.456852340437473E7","969.3908042568762"
"13044","41366","41363","5","41368","198399","9075.105","0.11797636499999999","7.457759850937474E7","969.5087806218762"
"13045","41368","41365","9","41374","198408","9076.42125","0.11799347624999998","7.458667493062474E7","969.6267740981262"
"13046","41374","41370","4","41374","198412","9076.42125","0.11799347624999998","7.459575135187474E7","969.7447675743763"
"13047","41374","41371","1","41372","198413","9075.9825","0.11798777249999999","7.460482733437474E7","969.8627553468763"
"13048","41372","41369","3","41372","198416","9075.9825","0.11798777249999999","7.461390331687474E7","969.9807431193763"
"13049","41372","41366","3","41369","198419","9075.324375","0.117979216875","7.462297864124975E7","970.0987223362513"
"13050","41369","41366","1","41367","198420","9074.885624999999","0.11797351312499998","7.463205352687475E7","970.2166958493763"
"13051","41367","41361","3","41364","198423","9074.227499999999","0.11796495749999998","7.464112775437476E7","970.3346608068763"
"13052","41364","41356","8","41364","198431","9074.227499999999","0.11796495749999998","7.465020198187476E7","970.4526257643763"
"13053","41364","41358","2","41360","198433","9073.35","0.11795355","7.465927533187476E7","970.5705793143763"
"13054","41360","41351","2","41353","198435","9071.814375","0.117933586875","7.466834714624976E7","970.6885129012513"
"13055","41353","41348","2","41350","198437","9071.15625","0.11792503124999999","7.467741830249976E7","970.8064379325014"
"13056","41350","41345","1","41346","198438","9070.27875","0.11791362374999999","7.468648858124976E7","970.9243515562514"
"13057","41346","41341","5","41346","198443","9070.27875","0.11791362374999999","7.469555885999976E7","971.0422651800014"
"13058","41346","41337","3","41340","198446","9068.9625","0.1178965125","7.470462782249977E7","971.1601616925014"
"13059","41340","41333","8","41341","198454","9069.181874999998","0.11789936437499997","7.471369700437477E7","971.2780610568765"
"13060","41341","41339","7","41346","198461","9070.27875","0.11791362374999999","7.472276728312477E7","971.3959746806265"
"13061","41346","41341","8","41349","198469","9070.936875","0.11792217937499999","7.473183821999978E7","971.5138968600015"
"13062","41349","41344","6","41350","198475","9071.15625","0.11792503124999999","7.474090937624978E7","971.6318218912515"
"13063","41350","41343","5","41348","198480","9070.7175","0.1179193275","7.474998009374978E7","971.7497412187515"
"13064","41348","41346","5","41351","198485","9071.375624999999","0.11792788312499998","7.475905146937478E7","971.8676691018766"
"13065","41351","41343","6","41349","198491","9070.936875","0.11792217937499999","7.476812240624978E7","971.9855912812516"
"13066","41349","41346","4","41350","198495","9071.15625","0.11792503124999999","7.477719356249978E7","972.1035163125016"
"13067","41350","41346","9","41355","198504","9072.253125","0.11793929062499998","7.478626581562477E7","972.2214556031266"
"13068","41355","41350","3","41353","198507","9071.814375","0.117933586875","7.479533762999977E7","972.3393891900016"
"13069","41353","41349","3","41352","198510","9071.595","0.11793073499999998","7.480440922499977E7","972.4573199250016"
"13070","41352","41347","4","41351","198514","9071.375624999999","0.11792788312499998","7.481348060062477E7","972.5752478081266"
"13071","41351","41343","4","41347","198518","9070.498125","0.11791647562499999","7.482255109874977E7","972.6931642837516"
"13072","41347","41340","2","41342","198520","9069.401249999999","0.11790221624999998","7.483162049999978E7","972.8110665000015"
"13073","41342","41339","2","41341","198522","9069.181874999998","0.11789936437499997","7.484068968187478E7","972.9289658643766"
"13074","41341","41340","2","41342","198524","9069.401249999999","0.11790221624999998","7.484975908312479E7","973.0468680806265"
"13075","41342","41338","2","41340","198526","9068.9625","0.1178965125","7.48588280456248E7","973.1647645931265"
"13076","41340","41334","6","41340","198532","9068.9625","0.1178965125","7.48678970081248E7","973.2826611056265"
"13077","41340","41331","5","41336","198537","9068.085","0.11788510499999998","7.487696509312479E7","973.4005462106265"
"13078","41336","41327","7","41334","198544","9067.64625","0.11787940124999999","7.488603273937479E7","973.5184256118765"
"13079","41334","41327","8","41335","198552","9067.865625","0.117882253125","7.489510060499978E7","973.6363078650015"
"13080","41335","41326","3","41329","198555","9066.549375","0.117865141875","7.490416715437478E7","973.7541730068765"
"13081","41329","41303","976","42279","199531","9274.955625","0.120574423125","7.491344210999978E7","973.8747474300015"
"13082","42279","42273","8","42281","199539","9275.394375","0.12058012687499998","7.492271750437477E7","973.9953275568765"
"13083","42281","42280","1","42281","199540","9275.394375","0.12058012687499998","7.493199289874977E7","974.1159076837515"
"13084","42281","42273","4","42277","199544","9274.516875","0.12056871937499998","7.494126741562477E7","974.2364764031265"
"13085","42277","42273","8","42281","199552","9275.394375","0.12058012687499998","7.495054280999976E7","974.3570565300015"
"13086","42281","42272","5","42277","199557","9274.516875","0.12056871937499998","7.495981732687476E7","974.4776252493765"
"13087","42277","42276","5","42281","199562","9275.394375","0.12058012687499998","7.496909272124976E7","974.5982053762515"
"13088","42281","42272","9","42281","199571","9275.394375","0.12058012687499998","7.497836811562476E7","974.7187855031265"
"13089","42281","42275","5","42280","199576","9275.175","0.12057727499999998","7.498764329062475E7","974.8393627781264"
"13090","42280","42277","2","42279","199578","9274.955625","0.120574423125","7.499691824624975E7","974.9599372012515"
"13091","42279","42274","3","42277","199581","9274.516875","0.12056871937499998","7.500619276312475E7","975.0805059206265"
"13092","42277","42275","6","42281","199587","9275.394375","0.12058012687499998","7.501546815749975E7","975.2010860475015"
"13093","42281","42273","5","42278","199592","9274.73625","0.12057157125","7.502474289374974E7","975.3216576187515"
"13094","42278","42272","2","42274","199594","9273.85875","0.12056016374999999","7.503401675249974E7","975.4422177825015"
"13095","42274","42267","4","42271","199598","9273.200625","0.12055160812499999","7.504328995312475E7","975.5627693906265"
"13096","42271","42265","3","42268","199601","9272.5425","0.12054305249999998","7.505256249562475E7","975.6833124431265"
"13097","42268","42267","5","42272","199606","9273.42","0.12055445999999999","7.506183591562475E7","975.8038669031265"
"13098","42272","42265","9","42274","199615","9273.85875","0.12056016374999999","7.507110977437475E7","975.9244270668765"
"13099","42274","42268","9","42277","199624","9274.516875","0.12056871937499998","7.508038429124975E7","976.0449957862515"
"13100","42277","42274","1","42275","199625","9274.078125","0.12056301562499999","7.508965836937475E7","976.1655588018765"
"13101","42275","42272","8","42280","199633","9275.175","0.12057727499999998","7.509893354437475E7","976.2861360768765"
"13102","42280","42272","3","42275","199636","9274.078125","0.12056301562499999","7.510820762249975E7","976.4066990925014"
"13103","42275","42270","1","42271","199637","9273.200625","0.12055160812499999","7.511748082312475E7","976.5272507006264"
"13104","42271","42267","9","42276","199646","9274.297499999999","0.12056586749999998","7.512675512062475E7","976.6478165681264"
"13105","42276","42270","1","42271","199647","9273.200625","0.12055160812499999","7.513602832124975E7","976.7683681762513"
"13106","42271","42263","4","42267","199651","9272.323124999999","0.12054020062499998","7.514530064437476E7","976.8889083768763"
"13107","42267","42258","5","42263","199656","9271.445625","0.12052879312499999","7.515457208999977E7","977.0094371700013"
"13108","42263","42255","4","42259","199660","9270.568125","0.12051738562499999","7.516384265812476E7","977.1299545556263"
"13109","42259","42254","4","42258","199664","9270.348750000001","0.12051453375","7.517311300687476E7","977.2504690893763"
"13110","42258","42255","2","42257","199666","9270.129375","0.120511681875","7.518238313624975E7","977.3709807712513"
"13111","42257","42251","3","42254","199669","9269.47125","0.12050312625","7.519165260749975E7","977.4914838975013"
"13112","42254","42245","8","42253","199677","9269.251875","0.120500274375","7.520092185937475E7","977.6119841718763"
"13113","42253","42251","7","42258","199684","9270.348750000001","0.12051453375","7.521019220812474E7","977.7324987056263"
"13114","42258","42256","7","42263","199691","9271.445625","0.12052879312499999","7.521946365374975E7","977.8530274987513"
"13115","42263","42256","6","42262","199697","9271.22625","0.12052594124999999","7.522873487999974E7","977.9735534400013"
"13116","42262","42253","7","42260","199704","9270.7875","0.1205202375","7.523800566749974E7","978.0940736775013"
"13117","42260","42259","2","42261","199706","9271.006875","0.12052308937499998","7.524727667437473E7","978.2145967668763"
"13118","42261","42258","5","42263","199711","9271.445625","0.12052879312499999","7.525654811999974E7","978.3351255600013"
"13119","42263","42258","1","42259","199712","9270.568125","0.12051738562499999","7.526581868812473E7","978.4556429456263"
"13120","42259","42256","1","42257","199713","9270.129375","0.120511681875","7.527508881749973E7","978.5761546275013"
"13121","42257","42249","3","42252","199716","9269.0325","0.12049742249999998","7.528435784999973E7","978.6966520500013"
"13122","42252","42250","7","42257","199723","9270.129375","0.120511681875","7.529362797937472E7","978.8171637318762"
"13123","42257","42254","6","42260","199729","9270.7875","0.1205202375","7.530289876687472E7","978.9376839693763"
"13124","42260","42254","3","42257","199732","9270.129375","0.120511681875","7.531216889624971E7","979.0581956512513"
"13125","42257","42252","9","42261","199741","9271.006875","0.12052308937499998","7.53214399031247E7","979.1787187406262"
"13126","42261","42260","9","42269","199750","9272.761875","0.120545904375","7.533071266499971E7","979.2992646450012"
"13127","42269","42267","9","42276","199759","9274.297499999999","0.12056586749999998","7.533998696249971E7","979.4198305125012"
"13128","42276","42270","9","42279","199768","9274.955625","0.120574423125","7.53492619181247E7","979.5404049356263"
"13129","42279","42270","2","42272","199770","9273.42","0.12055445999999999","7.53585353381247E7","979.6609593956263"
"13130","42272","42264","2","42266","199772","9272.103749999998","0.12053734874999997","7.536780744187471E7","979.7814967443762"
"13131","42266","42265","3","42268","199775","9272.5425","0.12054305249999998","7.537707998437472E7","979.9020397968762"
"13132","42268","42266","7","42273","199782","9273.639375","0.120557311875","7.538635362374972E7","980.0225971087513"
"13133","42273","42268","3","42271","199785","9273.200625","0.12055160812499999","7.539562682437472E7","980.1431487168762"
"13134","42271","42268","8","42276","199793","9274.297499999999","0.12056586749999998","7.540490112187472E7","980.2637145843762"
"13135","42276","42269","7","42276","199800","9274.297499999999","0.12056586749999998","7.541417541937472E7","980.3842804518762"
"13136","42276","42270","9","42279","199809","9274.955625","0.120574423125","7.542345037499972E7","980.5048548750012"
"13137","42279","42272","7","42279","199816","9274.955625","0.120574423125","7.543272533062471E7","980.6254292981263"
"13138","42279","42273","6","42279","199822","9274.955625","0.120574423125","7.544200028624971E7","980.7460037212513"
"13139","42279","42273","1","42274","199823","9273.85875","0.12056016374999999","7.545127414499971E7","980.8665638850014"
"13140","42274","42271","9","42280","199832","9275.175","0.12057727499999998","7.546054931999971E7","980.9871411600013"
"13141","42280","42231","958","43189","200790","9474.586874999999","0.12316962937499998","7.547002390687472E7","981.1103107893763"
"13142","43189","43180","3","43183","200793","9473.270625000001","0.123152518125","7.547949717749971E7","981.2334633075013"
"13143","43183","43179","4","43183","200797","9473.270625000001","0.123152518125","7.54889704481247E7","981.3566158256264"
"13144","43183","43175","7","43182","200804","9473.05125","0.12314966625","7.54984434993747E7","981.4797654918764"
"13145","43182","43180","9","43189","200813","9474.586874999999","0.12316962937499998","7.550791808624971E7","981.6029351212513"
"13146","43189","43188","9","43197","200822","9476.341875","0.12319244437499999","7.551739442812471E7","981.7261275656264"
"13147","43197","43196","8","43204","200830","9477.8775","0.1232124075","7.552687230562471E7","981.8493399731263"
"13148","43204","43199","2","43201","200832","9477.219374999999","0.12320385187499998","7.553634952499971E7","981.9725438250014"
"13149","43201","43195","8","43203","200840","9477.658125","0.123209555625","7.55458271831247E7","982.0957533806263"
"13150","43203","43201","5","43206","200845","9478.31625","0.12321811124999998","7.55553054993747E7","982.2189714918763"
"13151","43206","43201","5","43206","200850","9478.31625","0.12321811124999998","7.55647838156247E7","982.3421896031264"
"13152","43206","43199","2","43201","200852","9477.219374999999","0.12320385187499998","7.55742610349997E7","982.4653934550014"
"13153","43201","43195","4","43199","200856","9476.780625","0.12319814812499999","7.55837378156247E7","982.5885916031264"
"13154","43199","43198","7","43205","200863","9478.096875","0.12321525937499998","7.55932159124997E7","982.7118068625014"
"13155","43205","43204","4","43208","200867","9478.755000000001","0.123223815","7.560269466749969E7","982.8350306775013"
"13156","43208","43200","4","43204","200871","9477.8775","0.1232124075","7.561217254499969E7","982.9582430850013"
"13157","43204","43203","1","43204","200872","9477.8775","0.1232124075","7.562165042249969E7","983.0814554925013"
"13158","43204","43195","8","43203","200880","9477.658125","0.123209555625","7.563112808062468E7","983.2046650481262"
"13159","43203","43198","7","43205","200887","9478.096875","0.12321525937499998","7.564060617749968E7","983.3278803075012"
"13160","43205","43203","7","43210","200894","9479.19375","0.12322951875","7.565008537124968E7","983.4511098262512"
"13161","43210","43204","9","43213","200903","9479.851875","0.12323807437499999","7.565956522312468E7","983.5743479006262"
"13162","43213","43211","5","43216","200908","9480.509999999998","0.12324662999999997","7.566904573312469E7","983.6975945306262"
"13163","43216","43211","6","43217","200914","9480.729374999999","0.12324948187499998","7.56785264624997E7","983.8208440125012"
"13164","43217","43210","4","43214","200918","9480.071249999999","0.12324092624999998","7.56880065337497E7","983.9440849387512"
"13165","43214","43209","3","43212","200921","9479.6325","0.12323522249999999","7.569748616624969E7","984.0673201612512"
"13166","43212","43206","8","43214","200929","9480.071249999999","0.12324092624999998","7.57069662374997E7","984.1905610875012"
"13167","43214","43205","6","43211","200935","9479.413125","0.12323237062499998","7.571644565062469E7","984.3137934581263"
"13168","43211","43206","6","43212","200941","9479.6325","0.12323522249999999","7.572592528312469E7","984.4370286806263"
"13169","43212","43208","7","43215","200948","9480.290625","0.12324377812499998","7.573540557374969E7","984.5602724587513"
"13170","43215","43208","9","43217","200957","9480.729374999999","0.12324948187499998","7.57448863031247E7","984.6835219406263"
"13171","43217","43216","9","43225","200966","9482.484375","0.12327229687499999","7.57543687874997E7","984.8067942375013"
"13172","43225","43220","4","43224","200970","9482.265","0.12326944499999999","7.57638510524997E7","984.9300636825013"
"13173","43224","43218","1","43219","200971","9481.168125","0.123255185625","7.57733322206247E7","985.0533188681263"
"13174","43219","43216","8","43224","200979","9482.265","0.12326944499999999","7.57828144856247E7","985.1765883131263"
"13175","43224","43222","3","43225","200982","9482.484375","0.12327229687499999","7.57922969699997E7","985.2998606100014"
"13176","43225","43224","2","43226","200984","9482.703749999999","0.12327514874999998","7.58017796737497E7","985.4231357587514"
"13177","43226","43225","1","43226","200985","9482.703749999999","0.12327514874999998","7.58112623774997E7","985.5464109075015"
"13178","43226","43223","9","43232","200994","9484.02","0.12329226","7.58207463974997E7","985.6697031675014"
"13179","43232","43228","1","43229","200995","9483.361875","0.123283704375","7.58302297593747E7","985.7929868718765"
"13180","43229","43226","7","43233","201002","9484.239375000001","0.123295111875","7.583971399874969E7","985.9162819837514"
"13181","43233","43224","5","43229","201007","9483.361875","0.123283704375","7.584919736062469E7","986.0395656881265"
"13182","43229","43220","3","43223","201010","9482.045625","0.123266593125","7.585867940624969E7","986.1628322812514"
"13183","43223","43215","7","43222","201017","9481.82625","0.12326374124999999","7.586816123249969E7","986.2860960225014"
"13184","43222","43217","9","43226","201026","9482.703749999999","0.12327514874999998","7.587764393624969E7","986.4093711712515"
"13185","43226","43223","5","43228","201031","9483.1425","0.1232808525","7.588712707874969E7","986.5326520237514"
"13186","43228","43227","9","43236","201040","9484.8975","0.12330366749999998","7.589661197624968E7","986.6559556912514"
"13187","43236","43234","5","43239","201045","9485.555624999999","0.12331222312499998","7.590609753187469E7","986.7792679143764"
"13188","43239","43231","6","43237","201051","9485.116875","0.12330651937499999","7.591558264874968E7","986.9025744337514"
"13189","43237","43233","5","43238","201056","9485.33625","0.12330937125","7.592506798499969E7","987.0258838050014"
"13190","43238","43232","4","43236","201060","9484.8975","0.12330366749999998","7.593455288249968E7","987.1491874725014"
"13191","43236","43231","7","43238","201067","9485.33625","0.12330937125","7.594403821874969E7","987.2724968437514"
"13192","43238","43233","5","43238","201072","9485.33625","0.12330937125","7.59535235549997E7","987.3958062150014"
"13193","43238","43235","6","43241","201078","9485.994374999998","0.12331792687499997","7.59630095493747E7","987.5191241418763"
"13194","43241","43236","9","43245","201087","9486.871875","0.123329334375","7.59724964212497E7","987.6424534762513"
"13195","43245","43243","7","43250","201094","9487.96875","0.12334359375","7.59819843899997E7","987.7657970700012"
"13196","43250","43248","1","43249","201095","9487.749375","0.12334074187499998","7.59914721393747E7","987.8891378118763"
"13197","43249","43242","2","43244","201097","9486.6525","0.1233264825","7.60009587918747E7","988.0124642943763"
"13198","43244","43237","5","43242","201102","9486.213749999999","0.12332077874999998","7.601044500562471E7","988.1357850731263"
"13199","43242","43240","9","43249","201111","9487.749375","0.12334074187499998","7.601993275499971E7","988.2591258150013"
"13200","43249","43244","8","43252","201119","9488.4075","0.12334929749999998","7.602942116249971E7","988.3824751125013"
"13201","43252","43215","714","43929","201833","9636.924375","0.125280016875","7.603905808687471E7","988.5077551293763"
"13202","43929","43921","8","43929","201841","9636.924375","0.125280016875","7.60486950112497E7","988.6330351462512"
"13203","43929","43926","9","43935","201850","9638.240625","0.125297128125","7.60583332518747E7","988.7583322743762"
"13204","43935","43931","3","43934","201853","9638.021250000002","0.12529427625","7.60679712731247E7","988.8836265506262"
"13205","43934","43929","4","43933","201857","9637.801875000001","0.12529142437500002","7.607760907499969E7","989.0089179750012"
"13206","43933","43931","7","43938","201864","9638.89875","0.12530568375","7.60872479737497E7","989.1342236587511"
"13207","43938","43932","6","43938","201870","9638.89875","0.12530568375","7.60968868724997E7","989.2595293425011"
"13208","43938","43930","3","43933","201873","9637.801875000001","0.12529142437500002","7.61065246743747E7","989.384820766876"
"13209","43933","43924","7","43931","201880","9637.363125","0.12528572062499999","7.61161620374997E7","989.510106487501"
"13210","43931","43927","9","43936","201889","9638.46","0.12529997999999998","7.612580049749969E7","989.6354064675011"
"13211","43936","43927","1","43928","201890","9636.705","0.125277165","7.613543720249969E7","989.7606836325011"
"13212","43928","43923","5","43928","201895","9636.705","0.125277165","7.614507390749969E7","989.8859607975012"
"13213","43928","43922","4","43926","201899","9636.266249999999","0.12527146124999997","7.615471017374969E7","990.0112322587512"
"13214","43926","43923","3","43926","201902","9636.266249999999","0.12527146124999997","7.616434643999968E7","990.1365037200012"
"13215","43926","43924","7","43931","201909","9637.363125","0.12528572062499999","7.617398380312468E7","990.2617894406262"
"13216","43931","43925","9","43934","201918","9638.021250000002","0.12529427625","7.618362182437468E7","990.3870837168762"
"13217","43934","43928","1","43929","201919","9636.924375","0.125280016875","7.619325874874967E7","990.5123637337512"
"13218","43929","43926","2","43928","201921","9636.705","0.125277165","7.620289545374967E7","990.6376408987512"
"13219","43928","43920","5","43925","201926","9636.046875","0.12526860937499998","7.621253150062467E7","990.7629095081262"
"13220","43925","43921","5","43926","201931","9636.266249999999","0.12527146124999997","7.622216776687467E7","990.8881809693762"
"13221","43926","43920","6","43926","201937","9636.266249999999","0.12527146124999997","7.623180403312467E7","991.0134524306262"
"13222","43926","43925","7","43932","201944","9637.5825","0.1252885725","7.624144161562467E7","991.1387410031263"
"13223","43932","43931","9","43940","201953","9639.3375","0.12531138749999998","7.625108095312467E7","991.2640523906263"
"13224","43940","43937","2","43939","201955","9639.118125","0.125308535625","7.626072007124968E7","991.3893609262512"
"13225","43939","43932","6","43938","201961","9638.89875","0.12530568375","7.627035896999969E7","991.5146666100012"
"13226","43938","43932","1","43933","201962","9637.801875000001","0.12529142437500002","7.627999677187468E7","991.6399580343761"
"13227","43933","43925","8","43933","201970","9637.801875000001","0.12529142437500002","7.628963457374968E7","991.7652494587511"
"13228","43933","43924","3","43927","201973","9636.485625","0.12527431312499998","7.629927105937468E7","991.8905237718761"
"13229","43927","43918","5","43923","201978","9635.608125","0.125262905625","7.630890666749968E7","992.0157866775012"
"13230","43923","43915","6","43921","201984","9635.169375","0.12525720187499997","7.631854183687468E7","992.1410438793762"
"13231","43921","43916","4","43920","201988","9634.95","0.12525435000000001","7.632817678687468E7","992.2662982293762"
"13232","43920","43916","6","43922","201994","9635.38875","0.12526005375","7.633781217562468E7","992.3915582831262"
"13233","43922","43921","2","43923","201996","9635.608125","0.125262905625","7.634744778374968E7","992.5168211887512"
"13234","43923","43915","3","43918","201999","9634.51125","0.12524864624999998","7.635708229499969E7","992.6420698350013"
"13235","43918","43914","8","43922","202007","9635.38875","0.12526005375","7.636671768374969E7","992.7673298887513"
"13236","43922","43915","8","43923","202015","9635.608125","0.125262905625","7.637635329187469E7","992.8925927943764"
"13237","43923","43920","3","43923","202018","9635.608125","0.125262905625","7.63859888999997E7","993.0178557000014"
"13238","43923","43915","8","43923","202026","9635.608125","0.125262905625","7.63956245081247E7","993.1431186056265"
"13239","43923","43914","2","43916","202028","9634.072499999998","0.12524294249999998","7.64052585806247E7","993.2683615481264"
"13240","43916","43911","1","43912","202029","9633.195","0.12523153499999998","7.641489177562469E7","993.3935930831265"
"13241","43912","43909","7","43916","202036","9634.072499999998","0.12524294249999998","7.64245258481247E7","993.5188360256265"
"13242","43916","43910","8","43918","202044","9634.51125","0.12524864624999998","7.64341603593747E7","993.6440846718765"
"13243","43918","43917","3","43920","202047","9634.95","0.12525435000000001","7.64437953093747E7","993.7693390218765"
"13244","43920","43914","3","43917","202050","9634.291874999999","0.12524579437499997","7.645342960124971E7","993.8945848162515"
"13245","43917","43909","4","43913","202054","9633.414375","0.125234386875","7.646306301562472E7","994.0198192031265"
"13246","43913","43904","5","43909","202059","9632.536875000002","0.12522297937500002","7.647269555249971E7","994.1450421825016"
"13247","43909","43905","2","43907","202061","9632.098125","0.12521727562499999","7.64823276506247E7","994.2702594581266"
"13248","43907","43905","1","43906","202062","9631.87875","0.12521442375","7.64919595293747E7","994.3954738818766"
"13249","43906","43897","4","43901","202066","9630.781874999999","0.12520016437499998","7.65015903112497E7","994.5206740462515"
"13250","43901","43893","3","43896","202069","9629.685","0.125185905","7.65112199962497E7","994.6458599512515"
"13251","43896","43891","2","43893","202071","9629.026875","0.125177349375","7.652084902312471E7","994.7710373006265"
"13252","43893","43885","4","43889","202075","9628.149375","0.125165941875","7.653047717249972E7","994.8962032425015"
"13253","43889","43885","4","43889","202079","9628.149375","0.125165941875","7.654010532187472E7","995.0213691843766"
"13254","43889","43888","6","43894","202085","9629.24625","0.12518020124999998","7.654973456812473E7","995.1465493856266"
"13255","43894","43891","1","43892","202086","9628.807499999999","0.12517449749999998","7.655936337562473E7","995.2717238831266"
"13256","43892","43890","7","43897","202093","9629.904375","0.125188756875","7.656899327999973E7","995.3969126400016"
"13257","43897","43890","3","43893","202096","9629.026875","0.125177349375","7.657862230687474E7","995.5220899893766"
"13258","43893","43889","7","43896","202103","9629.685","0.125185905","7.658825199187474E7","995.6472758943765"
"13259","43896","43889","3","43892","202106","9628.807499999999","0.12517449749999998","7.659788079937474E7","995.7724503918765"
"13260","43892","43891","1","43892","202107","9628.807499999999","0.12517449749999998","7.660750960687475E7","995.8976248893765"
"13261","43892","43847","638","44485","202745","9758.896875","0.126865659375","7.661726850374974E7","996.0244905487515"
"13262","44485","44482","8","44490","202753","9759.99375","0.12687991875","7.662702849749975E7","996.1513704675015"
"13263","44490","44481","5","44486","202758","9759.11625","0.12686851124999998","7.663678761374974E7","996.2782389787515"
"13264","44486","44482","7","44489","202765","9759.774375","0.126877066875","7.664654738812475E7","996.4051160456264"
"13265","44489","44485","6","44491","202771","9760.213124999998","0.12688277062499997","7.665630760124975E7","996.5319988162514"
"13266","44491","44488","7","44495","202778","9761.090625","0.126894178125","7.666606869187476E7","996.6588929943764"
"13267","44495","44486","7","44493","202785","9760.651875","0.12688847437499998","7.667582934374976E7","996.7857814687515"
"13268","44493","44490","1","44491","202786","9760.213124999998","0.12688277062499997","7.668558955687477E7","996.9126642393765"
"13269","44491","44485","8","44493","202794","9760.651875","0.12688847437499998","7.669535020874977E7","997.0395527137515"
"13270","44493","44489","9","44498","202803","9761.74875","0.12690273375","7.670511195749977E7","997.1664554475014"
"13271","44498","44491","8","44499","202811","9761.968125000001","0.126905585625","7.671487392562477E7","997.2933610331264"
"13272","44499","44498","5","44503","202816","9762.845625","0.126916993125","7.672463677124977E7","997.4202780262514"
"13273","44503","44499","9","44508","202825","9763.942500000001","0.1269312525","7.673440071374977E7","997.5472092787513"
"13274","44508","44507","2","44509","202827","9764.161875000002","0.12693410437500002","7.674416487562476E7","997.6741433831263"
"13275","44509","44507","7","44514","202834","9765.25875","0.12694836375000002","7.675393013437477E7","997.8010917468763"
"13276","44514","44505","9","44514","202843","9765.25875","0.12694836375000002","7.676369539312477E7","997.9280401106263"
"13277","44514","44510","5","44515","202848","9765.478125","0.12695121562499997","7.677346087124978E7","998.0549913262513"
"13278","44515","44514","6","44520","202854","9766.575","0.126965475","7.678322744624978E7","998.1819568012513"
"13279","44520","44516","1","44517","202855","9765.916874999999","0.12695691937499998","7.679299336312479E7","998.3089137206263"
"13280","44517","44512","3","44515","202858","9765.478125","0.12695121562499997","7.68027588412498E7","998.4358649362513"
"13281","44515","44506","3","44509","202861","9764.161875000002","0.12693410437500002","7.681252300312479E7","998.5627990406263"
"13282","44509","44502","9","44511","202870","9764.600625","0.12693980812499997","7.682228760374978E7","998.6897388487513"
"13283","44511","44502","4","44506","202874","9763.50375","0.12692554874999998","7.683205110749978E7","998.8166643975013"
"13284","44506","44500","8","44508","202882","9763.942500000001","0.1269312525","7.684181504999977E7","998.9435956500013"
"13285","44508","44501","2","44503","202884","9762.845625","0.126916993125","7.685157789562477E7","999.0705126431262"
"13286","44503","44494","7","44501","202891","9762.406874999999","0.12691128937499999","7.686134030249977E7","999.1974239325012"
"13287","44501","44492","6","44498","202897","9761.74875","0.12690273375","7.687110205124977E7","999.3243266662512"
"13288","44498","44497","6","44503","202903","9762.845625","0.126916993125","7.688086489687477E7","999.4512436593761"
"13289","44503","44502","5","44507","202908","9763.723125","0.126928400625","7.689062861999977E7","999.5781720600012"
"13290","44507","44502","8","44510","202916","9764.38125","0.12693695625","7.690039300124976E7","999.7051090162512"
"13291","44510","44509","6","44515","202922","9765.478125","0.12695121562499997","7.691015847937477E7","999.8320602318762"
"13292","44515","44513","6","44519","202928","9766.355625","0.126962623125","7.691992483499977E7","999.9590228550012"
"13293","44519","44514","6","44520","202934","9766.575","0.126965475","7.692969140999977E7","1000.0859883300012"
"13294","44520","44517","5","44522","202939","9767.01375","0.12697117875","7.693945842374977E7","1000.2129595087512"
"13295","44522","44515","1","44516","202940","9765.697499999998","0.12695406749999996","7.694922412124978E7","1000.3399135762512"
"13296","44516","44510","3","44513","202943","9765.039375","0.126945511875","7.695898916062479E7","1000.4668590881262"
"13297","44513","44511","1","44512","202944","9764.82","0.12694265999999998","7.696875398062478E7","1000.5938017481262"
"13298","44512","44504","9","44513","202953","9765.039375","0.126945511875","7.697851901999979E7","1000.7207472600012"
"13299","44513","44505","6","44511","202959","9764.600625","0.12693980812499997","7.698828362062478E7","1000.8476870681262"
"13300","44511","44509","4","44513","202963","9765.039375","0.126945511875","7.699804865999979E7","1000.9746325800012"
"13301","44513","44504","8","44512","202971","9764.82","0.12694265999999998","7.700781347999978E7","1001.1015752400012"
"13302","44512","44510","5","44515","202976","9765.478125","0.12695121562499997","7.701757895812479E7","1001.2285264556263"
"13303","44515","44508","3","44511","202979","9764.600625","0.12693980812499997","7.702734355874978E7","1001.3554662637513"
"13304","44511","44509","3","44512","202982","9764.82","0.12694265999999998","7.703710837874977E7","1001.4824089237513"
"13305","44512","44509","3","44512","202985","9764.82","0.12694265999999998","7.704687319874977E7","1001.6093515837514"
"13306","44512","44508","6","44514","202991","9765.25875","0.12694836375000002","7.705663845749977E7","1001.7362999475014"
"13307","44514","44512","2","44514","202993","9765.25875","0.12694836375000002","7.706640371624978E7","1001.8632483112514"
"13308","44514","44508","8","44516","203001","9765.697499999998","0.12695406749999996","7.707616941374978E7","1001.9902023787514"
"13309","44516","44511","9","44520","203010","9766.575","0.126965475","7.708593598874979E7","1002.1171678537514"
"13310","44520","44517","6","44523","203016","9767.233125","0.126974030625","7.709570322187479E7","1002.2441418843764"
"13311","44523","44522","8","44530","203024","9768.76875","0.12699399374999998","7.710547199062479E7","1002.3711358781264"
"13312","44530","44523","7","44530","203031","9768.76875","0.12699399374999998","7.711524075937478E7","1002.4981298718765"
"13313","44530","44528","7","44535","203038","9769.865625","0.127008253125","7.712501062499978E7","1002.6251381250015"
"13314","44535","44532","8","44540","203046","9770.9625","0.1270225125","7.713478158749978E7","1002.7521606375016"
"13315","44540","44532","9","44541","203055","9771.181874999998","0.12702536437499998","7.714455276937479E7","1002.8791860018765"
"13316","44541","44536","4","44540","203059","9770.9625","0.1270225125","7.71543237318748E7","1003.0062085143766"
"13317","44540","44536","1","44537","203060","9770.304375","0.127013956875","7.716409403624979E7","1003.1332224712515"
"13318","44537","44535","6","44541","203066","9771.181874999998","0.12702536437499998","7.717386521812479E7","1003.2602478356265"
"13319","44541","44535","2","44537","203068","9770.304375","0.127013956875","7.718363552249978E7","1003.3872617925015"
"13320","44537","44534","4","44538","203072","9770.52375","0.12701680875","7.719340604624979E7","1003.5142786012515"
"13321","44538","44505","526","45031","203598","9878.675625","0.128422783125","7.720328472187479E7","1003.6427013843764"
"13322","45031","45029","6","45035","203604","9879.553125","0.128434190625","7.721316427499978E7","1003.7711355750014"
"13323","45035","45030","2","45032","203606","9878.895","0.128425635","7.722304316999978E7","1003.8995612100014"
"13324","45032","45025","5","45030","203611","9878.45625","0.12841993124999998","7.723292162624978E7","1004.0279811412514"
"13325","45030","45023","7","45030","203618","9878.45625","0.12841993124999998","7.724280008249977E7","1004.1564010725015"
"13326","45030","45024","2","45026","203620","9877.578749999999","0.12840852374999998","7.725267766124977E7","1004.2848095962514"
"13327","45026","45019","3","45022","203623","9876.70125","0.12839711625","7.726255436249977E7","1004.4132067125014"
"13328","45022","45014","6","45020","203629","9876.2625","0.1283914125","7.727243062499978E7","1004.5415981250014"
"13329","45020","45019","7","45026","203636","9877.578749999999","0.12840852374999998","7.728230820374978E7","1004.6700066487514"
"13330","45026","45025","6","45031","203642","9878.675625","0.128422783125","7.729218687937477E7","1004.7984294318763"
"13331","45031","45029","4","45033","203646","9879.114375000001","0.128428486875","7.730206599374977E7","1004.9268579187514"
"13332","45033","45028","1","45029","203647","9878.236875","0.128417079375","7.731194423062477E7","1005.0552749981264"
"13333","45029","45020","4","45024","203651","9877.140000000001","0.12840282","7.732182137062477E7","1005.1836778181264"
"13334","45024","45022","1","45023","203652","9876.920625","0.128399968125","7.733169829124977E7","1005.3120777862514"
"13335","45023","45015","2","45017","203654","9875.604374999999","0.12838285687499998","7.734157389562477E7","1005.4404606431264"
"13336","45017","45010","2","45012","203656","9874.5075","0.1283685975","7.735144840312476E7","1005.5688292406263"
"13337","45012","45003","9","45012","203665","9874.5075","0.1283685975","7.736132291062476E7","1005.6971978381263"
"13338","45012","45008","7","45015","203672","9875.165625","0.12837715312499998","7.737119807624976E7","1005.8255749912513"
"13339","45015","45008","9","45017","203681","9875.604374999999","0.12838285687499998","7.738107368062477E7","1005.9539578481263"
"13340","45017","45016","3","45019","203684","9876.043125","0.12838856062499998","7.739094972374977E7","1006.0823464087513"
"13341","45019","45016","8","45024","203692","9877.140000000001","0.12840282","7.740082686374977E7","1006.2107492287513"
"13342","45024","45023","8","45031","203700","9878.675625","0.128422783125","7.741070553937477E7","1006.3391720118763"
"13343","45031","45025","5","45030","203705","9878.45625","0.12841993124999998","7.742058399562477E7","1006.4675919431263"
"13344","45030","45023","1","45024","203706","9877.140000000001","0.12840282","7.743046113562477E7","1006.5959947631263"
"13345","45024","45020","7","45027","203713","9877.798125","0.128411375625","7.744033893374977E7","1006.7244061387513"
"13346","45027","45024","1","45025","203714","9877.359375","0.128405671875","7.745021629312477E7","1006.8528118106263"
"13347","45025","45024","4","45028","203718","9878.0175","0.12841422749999998","7.746009431062476E7","1006.9812260381264"
"13348","45028","45023","4","45027","203722","9877.798125","0.128411375625","7.746997210874976E7","1007.1096374137513"
"13349","45027","45022","3","45025","203725","9877.359375","0.128405671875","7.747984946812476E7","1007.2380430856264"
"13350","45025","45016","3","45019","203728","9876.043125","0.12838856062499998","7.748972551124977E7","1007.3664316462514"
"13351","45019","45014","4","45018","203732","9875.82375","0.12838570875","7.749960133499977E7","1007.4948173550014"
"13352","45018","45009","7","45016","203739","9875.384999999998","0.12838000499999996","7.750947671999978E7","1007.6231973600014"
"13353","45016","45010","2","45012","203741","9874.5075","0.1283685975","7.751935122749977E7","1007.7515659575014"
"13354","45012","45010","9","45019","203750","9876.043125","0.12838856062499998","7.752922727062477E7","1007.8799545181264"
"13355","45019","45017","7","45024","203757","9877.140000000001","0.12840282","7.753910441062477E7","1008.0083573381264"
"13356","45024","45016","1","45017","203758","9875.604374999999","0.12838285687499998","7.754898001499978E7","1008.1367401950014"
"13357","45017","45013","6","45019","203764","9876.043125","0.12838856062499998","7.755885605812478E7","1008.2651287556264"
"13358","45019","45017","3","45020","203767","9876.2625","0.1283914125","7.756873232062478E7","1008.3935201681264"
"13359","45020","45014","8","45022","203775","9876.70125","0.12839711625","7.757860902187479E7","1008.5219172843764"
"13360","45022","45015","5","45020","203780","9876.2625","0.1283914125","7.758848528437479E7","1008.6503086968764"
"13361","45020","45017","8","45025","203788","9877.359375","0.128405671875","7.759836264374979E7","1008.7787143687515"
"13362","45025","45018","9","45027","203797","9877.798125","0.128411375625","7.760824044187479E7","1008.9071257443765"
"13363","45027","45021","3","45024","203800","9877.140000000001","0.12840282","7.761811758187479E7","1009.0355285643765"
"13364","45024","45021","2","45023","203802","9876.920625","0.128399968125","7.762799450249979E7","1009.1639285325015"
"13365","45023","45018","7","45025","203809","9877.359375","0.128405671875","7.763787186187479E7","1009.2923342043765"
"13366","45025","45020","1","45021","203810","9876.481875","0.12839426437499998","7.764774834374979E7","1009.4207284687515"
"13367","45021","45016","8","45024","203818","9877.140000000001","0.12840282","7.765762548374979E7","1009.5491312887515"
"13368","45024","45017","1","45018","203819","9875.82375","0.12838570875","7.76675013074998E7","1009.6775169975015"
"13369","45018","45012","1","45013","203820","9874.726875","0.128371449375","7.76773760343748E7","1009.8058884468765"
"13370","45013","45004","3","45007","203823","9873.410625","0.128354338125","7.76872494449998E7","1009.9342427850014"
"13371","45007","45000","4","45004","203827","9872.7525","0.1283457825","7.76971221974998E7","1010.0625885675014"
"13372","45004","44997","4","45001","203831","9872.094374999999","0.128337226875","7.77069942918748E7","1010.1909257943764"
"13373","45001","45000","5","45005","203836","9872.971875","0.128348634375","7.77168672637498E7","1010.3192744287514"
"13374","45005","45002","6","45008","203842","9873.630000000001","0.12835719","7.772674089374979E7","1010.4476316187514"
"13375","45008","45005","2","45007","203844","9873.410625","0.128354338125","7.773661430437478E7","1010.5759859568764"
"13376","45007","44998","6","45004","203850","9872.7525","0.1283457825","7.774648705687478E7","1010.7043317393764"
"13377","45004","45000","1","45001","203851","9872.094374999999","0.128337226875","7.775635915124978E7","1010.8326689662514"
"13378","45001","44993","7","45000","203858","9871.875","0.128334375","7.776623102624978E7","1010.9610033412514"
"13379","45000","44998","7","45005","203865","9872.971875","0.128348634375","7.777610399812478E7","1011.0893519756264"
"13380","45005","44999","7","45006","203872","9873.19125","0.12835148624999998","7.778597718937477E7","1011.2177034618765"
"13381","45006","44973","549","45522","204421","9986.38875","0.12982305375","7.779596357812478E7","1011.3475265156264"
"13382","45522","45517","3","45520","204424","9985.95","0.12981735","7.780594952812478E7","1011.4773438656265"
"13383","45520","45517","2","45519","204426","9985.730625","0.12981449812499998","7.781593525874978E7","1011.6071583637515"
"13384","45519","45512","4","45516","204430","9985.072499999998","0.12980594249999997","7.782592033124979E7","1011.7369643062515"
"13385","45516","45514","8","45522","204438","9986.38875","0.12982305375","7.783590671999979E7","1011.8667873600015"
"13386","45522","45519","1","45520","204439","9985.95","0.12981735","7.78458926699998E7","1011.9966047100015"
"13387","45520","45518","3","45521","204442","9986.169375","0.12982020187499999","7.78558788393748E7","1012.1264249118765"
"13388","45521","45518","3","45521","204445","9986.169375","0.12982020187499999","7.78658650087498E7","1012.2562451137514"
"13389","45521","45518","8","45526","204453","9987.266249999999","0.12983446124999998","7.78758522749998E7","1012.3860795750014"
"13390","45526","45520","6","45526","204459","9987.266249999999","0.12983446124999998","7.78858395412498E7","1012.5159140362514"
"13391","45526","45521","4","45525","204463","9987.046875","0.129831609375","7.78958265881248E7","1012.6457456456263"
"13392","45525","45521","9","45530","204472","9988.14375","0.12984586874999998","7.79058147318748E7","1012.7755915143763"
"13393","45530","45521","7","45528","204479","9987.705","0.12984016499999998","7.791580243687479E7","1012.9054316793763"
"13394","45528","45526","9","45535","204488","9989.240625","0.129860128125","7.792579167749979E7","1013.0352918075013"
"13395","45535","45532","5","45537","204493","9989.679375","0.12986583187499998","7.793578135687478E7","1013.1651576393763"
"13396","45537","45535","3","45538","204496","9989.89875","0.12986868375","7.794577125562479E7","1013.2950263231263"
"13397","45538","45530","5","45535","204501","9989.240625","0.129860128125","7.795576049624978E7","1013.4248864512513"
"13398","45535","45526","3","45529","204504","9987.924375","0.129843016875","7.796574842062478E7","1013.5547294681263"
"13399","45529","45524","9","45533","204513","9988.801875000001","0.129854424375","7.797573722249977E7","1013.6845838925013"
"13400","45533","45532","3","45535","204516","9989.240625","0.129860128125","7.798572646312477E7","1013.8144440206263"
"13401","45535","45528","4","45532","204520","9988.5825","0.12985157249999998","7.799571504562476E7","1013.9442955931263"
"13402","45532","45529","8","45537","204528","9989.679375","0.12986583187499998","7.800570472499976E7","1014.0741614250013"
"13403","45537","45530","1","45531","204529","9988.363124999998","0.12984872062499997","7.801569308812475E7","1014.2040101456263"
"13404","45531","45527","6","45533","204535","9988.801875000001","0.129854424375","7.802568188999975E7","1014.3338645700013"
"13405","45533","45528","7","45535","204542","9989.240625","0.129860128125","7.803567113062474E7","1014.4637246981263"
"13406","45535","45533","3","45536","204545","9989.46","0.12986298","7.804566059062473E7","1014.5935876781263"
"13407","45536","45528","8","45536","204553","9989.46","0.12986298","7.805565005062473E7","1014.7234506581262"
"13408","45536","45530","8","45538","204561","9989.89875","0.12986868375","7.806563994937474E7","1014.8533193418763"
"13409","45538","45530","2","45532","204563","9988.5825","0.12985157249999998","7.807562853187473E7","1014.9831709143763"
"13410","45532","45524","1","45525","204564","9987.046875","0.129831609375","7.808561557874973E7","1015.1130025237512"
"13411","45525","45519","2","45521","204566","9986.169375","0.12982020187499999","7.809560174812473E7","1015.2428227256262"
"13412","45521","45515","1","45516","204567","9985.072499999998","0.12980594249999997","7.810558682062474E7","1015.3726286681261"
"13413","45516","45513","6","45519","204573","9985.730625","0.12981449812499998","7.811557255124974E7","1015.5024431662512"
"13414","45519","45516","5","45521","204578","9986.169375","0.12982020187499999","7.812555872062474E7","1015.6322633681261"
"13415","45521","45513","7","45520","204585","9985.95","0.12981735","7.813554467062475E7","1015.7620807181262"
"13416","45520","45518","7","45525","204592","9987.046875","0.129831609375","7.814553171749975E7","1015.8919123275011"
"13417","45525","45524","1","45525","204593","9987.046875","0.129831609375","7.815551876437475E7","1016.0217439368761"
"13418","45525","45516","9","45525","204602","9987.046875","0.129831609375","7.816550581124975E7","1016.151575546251"
"13419","45525","45516","6","45522","204608","9986.38875","0.12982305375","7.817549219999975E7","1016.281398600001"
"13420","45522","45521","5","45526","204613","9987.266249999999","0.12983446124999998","7.818547946624975E7","1016.411233061251"
"13421","45526","45517","4","45521","204617","9986.169375","0.12982020187499999","7.819546563562475E7","1016.541053263126"
"13422","45521","45513","2","45515","204619","9984.853125","0.12980309062499998","7.820545048874976E7","1016.670856353751"
"13423","45515","45508","4","45512","204623","9984.195","0.129794535","7.821543468374975E7","1016.800650888751"
"13424","45512","45510","3","45513","204626","9984.414375","0.129797386875","7.822541909812476E7","1016.930448275626"
"13425","45513","45506","7","45513","204633","9984.414375","0.129797386875","7.823540351249976E7","1017.060245662501"
"13426","45513","45505","7","45512","204640","9984.195","0.129794535","7.824538770749976E7","1017.1900401975009"
"13427","45512","45511","5","45516","204645","9985.072499999998","0.12980594249999997","7.825537277999976E7","1017.3198461400009"
"13428","45516","45510","8","45518","204653","9985.51125","0.12981164625","7.826535829124977E7","1017.4496577862509"
"13429","45518","45516","2","45518","204655","9985.51125","0.12981164625","7.827534380249977E7","1017.5794694325009"
"13430","45518","45517","6","45523","204661","9986.608125","0.129825905625","7.828533041062477E7","1017.7092953381259"
"13431","45523","45520","9","45529","204670","9987.924375","0.129843016875","7.829531833499977E7","1017.839138355001"
"13432","45529","45523","4","45527","204674","9987.485625","0.129837313125","7.830530582062477E7","1017.968975668126"
"13433","45527","45521","8","45529","204682","9987.924375","0.129843016875","7.831529374499977E7","1018.098818685001"
"13434","45529","45520","3","45523","204685","9986.608125","0.129825905625","7.832528035312477E7","1018.228644590626"
"13435","45523","45519","7","45526","204692","9987.266249999999","0.12983446124999998","7.833526761937477E7","1018.358479051876"
"13436","45526","45525","3","45528","204695","9987.705","0.12984016499999998","7.834525532437477E7","1018.488319216876"
"13437","45528","45522","6","45528","204701","9987.705","0.12984016499999998","7.835524302937476E7","1018.618159381876"
"13438","45528","45527","6","45533","204707","9988.801875000001","0.129854424375","7.836523183124976E7","1018.748013806251"
"13439","45533","45525","8","45533","204715","9988.801875000001","0.129854424375","7.837522063312475E7","1018.8778682306261"
"13440","45533","45526","1","45527","204716","9987.485625","0.129837313125","7.838520811874975E7","1019.0077055437511"
"13441","45527","45506","989","46495","205705","10199.840625","0.13259792812500001","7.839540795937476E7","1019.1403034718761"
"13442","46495","46490","5","46495","205710","10199.840625","0.13259792812500001","7.840560779999976E7","1019.2729014000012"
"13443","46495","46494","7","46501","205717","10201.156874999999","0.13261503937499997","7.841580895687476E7","1019.4055164393761"
"13444","46501","46499","7","46506","205724","10202.253749999998","0.13262929874999996","7.842601121062475E7","1019.5381457381261"
"13445","46506","46505","7","46512","205731","10203.57","0.13264641","7.843621478062475E7","1019.6707921481261"
"13446","46512","46508","7","46515","205738","10204.228125","0.13265496562499998","7.844641900874975E7","1019.8034471137511"
"13447","46515","46508","1","46509","205739","10202.911875000002","0.132637854375","7.845662192062475E7","1019.9360849681261"
"13448","46509","46501","5","46506","205744","10202.253749999998","0.13262929874999996","7.846682417437474E7","1020.0687142668761"
"13449","46506","46502","7","46509","205751","10202.911875000002","0.132637854375","7.847702708624974E7","1020.2013521212511"
"13450","46509","46506","8","46514","205759","10204.00875","0.13265211375","7.848723109499975E7","1020.3340042350012"
"13451","46514","46512","4","46516","205763","10204.447499999998","0.13265781749999997","7.849743554249975E7","1020.4666620525012"
"13452","46516","46510","4","46514","205767","10204.00875","0.13265211375","7.850763955124976E7","1020.5993141662512"
"13453","46514","46506","9","46515","205776","10204.228125","0.13265496562499998","7.851784377937476E7","1020.7319691318762"
"13454","46515","46514","7","46521","205783","10205.544375","0.132672076875","7.852804932374977E7","1020.8646412087512"
"13455","46521","46514","1","46515","205784","10204.228125","0.13265496562499998","7.853825355187477E7","1020.9972961743762"
"13456","46515","46511","2","46513","205786","10203.789375","0.132649261875","7.854845734124978E7","1021.1299454362512"
"13457","46513","46512","7","46519","205793","10205.105625","0.132666373125","7.855866244687478E7","1021.2626118093762"
"13458","46519","46514","4","46518","205797","10204.88625","0.13266352125","7.856886733312479E7","1021.3952753306262"
"13459","46518","46512","3","46515","205800","10204.228125","0.13265496562499998","7.85790715612498E7","1021.5279302962512"
"13460","46515","46506","5","46511","205805","10203.350625","0.13264355812499998","7.858927491187479E7","1021.6605738543761"
"13461","46511","46505","2","46507","205807","10202.473125","0.132632150625","7.859947738499978E7","1021.7932060050011"
"13462","46507","46498","8","46506","205815","10202.253749999998","0.13262929874999996","7.860967963874978E7","1021.9258353037511"
"13463","46506","46498","1","46499","205816","10200.718125000001","0.13260933562500002","7.861988035687478E7","1022.0584446393761"
"13464","46499","46495","1","46496","205817","10200.06","0.13260077999999997","7.863008041687478E7","1022.1910454193761"
"13465","46496","46495","4","46499","205821","10200.718125000001","0.13260933562500002","7.864028113499978E7","1022.3236547550011"
"13466","46499","46490","5","46495","205826","10199.840625","0.13259792812500001","7.865048097562478E7","1022.4562526831262"
"13467","46495","46493","2","46495","205828","10199.840625","0.13259792812500001","7.866068081624979E7","1022.5888506112512"
"13468","46495","46490","1","46491","205829","10198.963124999998","0.13258652062499998","7.86708797793748E7","1022.7214371318762"
"13469","46491","46488","5","46493","205834","10199.401875","0.13259222437499998","7.86810791812498E7","1022.8540293562512"
"13470","46493","46490","5","46495","205839","10199.840625","0.13259792812500001","7.86912790218748E7","1022.9866272843763"
"13471","46495","46491","7","46498","205846","10200.49875","0.13260648375","7.87014795206248E7","1023.1192337681263"
"13472","46498","46495","5","46500","205851","10200.9375","0.13261218749999998","7.87116804581248E7","1023.2518459556262"
"13473","46500","46494","3","46497","205854","10200.279375","0.132603631875","7.87218807374998E7","1023.3844495875012"
"13474","46497","46491","7","46498","205861","10200.49875","0.13260648375","7.87320812362498E7","1023.5170560712512"
"13475","46498","46489","4","46493","205865","10199.401875","0.13259222437499998","7.874228063812481E7","1023.6496482956262"
"13476","46493","46486","8","46494","205873","10199.62125","0.13259507625","7.875248025937481E7","1023.7822433718762"
"13477","46494","46492","5","46497","205878","10200.279375","0.132603631875","7.876268053874981E7","1023.9148470037512"
"13478","46497","46492","9","46501","205887","10201.156874999999","0.13261503937499997","7.877288169562481E7","1024.0474620431262"
"13479","46501","46499","6","46505","205893","10202.034375","0.13262644687499997","7.878308372999981E7","1024.1800884900013"
"13480","46505","46502","2","46504","205895","10201.815","0.132623595","7.879328554499981E7","1024.3127120850013"
"13481","46504","46496","4","46500","205899","10200.9375","0.13261218749999998","7.880348648249981E7","1024.4453242725012"
"13482","46500","46495","2","46497","205901","10200.279375","0.132603631875","7.881368676187481E7","1024.5779279043763"
"13483","46497","46488","2","46490","205903","10198.74375","0.13258366875","7.882388550562482E7","1024.7105115731263"
"13484","46490","46488","9","46497","205912","10200.279375","0.132603631875","7.883408578499982E7","1024.8431152050014"
"13485","46497","46490","8","46498","205920","10200.49875","0.13260648375","7.884428628374982E7","1024.9757216887513"
"13486","46498","46493","6","46499","205926","10200.718125000001","0.13260933562500002","7.885448700187482E7","1025.1083310243762"
"13487","46499","46491","7","46498","205933","10200.49875","0.13260648375","7.886468750062482E7","1025.240937508126"
"13488","46498","46492","7","46499","205940","10200.718125000001","0.13260933562500002","7.887488821874982E7","1025.373546843751"
"13489","46499","46496","5","46501","205945","10201.156874999999","0.13261503937499997","7.888508937562482E7","1025.506161883126"
"13490","46501","46493","5","46498","205950","10200.49875","0.13260648375","7.889528987437482E7","1025.6387683668759"
"13491","46498","46491","5","46496","205955","10200.06","0.13260077999999997","7.890548993437482E7","1025.771369146876"
"13492","46496","46494","3","46497","205958","10200.279375","0.132603631875","7.891569021374983E7","1025.903972778751"
"13493","46497","46488","4","46492","205962","10199.182499999999","0.13258937249999997","7.892588939624983E7","1026.036562151251"
"13494","46492","46483","8","46491","205970","10198.963124999998","0.13258652062499998","7.893608835937484E7","1026.169148671876"
"13495","46491","46483","3","46486","205973","10197.86625","0.13257226125","7.894628622562483E7","1026.301720933126"
"13496","46486","46478","1","46479","205974","10196.330625","0.132552298125","7.895648255624983E7","1026.434273231251"
"13497","46479","46474","4","46478","205978","10196.11125","0.13254944624999998","7.896667866749983E7","1026.566822677501"
"13498","46478","46471","4","46475","205982","10195.453125","0.132540890625","7.897687412062483E7","1026.699363568126"
"13499","46475","46471","1","46472","205983","10194.795","0.132532335","7.898706891562483E7","1026.831895903126"
"13500","46472","46470","7","46477","205990","10195.891875","0.132546594375","7.899726480749983E7","1026.964442497501"
"13501","46477","46477","100000","146477","305990","32133.391875","0.417734094375","7.902939819937482E7","1027.382176591876"
"13502","146477","146475","7","146482","305997","32134.488750000004","0.41774835375","7.906153268812482E7","1027.7999249456261"
"13503","146482","146474","6","146480","306003","32134.05","0.41774264999999994","7.909366673812482E7","1028.2176675956262"
"13504","146480","146474","3","146477","306006","32133.391875","0.417734094375","7.912580012999982E7","1028.6354016900011"
"13505","146477","146475","1","146476","306007","32133.172499999997","0.41773124249999993","7.915793330249982E7","1029.053132932501"
"13506","146476","146469","9","146478","306016","32133.61125","0.41773694625","7.919006691374981E7","1029.470869878751"
"13507","146478","146472","9","146481","306025","32134.269375","0.417745501875","7.922220118312481E7","1029.888615380626"
"13508","146481","146473","5","146478","306030","32133.61125","0.41773694625","7.925433479437481E7","1030.306352326876"
"13509","146478","146474","5","146479","306035","32133.830625","0.41773979812499995","7.92864686249998E7","1030.724092125001"
"13510","146479","146473","1","146474","306036","32132.73375","0.41772553874999996","7.93186013587498E7","1031.141817663751"
"13511","146474","146466","7","146473","306043","32132.514375000002","0.417722686875","7.935073387312481E7","1031.559540350626"
"13512","146473","146469","6","146475","306049","32132.953125","0.417728390625","7.938286682624981E7","1031.977268741251"
"13513","146475","146467","8","146475","306057","32132.953125","0.417728390625","7.941499977937481E7","1032.394997131876"
"13514","146475","146474","7","146481","306064","32134.269375","0.417745501875","7.94471340487498E7","1032.812742633751"
"13515","146481","146477","5","146482","306069","32134.488750000004","0.41774835375","7.94792685374998E7","1033.230490987501"
"13516","146482","146473","6","146479","306075","32133.830625","0.41773979812499995","7.95114023681248E7","1033.648230785626"
"13517","146479","146472","3","146475","306078","32132.953125","0.417728390625","7.95435353212498E7","1034.065959176251"
"13518","146475","146466","5","146471","306083","32132.075624999998","0.41771698312499994","7.95756673968748E7","1034.483676159376"
"13519","146471","146462","8","146470","306091","32131.85625","0.41771413125","7.96077992531248E7","1034.901390290626"
"13520","146470","146466","3","146469","306094","32131.636875","0.41771127937499997","7.96399308899998E7","1035.319101570001"
"13521","146469","146464","8","146472","306102","32132.295","0.41771983499999993","7.967206318499981E7","1035.7368214050011"
"13522","146472","146463","5","146468","306107","32131.4175","0.4177084275","7.970419460249981E7","1036.154529832501"
"13523","146468","146459","7","146466","306114","32130.97875","0.41770272374999995","7.973632558124982E7","1036.572232556251"
"13524","146466","146462","2","146464","306116","32130.539999999997","0.4176970199999999","7.976845612124982E7","1036.9899295762511"
"13525","146464","146458","5","146463","306121","32130.320625","0.417694168125","7.980058644187483E7","1037.4076237443762"
"13526","146463","146462","7","146469","306128","32131.636875","0.41771127937499997","7.983271807874984E7","1037.8253350237512"
"13527","146469","146461","6","146467","306134","32131.198125000003","0.417705575625","7.986484927687484E7","1038.2430405993762"
"13528","146467","146460","2","146462","306136","32130.10125","0.41769131624999994","7.989697937812483E7","1038.6607319156262"
"13529","146462","146460","2","146462","306138","32130.10125","0.41769131624999994","7.992910947937483E7","1039.0784232318763"
"13530","146462","146455","4","146459","306142","32129.443124999998","0.4176827606249999","7.996123892249982E7","1039.4961059925013"
"13531","146459","146451","3","146454","306145","32128.34625","0.41766850124999993","7.999336726874982E7","1039.9137744937514"
"13532","146454","146450","5","146455","306150","32128.565625","0.417671353125","8.002549583437482E7","1040.3314458468762"
"13533","146455","146449","8","146457","306158","32129.004375000004","0.417677056875","8.005762483874981E7","1040.7491229037512"
"13534","146457","146453","9","146462","306167","32130.10125","0.41769131624999994","8.00897549399998E7","1041.1668142200012"
"13535","146462","146453","8","146461","306175","32129.881875","0.41768846437499996","8.01218848218748E7","1041.5845026843763"
"13536","146461","146453","1","146454","306176","32128.34625","0.41766850124999993","8.01540131681248E7","1042.0021711856264"
"13537","146454","146448","1","146449","306177","32127.249375","0.41765424187499994","8.01861404174998E7","1042.4198254275013"
"13538","146449","146440","6","146446","306183","32126.591249999998","0.4176456862499999","8.02182670087498E7","1042.8374711137512"
"13539","146446","146438","9","146447","306192","32126.810625","0.41764853812499997","8.02503938193748E7","1043.2551196518762"
"13540","146447","146442","3","146445","306195","32126.371875","0.417642834375","8.02825201912498E7","1043.6727624862513"
"13541","146445","146438","8","146446","306203","32126.591249999998","0.4176456862499999","8.03146467824998E7","1044.0904081725012"
"13542","146446","146438","3","146441","306206","32125.494375","0.41763142687499993","8.034677227687481E7","1044.5080395993762"
"13543","146441","146436","4","146440","306210","32125.275","0.417628575","8.037889755187482E7","1044.9256681743761"
"13544","146440","146432","8","146440","306218","32125.275","0.417628575","8.041102282687482E7","1045.3432967493761"
"13545","146440","146436","9","146445","306227","32126.371875","0.417642834375","8.044314919874983E7","1045.7609395837512"
"13546","146445","146441","6","146447","306233","32126.810625","0.41764853812499997","8.047527600937483E7","1046.1785881218761"
"13547","146447","146446","6","146452","306239","32127.9075","0.4176627975","8.050740391687483E7","1046.5962509193762"
"13548","146452","146444","8","146452","306247","32127.9075","0.4176627975","8.053953182437482E7","1047.0139137168762"
"13549","146452","146446","3","146449","306250","32127.249375","0.41765424187499994","8.057165907374983E7","1047.4315679587512"
"13550","146449","146448","8","146456","306258","32128.785","0.41767420499999997","8.060378785874982E7","1047.8492421637511"
"13551","146456","146455","5","146460","306263","32129.6625","0.41768561249999997","8.063591752124982E7","1048.2669277762511"
"13552","146460","146457","3","146460","306266","32129.6625","0.41768561249999997","8.066804718374981E7","1048.6846133887511"
"13553","146460","146455","9","146464","306275","32130.539999999997","0.4176970199999999","8.070017772374982E7","1049.1023104087512"
"13554","146464","146460","6","146466","306281","32130.97875","0.41770272374999995","8.073230870249982E7","1049.5200131325012"
"13555","146466","146461","5","146466","306286","32130.97875","0.41770272374999995","8.076443968124983E7","1049.937715856251"
"13556","146466","146459","6","146465","306292","32130.759375","0.417699871875","8.079657044062483E7","1050.355415728126"
"13557","146465","146460","8","146468","306300","32131.4175","0.4177084275","8.082870185812484E7","1050.773124155626"
"13558","146468","146464","4","146468","306304","32131.4175","0.4177084275","8.086083327562484E7","1051.190832583126"
"13559","146468","146463","5","146468","306309","32131.4175","0.4177084275","8.089296469312485E7","1051.608541010626"
"13560","146468","146467","4","146471","306313","32132.075624999998","0.41771698312499994","8.092509676874985E7","1052.026257993751"
"13561","146471","146430","943","147373","307256","32329.951875000002","0.420289374375","8.095742672062485E7","1052.446547368126"
"13562","147373","147365","7","147372","307263","32329.7325","0.4202865224999999","8.098975645312485E7","1052.866833890626"
"13563","147372","147371","6","147377","307269","32330.829375","0.420300781875","8.102208728249985E7","1053.287134672501"
"13564","147377","147369","5","147374","307274","32330.17125","0.42029222624999996","8.105441745374985E7","1053.707426898751"
"13565","147374","147373","4","147377","307278","32330.829375","0.420300781875","8.108674828312485E7","1054.127727680626"
"13566","147377","147369","5","147374","307283","32330.17125","0.42029222624999996","8.111907845437485E7","1054.548019906876"
"13567","147374","147367","6","147373","307289","32329.951875000002","0.420289374375","8.115140840624985E7","1054.968309281251"
"13568","147373","147364","6","147370","307295","32329.29375","0.42028081875","8.118373769999985E7","1055.388590100001"
"13569","147370","147367","2","147369","307297","32329.074375","0.42027796687499996","8.121606677437486E7","1055.808868066876"
"13570","147369","147365","7","147372","307304","32329.7325","0.4202865224999999","8.124839650687486E7","1056.2291545893759"
"13571","147372","147363","7","147370","307311","32329.29375","0.42028081875","8.128072580062486E7","1056.6494354081258"
"13572","147370","147366","9","147375","307320","32330.390625","0.420295078125","8.131305619124986E7","1057.0697304862508"
"13573","147375","147374","1","147375","307321","32330.390625","0.420295078125","8.134538658187486E7","1057.4900255643759"
"13574","147375","147370","5","147375","307326","32330.390625","0.420295078125","8.137771697249986E7","1057.910320642501"
"13575","147375","147373","4","147377","307330","32330.829375","0.420300781875","8.141004780187486E7","1058.330621424376"
"13576","147377","147375","3","147378","307333","32331.04875","0.42030363375","8.144237885062486E7","1058.750925058126"
"13577","147378","147377","9","147386","307342","32332.80375","0.42032644874999997","8.147471165437485E7","1059.1712515068762"
"13578","147386","147385","1","147386","307343","32332.80375","0.42032644874999997","8.150704445812485E7","1059.5915779556262"
"13579","147386","147378","5","147383","307348","32332.145625","0.420317893125","8.153937660374984E7","1060.0118958487512"
"13580","147383","147381","7","147388","307355","32333.2425","0.4203321525","8.157170984624985E7","1060.4322280012511"
"13581","147388","147382","7","147389","307362","32333.461874999997","0.42033500437499993","8.160404330812486E7","1060.852563005626"
"13582","147389","147386","8","147394","307370","32334.55875","0.42034926375","8.163637786687486E7","1061.272912269376"
"13583","147394","147389","4","147393","307374","32334.339375","0.420346411875","8.166871220624986E7","1061.693258681251"
"13584","147393","147390","1","147391","307375","32333.900625","0.42034070812499996","8.170104610687487E7","1062.113599389376"
"13585","147391","147389","3","147392","307378","32334.120000000003","0.42034356","8.173338022687487E7","1062.533942949376"
"13586","147392","147384","4","147388","307382","32333.2425","0.4203321525","8.176571346937488E7","1062.954275101876"
"13587","147388","147387","9","147396","307391","32334.997499999998","0.42035496749999995","8.179804846687488E7","1063.374630069376"
"13588","147396","147394","4","147398","307395","32335.436250000002","0.42036067125","8.183038390312488E7","1063.794990740626"
"13589","147398","147391","4","147395","307399","32334.778125","0.42035211562499997","8.186271868124989E7","1064.215342856251"
"13590","147395","147387","3","147390","307402","32333.68125","0.42033785625","8.18950523624999E7","1064.635680712501"
"13591","147390","147386","2","147388","307404","32333.2425","0.4203321525","8.19273856049999E7","1065.0560128650009"
"13592","147388","147383","6","147389","307410","32333.461874999997","0.42033500437499993","8.19597190668749E7","1065.4763478693758"
"13593","147389","147382","9","147391","307419","32333.900625","0.42034070812499996","8.199205296749991E7","1065.8966885775008"
"13594","147391","147387","2","147389","307421","32333.461874999997","0.42033500437499993","8.202438642937492E7","1066.3170235818757"
"13595","147389","147383","9","147392","307430","32334.120000000003","0.42034356","8.205672054937492E7","1066.7373671418757"
"13596","147392","147384","9","147393","307439","32334.339375","0.420346411875","8.208905488874993E7","1067.1577135537507"
"13597","147393","147386","7","147393","307446","32334.339375","0.420346411875","8.212138922812493E7","1067.5780599656257"
"13598","147393","147384","4","147388","307450","32333.2425","0.4203321525","8.215372247062494E7","1067.9983921181256"
"13599","147388","147381","3","147384","307453","32332.364999999998","0.42032074499999994","8.218605483562493E7","1068.4187128631256"
"13600","147384","147376","4","147380","307457","32331.4875","0.4203093375","8.221838632312493E7","1068.8390222006255"
"13601","147380","147378","2","147380","307459","32331.4875","0.4203093375","8.225071781062493E7","1069.2593315381255"
"13602","147380","147376","1","147377","307460","32330.829375","0.420300781875","8.228304863999993E7","1069.6796323200006"
"13603","147377","147368","3","147371","307463","32329.513124999998","0.42028367062499994","8.231537815312493E7","1070.0999159906255"
"13604","147371","147368","6","147374","307469","32330.17125","0.42029222624999996","8.234770832437493E7","1070.5202082168755"
"13605","147374","147369","2","147371","307471","32329.513124999998","0.42028367062499994","8.238003783749993E7","1070.9404918875005"
"13606","147371","147364","7","147371","307478","32329.513124999998","0.42028367062499994","8.241236735062493E7","1071.3607755581254"
"13607","147371","147369","1","147370","307479","32329.29375","0.42028081875","8.244469664437494E7","1071.7810563768753"
"13608","147370","147363","3","147366","307482","32328.41625","0.42026941124999995","8.247702506062494E7","1072.2013257881254"
"13609","147366","147361","7","147368","307489","32328.855","0.420275115","8.250935391562495E7","1072.6216009031255"
"13610","147368","147364","8","147372","307497","32329.7325","0.4202865224999999","8.254168364812495E7","1073.0418874256254"
"13611","147372","147364","4","147368","307501","32328.855","0.420275115","8.257401250312495E7","1073.4621625406255"
"13612","147368","147366","5","147371","307506","32329.513124999998","0.42028367062499994","8.260634201624995E7","1073.8824462112505"
"13613","147371","147367","6","147373","307512","32329.951875000002","0.420289374375","8.263867196812496E7","1074.3027355856254"
"13614","147373","147370","2","147372","307514","32329.7325","0.4202865224999999","8.267100170062496E7","1074.7230221081254"
"13615","147372","147364","6","147370","307520","32329.29375","0.42028081875","8.270333099437496E7","1075.1433029268753"
"13616","147370","147368","9","147377","307529","32330.829375","0.420300781875","8.273566182374996E7","1075.5636037087504"
"13617","147377","147373","2","147375","307531","32330.390625","0.420295078125","8.276799221437496E7","1075.9838987868754"
"13618","147375","147366","2","147368","307533","32328.855","0.420275115","8.280032106937496E7","1076.4041739018755"
"13619","147368","147366","8","147374","307541","32330.17125","0.42029222624999996","8.283265124062496E7","1076.8244661281256"
"13620","147374","147368","4","147372","307545","32329.7325","0.4202865224999999","8.286498097312497E7","1077.2447526506255"
"13621","147372","147350","948","148298","308493","32532.873750000002","0.42292735875","8.289751384687497E7","1077.6676800093755"
"13622","148298","148291","5","148296","308498","32532.434999999998","0.42292165499999995","8.293004628187497E7","1078.0906016643755"
"13623","148296","148288","3","148291","308501","32531.338125","0.42290739562499996","8.296257761999997E7","1078.5135090600006"
"13624","148291","148286","8","148294","308509","32531.99625","0.42291595125","8.299510961624998E7","1078.9364250112505"
"13625","148294","148285","6","148291","308515","32531.338125","0.42290739562499996","8.302764095437498E7","1079.3593324068756"
"13626","148291","148289","5","148294","308520","32531.99625","0.42291595125","8.306017295062499E7","1079.7822483581256"
"13627","148294","148289","8","148297","308528","32532.654375","0.42292450687499994","8.309270560499999E7","1080.2051728650006"
"13628","148297","148290","1","148291","308529","32531.338125","0.42290739562499996","8.3125236943125E7","1080.6280802606257"
"13629","148291","148282","2","148284","308531","32529.802499999998","0.42288743249999994","8.315776674562499E7","1081.0509676931256"
"13630","148284","148276","6","148282","308537","32529.363750000004","0.42288172875","8.319029610937499E7","1081.4738494218757"
"13631","148282","148274","9","148283","308546","32529.583125","0.422884580625","8.322282569249998E7","1081.8967340025006"
"13632","148283","148280","1","148281","308547","32529.144374999993","0.42287887687499986","8.325535483687498E7","1082.3196128793757"
"13633","148281","148276","7","148283","308554","32529.583125","0.422884580625","8.328788441999997E7","1082.7424974600005"
"13634","148283","148278","6","148284","308560","32529.802499999998","0.42288743249999994","8.332041422249997E7","1083.1653848925005"
"13635","148284","148279","8","148287","308568","32530.460625","0.42289598812499996","8.335294468312496E7","1083.5882808806255"
"13636","148287","148281","8","148289","308576","32530.899374999997","0.42290169187499993","8.338547558249997E7","1084.0111825725005"
"13637","148289","148284","6","148290","308582","32531.11875","0.42290454375","8.341800670124997E7","1084.4340871162506"
"13638","148290","148289","5","148294","308587","32531.99625","0.42291595125","8.345053869749998E7","1084.8570030675005"
"13639","148294","148285","6","148291","308593","32531.338125","0.42290739562499996","8.348307003562498E7","1085.2799104631256"
"13640","148291","148287","2","148289","308595","32530.899374999997","0.42290169187499993","8.351560093499999E7","1085.7028121550006"
"13641","148289","148285","7","148292","308602","32531.557500000003","0.4229102475","8.354813249249999E7","1086.1257224025007"
"13642","148292","148285","6","148291","308608","32531.338125","0.42290739562499996","8.3580663830625E7","1086.5486297981258"
"13643","148291","148286","2","148288","308610","32530.68","0.42289884","8.3613194510625E7","1086.9715286381258"
"13644","148288","148283","4","148287","308614","32530.460625","0.42289598812499996","8.364572497125E7","1087.3944246262508"
"13645","148287","148282","6","148288","308620","32530.68","0.42289884","8.367825565125E7","1087.8173234662509"
"13646","148288","148279","6","148285","308626","32530.021875","0.422890284375","8.3710785673125E7","1088.2402137506258"
"13647","148285","148278","4","148282","308630","32529.363750000004","0.42288172875","8.3743315036875E7","1088.663095479376"
"13648","148282","148279","3","148282","308633","32529.363750000004","0.42288172875","8.377584440062499E7","1089.085977208126"
"13649","148282","148279","7","148286","308640","32530.24125","0.42289313624999997","8.380837464187498E7","1089.508870344376"
"13650","148286","148281","2","148283","308642","32529.583125","0.422884580625","8.384090422499998E7","1089.9317549250009"
"13651","148283","148279","6","148285","308648","32530.021875","0.422890284375","8.387343424687497E7","1090.3546452093758"
"13652","148285","148277","9","148286","308657","32530.24125","0.42289313624999997","8.390596448812497E7","1090.7775383456258"
"13653","148286","148277","4","148281","308661","32529.144374999993","0.42287887687499986","8.393849363249996E7","1091.2004172225008"
"13654","148281","148273","4","148277","308665","32528.266875","0.42286746937499997","8.397102189937496E7","1091.6232846918758"
"13655","148277","148269","3","148272","308668","32527.17","0.4228532099999999","8.400354906937496E7","1092.046137901876"
"13656","148272","148269","9","148278","308677","32528.48625","0.42287032125","8.403607755562496E7","1092.469008223126"
"13657","148278","148272","4","148276","308681","32528.047499999997","0.42286461749999993","8.406860560312496E7","1092.8918728406259"
"13658","148276","148272","8","148280","308689","32528.925","0.422876025","8.410113452812496E7","1093.314748865626"
"13659","148280","148279","5","148284","308694","32529.802499999998","0.42288743249999994","8.413366433062495E7","1093.7376362981258"
"13660","148284","148275","6","148281","308700","32529.144374999993","0.42287887687499986","8.416619347499995E7","1094.160515175001"
"13661","148281","148272","2","148274","308702","32527.60875","0.42285891374999995","8.419872108374995E7","1094.5833740887508"
"13662","148274","148270","4","148274","308706","32527.60875","0.42285891374999995","8.423124869249995E7","1095.0062330025007"
"13663","148274","148269","5","148274","308711","32527.60875","0.42285891374999995","8.426377630124995E7","1095.4290919162506"
"13664","148274","148265","3","148268","308714","32526.2925","0.4228418025","8.429630259374996E7","1095.8519337187506"
"13665","148268","148263","8","148271","308722","32526.950624999998","0.42285035812499994","8.432882954437496E7","1096.2747840768757"
"13666","148271","148270","2","148272","308724","32527.17","0.4228532099999999","8.436135671437496E7","1096.6976372868758"
"13667","148272","148264","8","148272","308732","32527.17","0.4228532099999999","8.439388388437496E7","1097.1204904968758"
"13668","148272","148266","8","148274","308740","32527.60875","0.42285891374999995","8.442641149312496E7","1097.5433494106258"
"13669","148274","148266","3","148269","308743","32526.511875","0.42284465437499996","8.445893800499997E7","1097.9661940650008"
"13670","148269","148263","1","148264","308744","32525.414999999997","0.4228303949999999","8.449146341999997E7","1098.3890244600007"
"13671","148264","148255","9","148264","308753","32525.414999999997","0.4228303949999999","8.452398883499998E7","1098.8118548550005"
"13672","148264","148262","6","148268","308759","32526.2925","0.4228418025","8.455651512749998E7","1099.2346966575005"
"13673","148268","148261","3","148264","308762","32525.414999999997","0.4228303949999999","8.458904054249999E7","1099.6575270525004"
"13674","148264","148258","3","148261","308765","32524.756875","0.42282183937499995","8.462156529937498E7","1100.0803488918755"
"13675","148261","148254","9","148263","308774","32525.195625","0.422827543125","8.465409049499999E7","1100.5031764350006"
"13676","148263","148254","8","148262","308782","32524.97625","0.42282469125","8.468661547124998E7","1100.9260011262506"
"13677","148262","148255","2","148257","308784","32523.879375000004","0.422810431875","8.471913935062498E7","1101.3488115581256"
"13678","148257","148256","4","148260","308788","32524.5375","0.42281898749999997","8.475166388812497E7","1101.7716305456256"
"13679","148260","148254","4","148258","308792","32524.09875","0.42281328375","8.478418798687497E7","1102.1944438293756"
"13680","148258","148251","7","148258","308799","32524.09875","0.42281328375","8.481671208562496E7","1102.6172571131256"
"13681","148258","148216","506","148722","309305","32625.88875","0.42413655375","8.484933797437496E7","1103.0413936668756"
"13682","148722","148714","4","148718","309309","32625.01125","0.42412514625","8.488196298562497E7","1103.4655188131255"
"13683","148718","148713","2","148715","309311","32624.353125","0.424116590625","8.491458733874997E7","1103.8896354037506"
"13684","148715","148713","3","148716","309314","32624.5725","0.42411944249999994","8.494721191124998E7","1104.3137548462505"
"13685","148716","148711","6","148717","309320","32624.791875000003","0.424122294375","8.497983670312499E7","1104.7378771406254"
"13686","148717","148715","9","148724","309329","32626.3275","0.42414225749999995","8.501246303062499E7","1105.1620193981255"
"13687","148724","148718","5","148723","309334","32626.108125000002","0.424139405625","8.504508913874999E7","1105.5861588037505"
"13688","148723","148719","7","148726","309341","32626.766249999997","0.4241479612499999","8.507771590499999E7","1106.0103067650005"
"13689","148726","148723","7","148730","309348","32627.64375","0.42415936875","8.511034354874998E7","1106.4344661337504"
"13690","148730","148723","2","148725","309350","32626.546875","0.424145109375","8.514297009562498E7","1106.8586112431256"
"13691","148725","148716","3","148719","309353","32625.230625","0.42412799812499996","8.517559532624999E7","1107.2827392412505"
"13692","148719","148716","3","148719","309356","32625.230625","0.42412799812499996","8.520822055687499E7","1107.7068672393755"
"13693","148719","148717","9","148726","309365","32626.766249999997","0.4241479612499999","8.524084732312499E7","1108.1310152006254"
"13694","148726","148720","4","148724","309369","32626.3275","0.42414225749999995","8.527347365062499E7","1108.5551574581254"
"13695","148724","148719","1","148720","309370","32625.45","0.42413085","8.5306099100625E7","1108.9792883081254"
"13696","148720","148713","9","148722","309379","32625.88875","0.42413655375","8.5338724989375E7","1109.4034248618755"
"13697","148722","148713","1","148714","309380","32624.133749999997","0.4241137387499999","8.5371349123125E7","1109.8275386006255"
"13698","148714","148712","6","148718","309386","32625.01125","0.42412514625","8.5403974134375E7","1110.2516637468755"
"13699","148718","148712","8","148720","309394","32625.45","0.42413085","8.543659958437501E7","1110.6757945968754"
"13700","148720","148715","8","148723","309402","32626.108125000002","0.424139405625","8.546922569250001E7","1111.0999340025005"
"13701","148723","148721","1","148722","309403","32625.88875","0.42413655375","8.550185158125001E7","1111.5240705562505"
"13702","148722","148719","1","148720","309404","32625.45","0.42413085","8.553447703125001E7","1111.9482014062505"
"13703","148720","148712","4","148716","309408","32624.5725","0.42411944249999994","8.556710160375002E7","1112.3723208487504"
"13704","148716","148707","4","148711","309412","32623.475625","0.42410518312499995","8.559972507937501E7","1112.7964260318754"
"13705","148711","148707","8","148715","309420","32624.353125","0.424116590625","8.563234943250002E7","1113.2205426225005"
"13706","148715","148706","4","148710","309424","32623.25625","0.42410233124999996","8.566497268875001E7","1113.6446449537505"
"13707","148710","148701","8","148709","309432","32623.036874999998","0.4240994793749999","8.569759572562501E7","1114.0687444331254"
"13708","148709","148708","9","148717","309441","32624.791875000003","0.424122294375","8.573022051750001E7","1114.4928667275003"
"13709","148717","148711","5","148716","309446","32624.5725","0.42411944249999994","8.576284509000002E7","1114.9169861700002"
"13710","148716","148710","5","148715","309451","32624.353125","0.424116590625","8.579546944312502E7","1115.3411027606253"
"13711","148715","148712","9","148721","309460","32625.669374999998","0.42413370187499994","8.582809511250003E7","1115.7652364625003"
"13712","148721","148717","3","148720","309463","32625.45","0.42413085","8.586072056250003E7","1116.1893673125003"
"13713","148720","148715","9","148724","309472","32626.3275","0.42414225749999995","8.589334689000003E7","1116.6135095700004"
"13714","148724","148717","5","148722","309477","32625.88875","0.42413655375","8.592597277875003E7","1117.0376461237504"
"13715","148722","148719","6","148725","309483","32626.546875","0.424145109375","8.595859932562503E7","1117.4617912331255"
"13716","148725","148719","7","148726","309490","32626.766249999997","0.4241479612499999","8.599122609187503E7","1117.8859391943754"
"13717","148726","148721","5","148726","309495","32626.766249999997","0.4241479612499999","8.602385285812503E7","1118.3100871556253"
"13718","148726","148718","2","148720","309497","32625.45","0.42413085","8.605647830812503E7","1118.7342180056253"
"13719","148720","148716","7","148723","309504","32626.108125000002","0.424139405625","8.608910441625004E7","1119.1583574112503"
"13720","148723","148715","7","148722","309511","32625.88875","0.42413655375","8.612173030500004E7","1119.5824939650004"
"13721","148722","148720","6","148726","309517","32626.766249999997","0.4241479612499999","8.615435707125004E7","1120.0066419262503"
"13722","148726","148720","8","148728","309525","32627.205","0.424153665","8.618698427625003E7","1120.4307955912502"
"13723","148728","148725","5","148730","309530","32627.64375","0.42415936875","8.621961192000003E7","1120.8549549600002"
"13724","148730","148725","6","148731","309536","32627.863124999993","0.42416222062499986","8.625223978312503E7","1121.2791171806252"
"13725","148731","148730","7","148737","309543","32629.179375","0.42417933187499995","8.628486896250002E7","1121.7032965125002"
"13726","148737","148733","6","148739","309549","32629.618124999997","0.42418503562499993","8.631749858062503E7","1122.1274815481252"
"13727","148739","148730","9","148739","309558","32629.618124999997","0.42418503562499993","8.635012819875003E7","1122.5516665837501"
"13728","148739","148730","8","148738","309566","32629.39875","0.42418218375","8.638275759750004E7","1122.9758487675"
"13729","148738","148731","2","148733","309568","32628.301875","0.424167924375","8.641538589937504E7","1123.4000166918752"
"13730","148733","148728","1","148729","309569","32627.424375","0.42415651687499994","8.644801332375003E7","1123.8241732087502"
"13731","148729","148722","4","148726","309573","32626.766249999997","0.4241479612499999","8.648064009000003E7","1124.24832117"
"13732","148726","148720","7","148727","309580","32626.985625","0.42415081312499997","8.651326707562503E7","1124.672471983125"
"13733","148727","148726","7","148733","309587","32628.301875","0.424167924375","8.654589537750003E7","1125.0966399075"
"13734","148733","148728","3","148731","309590","32627.863124999993","0.42416222062499986","8.657852324062502E7","1125.520802128125"
"13735","148731","148723","7","148730","309597","32627.64375","0.42415936875","8.661115088437502E7","1125.944961496875"
"13736","148730","148725","9","148734","309606","32628.521249999998","0.42417077624999994","8.664377940562502E7","1126.3691322731252"
"13737","148734","148728","2","148730","309608","32627.64375","0.42415936875","8.667640704937501E7","1126.7932916418752"
"13738","148730","148727","3","148730","309611","32627.64375","0.42415936875","8.670903469312501E7","1127.2174510106252"
"13739","148730","148724","5","148729","309616","32627.424375","0.42415651687499994","8.67416621175E7","1127.6416075275001"
"13740","148729","148721","3","148724","309619","32626.3275","0.42414225749999995","8.677428844500001E7","1128.0657497850002"
"13741","148724","148700","543","149243","310162","32740.183125","0.42562238062499996","8.680702862812501E7","1128.4913721656253"
"13742","149243","149234","1","149235","310163","32738.428125","0.42559956562499995","8.683976705625E7","1128.9169717312502"
"13743","149235","149227","6","149233","310169","32737.989375","0.425593861875","8.6872505045625E7","1129.3425655931253"
"13744","149233","149224","6","149230","310175","32737.33125","0.42558530624999996","8.6905242376875E7","1129.7681508993753"
"13745","149230","149222","6","149228","310181","32736.8925","0.4255796025","8.6937979269375E7","1130.1937305018753"
"13746","149228","149220","3","149223","310184","32735.795625000002","0.425565343125","8.6970715065E7","1130.6192958450004"
"13747","149223","149220","7","149227","310191","32736.673125","0.425576750625","8.7003451738125E7","1131.0448725956253"
"13748","149227","149226","5","149231","310196","32737.550624999993","0.4255881581249999","8.703618928875E7","1131.4704607537503"
"13749","149231","149226","8","149234","310204","32738.208749999998","0.42559671374999997","8.706892749749999E7","1131.8960574675004"
"13750","149234","149233","4","149237","310208","32738.866875","0.425605269375","8.710166636437498E7","1132.3216627368754"
"13751","149237","149233","6","149239","310214","32739.305624999997","0.42561097312499996","8.713440566999999E7","1132.7472737100004"
"13752","149239","149230","2","149232","310216","32737.770000000004","0.42559101000000005","8.716714343999998E7","1133.1728647200005"
"13753","149232","149228","6","149234","310222","32738.208749999998","0.42559671374999997","8.719988164874998E7","1133.5984614337506"
"13754","149234","149226","6","149232","310228","32737.770000000004","0.42559101000000005","8.723261941874997E7","1134.0240524437506"
"13755","149232","149225","9","149234","310237","32738.208749999998","0.42559671374999997","8.726535762749997E7","1134.4496491575007"
"13756","149234","149232","3","149235","310240","32738.428125","0.42559956562499995","8.729809605562496E7","1134.8752487231257"
"13757","149235","149232","7","149239","310247","32739.305624999997","0.42561097312499996","8.733083536124997E7","1135.3008596962507"
"13758","149239","149237","1","149238","310248","32739.08625","0.42560812124999997","8.736357444749998E7","1135.7264678175006"
"13759","149238","149231","2","149233","310250","32737.989375","0.425593861875","8.739631243687497E7","1136.1520616793757"
"13760","149233","149227","9","149236","310259","32738.6475","0.42560241749999994","8.742905108437496E7","1136.5776640968757"
"13761","149236","149228","2","149230","310261","32737.33125","0.42558530624999996","8.746178841562496E7","1137.0032494031257"
"13762","149230","149221","1","149222","310262","32735.57625","0.42556249124999995","8.749452399187496E7","1137.4288118943757"
"13763","149222","149215","5","149220","310267","32735.1375","0.4255567875","8.752725912937497E7","1137.8543686818757"
"13764","149220","149211","4","149215","310271","32734.040625","0.425542528125","8.755999316999997E7","1138.2799112100008"
"13765","149215","149210","8","149218","310279","32734.69875","0.42555108374999995","8.759272786874998E7","1138.7054622937508"
"13766","149218","149215","7","149222","310286","32735.57625","0.42556249124999995","8.762546344499998E7","1139.1310247850008"
"13767","149222","149217","8","149225","310294","32736.234375","0.42557104687499997","8.765819967937498E7","1139.5565958318757"
"13768","149225","149220","9","149229","310303","32737.111875","0.425582454375","8.769093679124998E7","1139.9821782862507"
"13769","149229","149220","6","149226","310309","32736.453749999997","0.42557389874999996","8.772367324499997E7","1140.4077521850006"
"13770","149226","149219","9","149228","310318","32736.8925","0.4255796025","8.775641013749997E7","1140.8333317875006"
"13771","149228","149220","8","149228","310326","32736.8925","0.4255796025","8.778914702999997E7","1141.2589113900005"
"13772","149228","149219","1","149220","310327","32735.1375","0.4255567875","8.782188216749997E7","1141.6844681775005"
"13773","149220","149218","4","149222","310331","32735.57625","0.42556249124999995","8.785461774374998E7","1142.1100306687506"
"13774","149222","149213","4","149217","310335","32734.479375000003","0.425548231875","8.788735222312498E7","1142.5355789006255"
"13775","149217","149213","2","149215","310337","32734.040625","0.425542528125","8.792008626374999E7","1142.9611214287506"
"13776","149215","149209","4","149213","310341","32733.601875","0.42553682437499996","8.7952819865625E7","1143.3866582531257"
"13777","149213","149211","9","149220","310350","32735.1375","0.4255567875","8.7985555003125E7","1143.8122150406257"
"13778","149220","149218","3","149221","310353","32735.356874999998","0.42555963937499997","8.801829036E7","1144.2377746800007"
"13779","149221","149218","7","149225","310360","32736.234375","0.42557104687499997","8.8051026594375E7","1144.6633457268756"
"13780","149225","149221","4","149225","310364","32736.234375","0.42557104687499997","8.808376282875E7","1145.0889167737505"
"13781","149225","149216","7","149223","310371","32735.795625000002","0.425565343125","8.8116498624375E7","1145.5144821168756"
"13782","149223","149222","3","149225","310374","32736.234375","0.42557104687499997","8.814923485875E7","1145.9400531637505"
"13783","149225","149223","7","149230","310381","32737.33125","0.42558530624999996","8.818197219E7","1146.3656384700005"
"13784","149230","149229","8","149237","310389","32738.866875","0.425605269375","8.821471105687499E7","1146.7912437393754"
"13785","149237","149229","4","149233","310393","32737.989375","0.425593861875","8.824744904624999E7","1147.2168376012505"
"13786","149233","149230","3","149233","310396","32737.989375","0.425593861875","8.828018703562498E7","1147.6424314631256"
"13787","149233","149224","5","149229","310401","32737.111875","0.425582454375","8.831292414749998E7","1148.0680139175006"
"13788","149229","149225","3","149228","310404","32736.8925","0.4255796025","8.834566103999998E7","1148.4935935200006"
"13789","149228","149222","6","149228","310410","32736.8925","0.4255796025","8.837839793249997E7","1148.9191731225005"
"13790","149228","149221","5","149226","310415","32736.453749999997","0.42557389874999996","8.841113438624997E7","1149.3447470212504"
"13791","149226","149225","3","149228","310418","32736.8925","0.4255796025","8.844387127874997E7","1149.7703266237504"
"13792","149228","149227","9","149236","310427","32738.6475","0.42560241749999994","8.847660992624997E7","1150.1959290412503"
"13793","149236","149227","7","149234","310434","32738.208749999998","0.42559671374999997","8.850934813499996E7","1150.6215257550004"
"13794","149234","149229","4","149233","310438","32737.989375","0.425593861875","8.854208612437496E7","1151.0471196168755"
"13795","149233","149230","1","149231","310439","32737.550624999993","0.4255881581249999","8.857482367499995E7","1151.4727077750006"
"13796","149231","149224","1","149225","310440","32736.234375","0.42557104687499997","8.860755990937495E7","1151.8982788218755"
"13797","149225","149216","8","149224","310448","32736.015","0.425568195","8.864029592437495E7","1152.3238470168756"
"13798","149224","149221","3","149224","310451","32736.015","0.425568195","8.867303193937495E7","1152.7494152118757"
"13799","149224","149222","5","149227","310456","32736.673125","0.425576750625","8.870576861249995E7","1153.1749919625006"
"13800","149227","149222","8","149230","310464","32737.33125","0.42558530624999996","8.873850594374995E7","1153.6005772687506"
"13801","149230","149206","812","150018","311276","32910.198749999996","0.42783258374999994","8.877141614249995E7","1154.0284098525005"
"13802","150018","150010","5","150015","311281","32909.540625","0.427824028125","8.880432568312496E7","1154.4562338806256"
"13803","150015","150014","8","150022","311289","32911.07625","0.42784399124999994","8.883723675937496E7","1154.8840778718757"
"13804","150022","150021","4","150025","311293","32911.734375","0.42785254687499996","8.887014849374996E7","1155.3119304187508"
"13805","150025","150024","9","150033","311302","32913.489375","0.4278753618749999","8.890306198312496E7","1155.7398057806258"
"13806","150033","150029","1","150030","311303","32912.83125","0.42786680625","8.893597481437495E7","1156.1676725868758"
"13807","150030","150024","5","150029","311308","32912.611874999995","0.4278639543749999","8.896888742624995E7","1156.5955365412508"
"13808","150029","150025","5","150030","311313","32912.83125","0.42786680625","8.900180025749995E7","1157.0234033475008"
"13809","150030","150024","6","150030","311319","32912.83125","0.42786680625","8.903471308874995E7","1157.4512701537508"
"13810","150030","150023","7","150030","311326","32912.83125","0.42786680625","8.906762591999994E7","1157.8791369600008"
"13811","150030","150029","1","150030","311327","32912.83125","0.42786680625","8.910053875124994E7","1158.3070037662508"
"13812","150030","150024","9","150033","311336","32913.489375","0.4278753618749999","8.913345224062493E7","1158.7348791281258"
"13813","150033","150029","8","150037","311344","32914.366875","0.427886769375","8.916636660749993E7","1159.1627658975008"
"13814","150037","150032","2","150034","311346","32913.70875","0.42787821374999996","8.919928031624992E7","1159.5906441112509"
"13815","150034","150032","9","150041","311355","32915.244375","0.427898176875","8.923219556062493E7","1160.018542288126"
"13816","150041","150040","9","150049","311364","32916.999375","0.427920991875","8.926511255999993E7","1160.446463280001"
"13817","150049","150041","7","150048","311371","32916.78","0.42791813999999995","8.929802933999993E7","1160.8743814200009"
"13818","150048","150042","6","150048","311377","32916.78","0.42791813999999995","8.933094611999993E7","1161.3022995600008"
"13819","150048","150042","1","150043","311378","32915.683124999996","0.4279038806249999","8.936386180312493E7","1161.730203440626"
"13820","150043","150041","8","150049","311386","32916.999375","0.427920991875","8.939677880249994E7","1162.158124432501"
"13821","150049","150046","2","150048","311388","32916.78","0.42791813999999995","8.942969558249994E7","1162.586042572501"
"13822","150048","150042","6","150048","311394","32916.78","0.42791813999999995","8.946261236249994E7","1163.0139607125009"
"13823","150048","150039","1","150040","311395","32915.025","0.427895325","8.949552738749994E7","1163.4418560375009"
"13824","150040","150033","8","150041","311403","32915.244375","0.427898176875","8.952844263187495E7","1163.869754214376"
"13825","150041","150038","9","150047","311412","32916.560625","0.42791528812499996","8.956135919249995E7","1164.2976695025009"
"13826","150047","150041","4","150045","311416","32916.121875","0.42790958437499993","8.959427531437495E7","1164.7255790868758"
"13827","150045","150043","9","150052","311425","32917.6575","0.4279295475","8.962719297187495E7","1165.1535086343758"
"13828","150052","150048","5","150053","311430","32917.876875","0.427932399375","8.966011084874995E7","1165.581441033751"
"13829","150053","150048","7","150055","311437","32918.315625","0.427938103125","8.969302916437495E7","1166.0093791368759"
"13830","150055","150049","7","150056","311444","32918.534999999996","0.4279409549999999","8.972594769937494E7","1166.4373200918758"
"13831","150056","150051","6","150057","311450","32918.754375000004","0.427943806875","8.975886645374994E7","1166.8652638987508"
"13832","150057","150051","7","150058","311457","32918.97375","0.42794665874999993","8.979178542749994E7","1167.2932105575007"
"13833","150058","150056","2","150058","311459","32918.97375","0.42794665874999993","8.982470440124993E7","1167.7211572162507"
"13834","150058","150055","6","150061","311465","32919.631875","0.42795521437499995","8.985762403312492E7","1168.1491124306258"
"13835","150061","150055","9","150064","311474","32920.28999999999","0.4279637699999999","8.989054432312493E7","1168.5770762006257"
"13836","150064","150055","9","150064","311483","32920.28999999999","0.4279637699999999","8.992346461312494E7","1169.0050399706256"
"13837","150064","150056","1","150057","311484","32918.754375000004","0.427943806875","8.995638336749993E7","1169.4329837775006"
"13838","150057","150050","7","150057","311491","32918.754375000004","0.427943806875","8.998930212187493E7","1169.8609275843755"
"13839","150057","150049","3","150052","311494","32917.6575","0.4279295475","9.002221977937493E7","1170.2888571318756"
"13840","150052","150047","7","150054","311501","32918.096249999995","0.4279352512499999","9.005513787562492E7","1170.7167923831255"
"13841","150054","150052","4","150056","311505","32918.534999999996","0.4279409549999999","9.008805641062492E7","1171.1447333381254"
"13842","150056","150050","8","150058","311513","32918.97375","0.42794665874999993","9.012097538437492E7","1171.5726799968754"
"13843","150058","150052","1","150053","311514","32917.876875","0.427932399375","9.015389326124991E7","1172.0006123962505"
"13844","150053","150049","5","150054","311519","32918.096249999995","0.4279352512499999","9.018681135749991E7","1172.4285476475004"
"13845","150054","150047","3","150050","311522","32917.21875","0.42792384375","9.021972857624991E7","1172.8564714912504"
"13846","150050","150046","3","150049","311525","32916.999375","0.427920991875","9.025264557562491E7","1173.2843924831254"
"13847","150049","150040","4","150044","311529","32915.9025","0.42790673249999994","9.028556147812492E7","1173.7122992156255"
"13848","150044","150043","4","150047","311533","32916.560625","0.42791528812499996","9.031847803874992E7","1174.1402145037505"
"13849","150047","150041","3","150044","311536","32915.9025","0.42790673249999994","9.035139394124992E7","1174.5681212362506"
"13850","150044","150040","9","150049","311545","32916.999375","0.427920991875","9.038431094062492E7","1174.9960422281256"
"13851","150049","150045","8","150053","311553","32917.876875","0.427932399375","9.041722881749992E7","1175.4239746275007"
"13852","150053","150045","3","150048","311556","32916.78","0.42791813999999995","9.045014559749992E7","1175.8518927675007"
"13853","150048","150039","7","150046","311563","32916.34125","0.4279124362499999","9.048306193874992E7","1176.2798052037506"
"13854","150046","150043","6","150049","311569","32916.999375","0.427920991875","9.051597893812492E7","1176.7077261956256"
"13855","150049","150042","8","150050","311577","32917.21875","0.42792384375","9.054889615687492E7","1177.1356500393756"
"13856","150050","150049","5","150054","311582","32918.096249999995","0.4279352512499999","9.058181425312492E7","1177.5635852906255"
"13857","150054","150045","1","150046","311583","32916.34125","0.4279124362499999","9.061473059437492E7","1177.9914977268754"
"13858","150046","150041","8","150049","311591","32916.999375","0.427920991875","9.064764759374993E7","1178.4194187187504"
"13859","150049","150045","2","150047","311593","32916.560625","0.42791528812499996","9.068056415437493E7","1178.8473340068754"
"13860","150047","150044","9","150053","311602","32917.876875","0.427932399375","9.071348203124993E7","1179.2752664062505"
"13861","150053","150018","602","150620","312204","33042.2625","0.42954941249999995","9.074652429374993E7","1179.7048158187504"
"13862","150620","150611","8","150619","312212","33042.043125","0.4295465606249999","9.077956633687493E7","1180.1343623793755"
"13863","150619","150615","5","150620","312217","33042.2625","0.42954941249999995","9.081260859937494E7","1180.5639117918754"
"13864","150620","150618","9","150627","312226","33043.798125","0.42956937562499997","9.084565239749993E7","1180.9934811675005"
"13865","150627","150619","5","150624","312231","33043.14","0.42956081999999995","9.087869553749993E7","1181.4230419875005"
"13866","150624","150619","5","150624","312236","33043.14","0.42956081999999995","9.091173867749994E7","1181.8526028075005"
"13867","150624","150621","8","150629","312244","33044.236874999995","0.4295750793749999","9.094478291437493E7","1182.2821778868754"
"13868","150629","150627","7","150634","312251","33045.33375","0.42958933874999994","9.097782824812493E7","1182.7117672256254"
"13869","150634","150625","9","150634","312260","33045.33375","0.42958933874999994","9.101087358187492E7","1183.1413565643754"
"13870","150634","150633","3","150636","312263","33045.7725","0.42959504249999997","9.104391935437492E7","1183.5709516068755"
"13871","150636","150627","5","150632","312268","33044.895000000004","0.429583635","9.107696424937491E7","1184.0005352418755"
"13872","150632","150630","4","150634","312272","33045.33375","0.42958933874999994","9.11100095831249E7","1184.4301245806255"
"13873","150634","150625","4","150629","312276","33044.236874999995","0.4295750793749999","9.11430538199999E7","1184.8596996600004"
"13874","150629","150620","6","150626","312282","33043.57875","0.42956652375","9.11760973987499E7","1185.2892661837504"
"13875","150626","150625","7","150632","312289","33044.895000000004","0.429583635","9.12091422937499E7","1185.7188498187504"
"13876","150632","150625","6","150631","312295","33044.675624999996","0.4295807831249999","9.12421869693749E7","1186.1484306018754"
"13877","150631","150625","7","150632","312302","33044.895000000004","0.429583635","9.127523186437489E7","1186.5780142368753"
"13878","150632","150628","2","150630","312304","33044.45625","0.42957793125","9.130827632062489E7","1187.0075921681253"
"13879","150630","150621","9","150630","312313","33044.45625","0.42957793125","9.134132077687488E7","1187.4371700993752"
"13880","150630","150621","4","150625","312317","33043.359375","0.429563671875","9.137436413624988E7","1187.8667337712502"
"13881","150625","150624","5","150629","312322","33044.236874999995","0.4295750793749999","9.140740837312488E7","1188.296308850625"
"13882","150629","150628","6","150634","312328","33045.33375","0.42958933874999994","9.144045370687488E7","1188.7258981893751"
"13883","150634","150631","6","150637","312334","33045.991875","0.42959789437499996","9.147349969874987E7","1189.1554960837502"
"13884","150637","150635","9","150644","312343","33047.5275","0.4296178574999999","9.150654722624987E7","1189.5851139412503"
"13885","150644","150638","7","150645","312350","33047.746875","0.4296207093749999","9.153959497312488E7","1190.0147346506253"
"13886","150645","150641","5","150646","312355","33047.96625","0.42962356124999995","9.157264293937488E7","1190.4443582118754"
"13887","150646","150644","2","150646","312357","33047.96625","0.42962356124999995","9.160569090562488E7","1190.8739817731255"
"13888","150646","150637","4","150641","312361","33046.869375","0.429609301875","9.163873777499989E7","1191.3035910750004"
"13889","150641","150637","4","150641","312365","33046.869375","0.429609301875","9.167178464437489E7","1191.7332003768754"
"13890","150641","150633","5","150638","312370","33046.21125","0.42960074625","9.17048308556249E7","1192.1628011231253"
"13891","150638","150636","7","150643","312377","33047.308124999996","0.42961500562499993","9.17378781637499E7","1192.5924161287503"
"13892","150643","150637","2","150639","312379","33046.43062499999","0.4296035981249999","9.177092459437491E7","1193.0220197268752"
"13893","150639","150630","9","150639","312388","33046.43062499999","0.4296035981249999","9.180397102499992E7","1193.4516233250001"
"13894","150639","150635","8","150643","312396","33047.308124999996","0.42961500562499993","9.183701833312492E7","1193.8812383306251"
"13895","150643","150635","7","150642","312403","33047.08875","0.42961215375","9.187006542187493E7","1194.3108504843751"
"13896","150642","150638","8","150646","312411","33047.96625","0.42962356124999995","9.190311338812493E7","1194.7404740456252"
"13897","150646","150642","4","150646","312415","33047.96625","0.42962356124999995","9.193616135437493E7","1195.1700976068753"
"13898","150646","150640","1","150641","312416","33046.869375","0.429609301875","9.196920822374994E7","1195.5997069087502"
"13899","150641","150633","3","150636","312419","33045.7725","0.42959504249999997","9.200225399624993E7","1196.0293019512503"
"13900","150636","150630","4","150634","312423","33045.33375","0.42958933874999994","9.203529932999992E7","1196.4588912900003"
"13901","150634","150629","1","150630","312424","33044.45625","0.42957793125","9.206834378624992E7","1196.8884692212503"
"13902","150630","150629","5","150634","312429","33045.33375","0.42958933874999994","9.210138911999992E7","1197.3180585600003"
"13903","150634","150628","9","150637","312438","33045.991875","0.42959789437499996","9.213443511187491E7","1197.7476564543754"
"13904","150637","150634","8","150642","312446","33047.08875","0.42961215375","9.216748220062491E7","1198.1772686081254"
"13905","150642","150641","6","150647","312452","33048.185625","0.42962641312499994","9.220053038624991E7","1198.6068950212505"
"13906","150647","150645","2","150647","312454","33048.185625","0.42962641312499994","9.223357857187492E7","1199.0365214343756"
"13907","150647","150646","9","150655","312463","33049.940625","0.429649228125","9.226662851249991E7","1199.4661706625006"
"13908","150655","150646","7","150653","312470","33049.501875","0.429643524375","9.229967801437491E7","1199.8958141868757"
"13909","150653","150644","2","150646","312472","33047.96625","0.42962356124999995","9.233272598062491E7","1200.3254377481258"
"13910","150646","150642","8","150650","312480","33048.84375","0.42963496874999996","9.236577482437491E7","1200.7550727168757"
"13911","150650","150643","9","150652","312489","33049.2825","0.4296406725","9.239882410687491E7","1201.1847133893757"
"13912","150652","150648","7","150655","312496","33049.940625","0.429649228125","9.243187404749991E7","1201.6143626175008"
"13913","150655","150650","9","150659","312505","33050.818125","0.42966063562499995","9.24649248656249E7","1202.0440232531257"
"13914","150659","150656","5","150661","312510","33051.256875","0.429666339375","9.24979761224999E7","1202.4736895925007"
"13915","150661","150658","9","150667","312519","33052.573125","0.429683450625","9.25310286956249E7","1202.9033730431256"
"13916","150667","150666","7","150673","312526","33053.889375","0.42970056187499994","9.25640825849999E7","1203.3330736050007"
"13917","150673","150668","8","150676","312534","33054.5475","0.42970911749999996","9.25971371324999E7","1203.7627827225006"
"13918","150676","150672","5","150677","312539","33054.766875","0.429711969375","9.26301918993749E7","1204.1924946918755"
"13919","150677","150675","1","150676","312540","33054.5475","0.42970911749999996","9.26632464468749E7","1204.6222038093754"
"13920","150676","150672","4","150676","312544","33054.5475","0.42970911749999996","9.26963009943749E7","1205.0519129268753"
"13921","150676","150643","837","151480","313381","33230.925","0.432002025","9.27295319193749E7","1205.4839149518752"
"13922","151480","151479","7","151486","313388","33232.24125","0.43201913624999994","9.276276416062489E7","1205.9159340881251"
"13923","151486","151477","2","151479","313390","33230.705624999995","0.4319991731249999","9.279599486624989E7","1206.34793326125"
"13924","151479","151470","2","151472","313392","33229.17","0.43197920999999995","9.282922403624989E7","1206.77991247125"
"13925","151472","151466","5","151471","313397","33228.950625","0.43197635812499996","9.28624529868749E7","1207.211888829375"
"13926","151471","151462","9","151471","313406","33228.950625","0.43197635812499996","9.28956819374999E7","1207.6438651875"
"13927","151471","151464","5","151469","313411","33228.511875","0.43197065437499993","9.29289104493749E7","1208.075835841875"
"13928","151469","151465","5","151470","313416","33228.73125","0.4319735062499999","9.29621391806249E7","1208.507809348125"
"13929","151470","151467","7","151474","313423","33229.60875","0.43198491375","9.29953687893749E7","1208.939794261875"
"13930","151474","151469","8","151477","313431","33230.266875","0.431993469375","9.30285990562499E7","1209.37178773125"
"13931","151477","151475","8","151483","313439","33231.583125","0.4320105806249999","9.30618306393749E7","1209.803798311875"
"13932","151483","151481","5","151486","313444","33232.24125","0.43201913624999994","9.309506288062489E7","1210.2358174481249"
"13933","151486","151478","8","151486","313452","33232.24125","0.43201913624999994","9.312829512187488E7","1210.6678365843748"
"13934","151486","151485","7","151492","313459","33233.5575","0.4320362475","9.316152867937489E7","1211.0998728318748"
"13935","151492","151488","5","151493","313464","33233.776874999996","0.4320390993749999","9.31947624562499E7","1211.5319119312499"
"13936","151493","151486","8","151494","313472","33233.99625","0.43204195124999994","9.32279964524999E7","1211.9639538825"
"13937","151494","151488","1","151489","313473","33232.89937499999","0.4320276918749999","9.32612293518749E7","1212.395981574375"
"13938","151489","151480","1","151481","313474","33231.144374999996","0.43200487687499994","9.32944604962499E7","1212.82798645125"
"13939","151481","151474","7","151481","313481","33231.144374999996","0.43200487687499994","9.33276916406249E7","1213.259991328125"
"13940","151481","151472","8","151480","313489","33230.925","0.432002025","9.33609225656249E7","1213.6919933531249"
"13941","151480","151472","1","151473","313490","33229.389375","0.43198206187499993","9.33941519549999E7","1214.123975415"
"13942","151473","151464","1","151465","313491","33227.634375","0.431959246875","9.34273795893749E7","1214.555934661875"
"13943","151465","151458","7","151465","313498","33227.634375","0.431959246875","9.34606072237499E7","1214.98789390875"
"13944","151465","151463","9","151472","313507","33229.17","0.43197920999999995","9.349383639374991E7","1215.41987311875"
"13945","151472","151465","7","151472","313514","33229.17","0.43197920999999995","9.352706556374991E7","1215.85185232875"
"13946","151472","151467","6","151473","313520","33229.389375","0.43198206187499993","9.356029495312491E7","1216.283834390625"
"13947","151473","151469","1","151470","313521","33228.73125","0.4319735062499999","9.359352368437491E7","1216.715807896875"
"13948","151470","151465","7","151472","313528","33229.17","0.43197920999999995","9.362675285437492E7","1217.147787106875"
"13949","151472","151469","4","151473","313532","33229.389375","0.43198206187499993","9.365998224374992E7","1217.57976916875"
"13950","151473","151472","6","151478","313538","33230.48625","0.43199632125","9.369321272999991E7","1218.01176549"
"13951","151478","151473","2","151475","313540","33229.828125","0.43198776562499996","9.372644255812491E7","1218.443753255625"
"13952","151475","151474","5","151479","313545","33230.705624999995","0.4319991731249999","9.375967326374991E7","1218.87575242875"
"13953","151479","151471","6","151477","313551","33230.266875","0.431993469375","9.379290353062491E7","1219.307745898125"
"13954","151477","151469","4","151473","313555","33229.389375","0.43198206187499993","9.382613291999991E7","1219.73972796"
"13955","151473","151470","4","151474","313559","33229.60875","0.43198491375","9.385936252874991E7","1220.17171287375"
"13956","151474","151465","7","151472","313566","33229.17","0.43197920999999995","9.389259169874991E7","1220.60369208375"
"13957","151472","151466","9","151475","313575","33229.828125","0.43198776562499996","9.392582152687491E7","1221.0356798493751"
"13958","151475","151467","2","151469","313577","33228.511875","0.43197065437499993","9.395905003874992E7","1221.46765050375"
"13959","151469","151465","4","151469","313581","33228.511875","0.43197065437499993","9.399227855062492E7","1221.899621158125"
"13960","151469","151467","4","151471","313585","33228.950625","0.43197635812499996","9.402550750124992E7","1222.33159751625"
"13961","151471","151462","1","151463","313586","33227.195625","0.43195354312499995","9.405873469687493E7","1222.763551059375"
"13962","151463","151460","2","151462","313588","33226.97625","0.43195069124999996","9.409196167312492E7","1223.195501750625"
"13963","151462","151455","6","151461","313594","33226.756875","0.431947839375","9.412518842999992E7","1223.62744959"
"13964","151461","151453","9","151462","313603","33226.97625","0.43195069124999996","9.415841540624991E7","1224.05940028125"
"13965","151462","151457","7","151464","313610","33227.41499999999","0.4319563949999999","9.419164282124992E7","1224.49135667625"
"13966","151464","151461","4","151465","313614","33227.634375","0.431959246875","9.422487045562492E7","1224.923315923125"
"13967","151465","151456","1","151457","313615","33225.879375000004","0.431936431875","9.425809633499992E7","1225.3552523550002"
"13968","151457","151455","2","151457","313617","33225.879375000004","0.431936431875","9.429132221437491E7","1225.7871887868753"
"13969","151457","151451","4","151455","313621","33225.440625","0.431930728125","9.432454765499991E7","1226.2191195150003"
"13970","151455","151452","5","151457","313626","33225.879375000004","0.431936431875","9.435777353437491E7","1226.6510559468754"
"13971","151457","151456","7","151463","313633","33227.195625","0.43195354312499995","9.439100072999991E7","1227.0830094900004"
"13972","151463","151457","7","151464","313640","33227.41499999999","0.4319563949999999","9.442422814499992E7","1227.5149658850005"
"13973","151464","151457","3","151460","313643","33226.5375","0.43194498749999993","9.445745468249992E7","1227.9469108725004"
"13974","151460","151452","6","151458","313649","33226.09875","0.43193928374999996","9.449068078124991E7","1228.3788501562503"
"13975","151458","151452","6","151458","313655","33226.09875","0.43193928374999996","9.45239068799999E7","1228.8107894400002"
"13976","151458","151451","5","151456","313660","33225.659999999996","0.43193357999999993","9.45571325399999E7","1229.2427230200003"
"13977","151456","151454","1","151455","313661","33225.440625","0.431930728125","9.45903579806249E7","1229.6746537481254"
"13978","151455","151452","8","151460","313669","33226.5375","0.43194498749999993","9.46235845181249E7","1230.1065987356253"
"13979","151460","151458","8","151466","313677","33227.85375","0.43196209875","9.46568123718749E7","1230.5385608343754"
"13980","151466","151457","4","151461","313681","33226.756875","0.431947839375","9.469003912874989E7","1230.9705086737504"
"13981","151461","151413","556","151969","314237","33338.199375","0.4333965918749999","9.47233773281249E7","1231.4039052656253"
"13982","151969","151964","7","151971","314244","33338.638125","0.43340229562499993","9.47567159662499E7","1231.8373075612503"
"13983","151971","151963","9","151972","314253","33338.8575","0.4334051475","9.47900548237499E7","1232.2707127087504"
"13984","151972","151969","2","151971","314255","33338.638125","0.43340229562499993","9.48233934618749E7","1232.7041150043754"
"13985","151971","151969","9","151978","314264","33340.17375","0.43342225875","9.48567336356249E7","1233.1375372631253"
"13986","151978","151969","9","151978","314273","33340.17375","0.43342225875","9.48900738093749E7","1233.5709595218752"
"13987","151978","151969","4","151973","314277","33339.076875","0.43340799937499996","9.49234128862499E7","1234.0043675212503"
"13988","151973","151965","8","151973","314285","33339.076875","0.43340799937499996","9.49567519631249E7","1234.4377755206253"
"13989","151973","151972","9","151981","314294","33340.831874999996","0.4334308143749999","9.49900927949999E7","1234.8712063350004"
"13990","151981","151979","2","151981","314296","33340.831874999996","0.4334308143749999","9.50234336268749E7","1235.3046371493754"
"13991","151981","151976","5","151981","314301","33340.831874999996","0.4334308143749999","9.505677445874989E7","1235.7380679637504"
"13992","151981","151975","8","151983","314309","33341.270625","0.43343651812499995","9.509011572937489E7","1236.1715044818754"
"13993","151983","151979","1","151980","314310","33340.6125","0.4334279625","9.512345634187488E7","1236.6049324443754"
"13994","151980","151976","1","151977","314311","33339.954375","0.43341940687499997","9.515679629624988E7","1237.0383518512504"
"13995","151977","151973","4","151977","314315","33339.954375","0.43341940687499997","9.519013625062488E7","1237.4717712581253"
"13996","151977","151968","4","151972","314319","33338.8575","0.4334051475","9.522347510812488E7","1237.9051764056253"
"13997","151972","151970","1","151971","314320","33338.638125","0.43340229562499993","9.525681374624988E7","1238.3385787012503"
"13998","151971","151966","6","151972","314326","33338.8575","0.4334051475","9.529015260374989E7","1238.7719838487503"
"13999","151972","151969","6","151975","314332","33339.515625","0.433413703125","9.532349211937489E7","1239.2053975518754"
"14000","151975","151974","8","151982","314340","33341.051250000004","0.43343366625","9.535683317062488E7","1239.6388312181255"
"14001","151982","151977","3","151980","314343","33340.6125","0.4334279625","9.539017378312488E7","1240.0722591806255"
"14002","151980","151972","1","151973","314344","33339.076875","0.43340799937499996","9.542351285999988E7","1240.5056671800005"
"14003","151973","151972","4","151976","314348","33339.735","0.433416555","9.545685259499988E7","1240.9390837350004"
"14004","151976","151975","9","151984","314357","33341.49","0.43343936999999993","9.549019408499987E7","1241.3725231050005"
"14005","151984","151979","2","151981","314359","33340.831874999996","0.4334308143749999","9.552353491687487E7","1241.8059539193755"
"14006","151981","151973","8","151981","314367","33340.831874999996","0.4334308143749999","9.555687574874987E7","1242.2393847337505"
"14007","151981","151973","3","151976","314370","33339.735","0.433416555","9.559021548374987E7","1242.6728012887504"
"14008","151976","151971","6","151977","314376","33339.954375","0.43341940687499997","9.562355543812487E7","1243.1062206956253"
"14009","151977","151973","4","151977","314380","33339.954375","0.43341940687499997","9.565689539249986E7","1243.5396401025002"
"14010","151977","151976","4","151980","314384","33340.6125","0.4334279625","9.569023600499986E7","1243.9730680650002"
"14011","151980","151972","8","151980","314392","33340.6125","0.4334279625","9.572357661749986E7","1244.4064960275002"
"14012","151980","151972","3","151975","314395","33339.515625","0.433413703125","9.575691613312486E7","1244.8399097306253"
"14013","151975","151973","3","151976","314398","33339.735","0.433416555","9.579025586812486E7","1245.2733262856252"
"14014","151976","151967","1","151968","314399","33337.979999999996","0.4333937399999999","9.582359384812486E7","1245.7067200256251"
"14015","151968","151963","1","151964","314400","33337.10249999999","0.4333823324999999","9.585693095062487E7","1246.1401023581252"
"14016","151964","151962","8","151970","314408","33338.41875","0.43339944374999995","9.589026936937487E7","1246.5735018018752"
"14017","151970","151965","3","151968","314411","33337.979999999996","0.4333937399999999","9.592360734937488E7","1247.006895541875"
"14018","151968","151962","4","151966","314415","33337.54125","0.43338803625","9.595694489062488E7","1247.4402835781252"
"14019","151966","151960","2","151962","314417","33336.66375","0.43337662875","9.599028155437487E7","1247.8736602068752"
"14020","151962","151960","3","151963","314420","33336.883125","0.433379480625","9.602361843749988E7","1248.3070396875003"
"14021","151963","151954","3","151957","314423","33335.566875000004","0.433362369375","9.605695400437488E7","1248.7404020568752"
"14022","151957","151948","7","151955","314430","33335.128125","0.433356665625","9.609028913249987E7","1249.1737587225002"
"14023","151955","151948","1","151949","314431","33333.811875","0.433339554375","9.612362294437487E7","1249.6070982768751"
"14024","151949","151947","6","151953","314437","33334.689375","0.433350961875","9.615695763374987E7","1250.0404492387502"
"14025","151953","151945","8","151953","314445","33334.689375","0.433350961875","9.619029232312487E7","1250.4738002006252"
"14026","151953","151947","2","151949","314447","33333.811875","0.433339554375","9.622362613499987E7","1250.9071397550001"
"14027","151949","151946","2","151948","314449","33333.5925","0.43333670249999995","9.625695972749987E7","1251.3404764575"
"14028","151948","151944","3","151947","314452","33333.373125","0.43333385062499996","9.629029310062487E7","1251.7738103081251"
"14029","151947","151944","5","151949","314457","33333.811875","0.433339554375","9.632362691249987E7","1252.2071498625"
"14030","151949","151940","4","151944","314461","33332.715","0.43332529499999994","9.635695962749988E7","1252.6404751575"
"14031","151944","151935","8","151943","314469","33332.495624999996","0.4333224431249999","9.639029212312488E7","1253.073797600625"
"14032","151943","151938","9","151947","314478","33333.373125","0.43333385062499996","9.642362549624988E7","1253.5071314512502"
"14033","151947","151944","5","151949","314483","33333.811875","0.433339554375","9.645695930812488E7","1253.940471005625"
"14034","151949","151941","7","151948","314490","33333.5925","0.43333670249999995","9.649029290062489E7","1254.373807708125"
"14035","151948","151942","6","151948","314496","33333.5925","0.43333670249999995","9.652362649312489E7","1254.807144410625"
"14036","151948","151939","2","151941","314498","33332.056875","0.433316739375","9.65569585499999E7","1255.2404611499999"
"14037","151941","151933","3","151936","314501","33330.96","0.43330247999999993","9.659028950999989E7","1255.67376363"
"14038","151936","151933","3","151936","314504","33330.96","0.43330247999999993","9.662362046999988E7","1256.10706611"
"14039","151936","151929","9","151938","314513","33331.39875","0.43330818374999996","9.665695186874989E7","1256.54037429375"
"14040","151938","151930","9","151939","314522","33331.61812499999","0.4333110356249999","9.66902834868749E7","1256.9736853293748"
"14041","151939","151908","716","152624","315238","33481.89","0.43526456999999996","9.67237653768749E7","1257.4089498993749"
"14042","152624","152617","8","152625","315246","33482.109375","0.43526742187499995","9.67572474862499E7","1257.84421732125"
"14043","152625","152617","5","152622","315251","33481.45125","0.43525886624999993","9.67907289374999E7","1258.2794761875"
"14044","152622","152614","7","152621","315258","33481.231875","0.43525601437499994","9.68242101693749E7","1258.714732201875"
"14045","152621","152613","7","152620","315265","33481.0125","0.43525316249999996","9.68576911818749E7","1259.149985364375"
"14046","152620","152616","2","152618","315267","33480.573749999996","0.4352474587499999","9.68911717556249E7","1259.585232823125"
"14047","152618","152609","6","152615","315273","33479.915625","0.43523890312499997","9.692465167124991E7","1260.02047172625"
"14048","152615","152608","5","152613","315278","33479.476875","0.435233199375","9.695813114812492E7","1260.455704925625"
"14049","152613","152607","5","152612","315283","33479.2575","0.43523034749999995","9.699161040562491E7","1260.890935273125"
"14050","152612","152605","3","152608","315286","33478.38","0.43521893999999994","9.70250887856249E7","1261.326154213125"
"14051","152608","152603","8","152611","315294","33479.038125","0.43522749562499996","9.70585678237499E7","1261.76138170875"
"14052","152611","152606","1","152607","315295","33478.160625000004","0.435216088125","9.70920459843749E7","1262.1965977968748"
"14053","152607","152601","4","152605","315299","33477.721875","0.43521038437500004","9.71255237062499E7","1262.6318081812499"
"14054","152605","152603","1","152604","315300","33477.502499999995","0.4352075324999999","9.715900120874989E7","1263.06701571375"
"14055","152604","152598","4","152602","315304","33477.06375","0.43520182874999996","9.719247827249989E7","1263.5022175425"
"14056","152602","152598","3","152601","315307","33476.844375","0.435198976875","9.722595511687489E7","1263.937416519375"
"14057","152601","152595","8","152603","315315","33477.283125","0.435204680625","9.725943239999989E7","1264.3726212"
"14058","152603","152595","9","152604","315324","33477.502499999995","0.4352075324999999","9.729290990249988E7","1264.8078287325"
"14059","152604","152595","1","152596","315325","33475.7475","0.43518471749999993","9.732638564999989E7","1265.24301345"
"14060","152596","152591","2","152593","315327","33475.089374999996","0.4351761618749999","9.735986073937489E7","1265.678189611875"
"14061","152593","152590","6","152596","315333","33475.7475","0.43518471749999993","9.73933364868749E7","1266.1133743293751"
"14062","152596","152587","8","152595","315341","33475.528125","0.43518186562499994","9.74268120149999E7","1266.5485561950002"
"14063","152595","152588","7","152595","315348","33475.528125","0.43518186562499994","9.74602875431249E7","1266.9837380606252"
"14064","152595","152586","9","152595","315357","33475.528125","0.43518186562499994","9.74937630712499E7","1267.4189199262503"
"14065","152595","152589","8","152597","315365","33475.966875","0.43518756937499997","9.75272390381249E7","1267.8541074956254"
"14066","152597","152591","4","152595","315369","33475.528125","0.43518186562499994","9.75607145662499E7","1268.2892893612504"
"14067","152595","152593","8","152601","315377","33476.844375","0.435198976875","9.75941914106249E7","1268.7244883381254"
"14068","152601","152592","8","152600","315385","33476.625","0.435196125","9.76276680356249E7","1269.1596844631254"
"14069","152600","152592","8","152600","315393","33476.625","0.435196125","9.76611446606249E7","1269.5948805881253"
"14070","152600","152598","1","152599","315394","33476.405625","0.43519327312499995","9.76946210662499E7","1270.0300738612502"
"14071","152599","152598","4","152602","315398","33477.06375","0.43520182874999996","9.77280981299999E7","1270.4652756900002"
"14072","152602","152598","2","152600","315400","33476.625","0.435196125","9.77615747549999E7","1270.9004718150002"
"14073","152600","152596","8","152604","315408","33477.502499999995","0.4352075324999999","9.77950522574999E7","1271.3356793475002"
"14074","152604","152602","1","152603","315409","33477.283125","0.435204680625","9.78285295406249E7","1271.7708840281252"
"14075","152603","152596","8","152604","315417","33477.502499999995","0.4352075324999999","9.78620070431249E7","1272.2060915606253"
"14076","152604","152603","3","152606","315420","33477.941249999996","0.4352132362499999","9.78954849843749E7","1272.6413047968754"
"14077","152606","152602","7","152609","315427","33478.599375","0.43522179187499993","9.792896358374989E7","1273.0765265887503"
"14078","152609","152606","9","152615","315436","33479.915625","0.43523890312499997","9.79624434993749E7","1273.5117654918754"
"14079","152615","152611","2","152613","315438","33479.476875","0.435233199375","9.79959229762499E7","1273.9469986912504"
"14080","152613","152605","5","152610","315443","33478.81875","0.43522464375","9.80294017949999E7","1274.3822233350004"
"14081","152610","152601","5","152606","315448","33477.941249999996","0.4352132362499999","9.80628797362499E7","1274.8174365712505"
"14082","152606","152600","3","152603","315451","33477.283125","0.435204680625","9.809635701937489E7","1275.2526412518755"
"14083","152603","152597","2","152599","315453","33476.405625","0.43519327312499995","9.81298334249999E7","1275.6878345250004"
"14084","152599","152591","1","152592","315454","33474.87","0.43517331","9.81633082949999E7","1276.1230078350004"
"14085","152592","152590","2","152592","315456","33474.87","0.43517331","9.81967831649999E7","1276.5581811450004"
"14086","152592","152587","7","152594","315463","33475.30875","0.43517901374999995","9.82302584737499E7","1276.9933601587504"
"14087","152594","152587","5","152592","315468","33474.87","0.43517331","9.826373334374991E7","1277.4285334687504"
"14088","152592","152584","2","152586","315470","33473.55375","0.43515619874999995","9.82972068974999E7","1277.8636896675005"
"14089","152586","152583","6","152589","315476","33474.21187499999","0.4351647543749999","9.833068110937491E7","1278.2988544218754"
"14090","152589","152581","7","152588","315483","33473.9925","0.4351619025","9.836415510187492E7","1278.7340163243755"
"14091","152588","152583","7","152590","315490","33474.43125","0.43516760625","9.839762953312492E7","1279.1691839306254"
"14092","152590","152581","1","152582","315491","33472.676250000004","0.43514479125000005","9.843110220937492E7","1279.6043287218754"
"14093","152582","152580","8","152588","315499","33473.9925","0.4351619025","9.846457620187493E7","1280.0394906243755"
"14094","152588","152582","2","152584","315501","33473.115","0.43515049499999997","9.849804931687492E7","1280.4746411193755"
"14095","152584","152576","9","152585","315510","33473.334375","0.43515334687499996","9.853152265124992E7","1280.9097944662506"
"14096","152585","152579","2","152581","315512","33472.456874999996","0.4351419393749999","9.856499510812491E7","1281.3449364056255"
"14097","152581","152579","3","152582","315515","33472.676250000004","0.43514479125000005","9.859846778437491E7","1281.7800811968755"
"14098","152582","152576","4","152580","315519","33472.2375","0.4351390875","9.86319400218749E7","1282.2152202843754"
"14099","152580","152575","4","152579","315523","33472.018124999995","0.4351362356249999","9.86654120399999E7","1282.6503565200003"
"14100","152579","152575","2","152577","315525","33471.579375","0.435130531875","9.86988836193749E7","1283.0854870518754"
"14101","152577","152553","675","153228","316200","33614.3925","0.4369871025","9.87324980118749E7","1283.5224741543755"
"14102","153228","153224","3","153227","316203","33614.173125","0.436984250625","9.87661121849999E7","1283.9594584050005"
"14103","153227","153225","4","153229","316207","33614.611874999995","0.43698995437499993","9.87997267968749E7","1284.3964483593754"
"14104","153229","153226","1","153227","316208","33614.173125","0.436984250625","9.88333409699999E7","1284.8334326100005"
"14105","153227","153221","7","153228","316215","33614.3925","0.4369871025","9.88669553624999E7","1285.2704197125006"
"14106","153228","153225","1","153226","316216","33613.95375","0.43698139874999997","9.890056931624989E7","1285.7074011112506"
"14107","153226","153218","1","153219","316217","33612.418125","0.43696143562499995","9.89341817343749E7","1286.1443625468758"
"14108","153219","153215","2","153217","316219","33611.979375","0.43695573187500003","9.89677937137499E7","1286.5813182787508"
"14109","153217","153213","9","153222","316228","33613.07625","0.43696999124999997","9.90014067899999E7","1287.0182882700008"
"14110","153222","153213","5","153218","316233","33612.198749999996","0.4369585837499999","9.90350189887499E7","1287.4552468537509"
"14111","153218","153209","7","153216","316240","33611.76","0.43695288","9.906863074874991E7","1287.8921997337509"
"14112","153216","153208","6","153214","316246","33611.32124999999","0.4369471762499999","9.910224206999992E7","1288.3291469100009"
"14113","153214","153207","3","153210","316249","33610.44375","0.43693576874999995","9.913585251374991E7","1288.7660826787508"
"14114","153210","153204","9","153213","316258","33611.101875","0.43694432437499997","9.916946361562492E7","1289.2030270031257"
"14115","153213","153212","4","153216","316262","33611.76","0.43695288","9.920307537562492E7","1289.6399798831258"
"14116","153216","153208","2","153210","316264","33610.44375","0.43693576874999995","9.923668581937492E7","1290.0769156518757"
"14117","153210","153209","6","153215","316270","33611.540625","0.436950028125","9.927029735999992E7","1290.5138656800007"
"14118","153215","153209","5","153214","316275","33611.32124999999","0.4369471762499999","9.930390868124993E7","1290.9508128562506"
"14119","153214","153213","3","153216","316278","33611.76","0.43695288","9.933752044124994E7","1291.3877657362507"
"14120","153216","153209","5","153214","316283","33611.32124999999","0.4369471762499999","9.937113176249994E7","1291.8247129125007"
"14121","153214","153213","8","153221","316291","33612.856875","0.4369671393749999","9.940474461937495E7","1292.2616800518756"
"14122","153221","153219","8","153227","316299","33614.173125","0.436984250625","9.943835879249994E7","1292.6986643025007"
"14123","153227","153224","1","153225","316300","33613.734375","0.436978546875","9.947197252687494E7","1293.1356428493757"
"14124","153225","153220","7","153227","316307","33614.173125","0.436984250625","9.950558669999994E7","1293.5726271000008"
"14125","153227","153218","4","153222","316311","33613.07625","0.43696999124999997","9.953919977624995E7","1294.0095970912507"
"14126","153222","153216","6","153222","316317","33613.07625","0.43696999124999997","9.957281285249995E7","1294.4465670825007"
"14127","153222","153213","3","153216","316320","33611.76","0.43695288","9.960642461249995E7","1294.8835199625007"
"14128","153216","153215","6","153221","316326","33612.856875","0.4369671393749999","9.964003746937495E7","1295.3204871018756"
"14129","153221","153218","9","153227","316335","33614.173125","0.436984250625","9.967365164249995E7","1295.7574713525007"
"14130","153227","153223","5","153228","316340","33614.3925","0.4369871025","9.970726603499995E7","1296.1944584550008"
"14131","153228","153225","2","153227","316342","33614.173125","0.436984250625","9.974088020812495E7","1296.631442705626"
"14132","153227","153221","9","153230","316351","33614.83125","0.43699280625000003","9.977449503937495E7","1297.0684355118758"
"14133","153230","153222","3","153225","316354","33613.734375","0.436978546875","9.980810877374995E7","1297.5054140587508"
"14134","153225","153222","1","153223","316355","33613.295625","0.43697284312499995","9.984172206937495E7","1297.9423869018758"
"14135","153223","153216","9","153225","316364","33613.734375","0.436978546875","9.987533580374995E7","1298.3793654487508"
"14136","153225","153216","7","153223","316371","33613.295625","0.43697284312499995","9.990894909937495E7","1298.8163382918758"
"14137","153223","153221","7","153228","316378","33614.3925","0.4369871025","9.994256349187495E7","1299.253325394376"
"14138","153228","153221","1","153222","316379","33613.07625","0.43696999124999997","9.997617656812495E7","1299.6902953856259"
"14139","153222","153217","6","153223","316385","33613.295625","0.43697284312499995","1.0000978986374995E8","1300.1272682287508"
"14140","153223","153219","7","153226","316392","33613.95375","0.43698139874999997","1.0004340381749995E8","1300.5642496275009"
"14141","153226","153225","6","153231","316398","33615.050624999996","0.4369956581249999","1.0007701886812495E8","1301.0012452856258"
"14142","153231","153225","4","153229","316402","33614.611874999995","0.43698995437499993","1.0011063347999994E8","1301.4382352400007"
"14143","153229","153227","5","153232","316407","33615.270000000004","0.43699851","1.0014424874999994E8","1301.8752337500007"
"14144","153232","153231","9","153240","316416","33617.025","0.437021325","1.0017786577499995E8","1302.3122550750006"
"14145","153240","153231","4","153235","316420","33615.928125","0.43700706562499997","1.0021148170312494E8","1302.7492621406257"
"14146","153235","153226","6","153232","316426","33615.270000000004","0.43699851","1.0024509697312494E8","1303.1862606506256"
"14147","153232","153227","8","153235","316434","33615.928125","0.43700706562499997","1.0027871290124993E8","1303.6232677162507"
"14148","153235","153232","4","153236","316438","33616.1475","0.43700991749999996","1.0031232904874992E8","1304.0602776337507"
"14149","153236","153227","8","153235","316446","33615.928125","0.43700706562499997","1.0034594497687492E8","1304.4972846993758"
"14150","153235","153229","9","153238","316455","33616.58625","0.43701562125","1.0037956156312492E8","1304.9343003206259"
"14151","153238","153234","6","153240","316461","33617.025","0.437021325","1.0041317858812493E8","1305.3713216456258"
"14152","153240","153238","4","153242","316465","33617.46375","0.43702702875","1.0044679605187494E8","1305.8083486743758"
"14153","153242","153234","5","153239","316470","33616.80562499999","0.43701847312499986","1.0048041285749994E8","1306.2453671475007"
"14154","153239","153237","1","153238","316471","33616.58625","0.43701562125","1.0051402944374995E8","1306.6823827687508"
"14155","153238","153233","6","153239","316477","33616.80562499999","0.43701847312499986","1.0054764624937496E8","1307.1194012418757"
"14156","153239","153233","8","153241","316485","33617.244375","0.437024176875","1.0058126349374996E8","1307.5564254187507"
"14157","153241","153238","4","153242","316489","33617.46375","0.43702702875","1.0061488095749997E8","1307.9934524475007"
"14158","153242","153233","2","153235","316491","33615.928125","0.43700706562499997","1.0064849688562496E8","1308.4304595131257"
"14159","153235","153226","9","153235","316500","33615.928125","0.43700706562499997","1.0068211281374995E8","1308.8674665787507"
"14160","153235","153229","8","153237","316508","33616.366875","0.43701276937499994","1.0071572918062495E8","1309.3044793481258"
"14161","153237","153218","917","154135","317425","33813.365625","0.43957375312499997","1.0074954254624994E8","1309.7440531012508"
"14162","154135","154126","7","154133","317432","33812.926875","0.43956804937499994","1.0078335547312494E8","1310.1836211506259"
"14163","154133","154131","8","154139","317440","33814.24312499999","0.4395851606249999","1.0081716971624994E8","1310.623206311251"
"14164","154139","154135","9","154144","317449","33815.34","0.4395994199999999","1.0085098505624995E8","1311.0628057312508"
"14165","154144","154138","3","154141","317452","33814.681875","0.439590864375","1.0088479973812495E8","1311.502396595626"
"14166","154141","154135","1","154136","317453","33813.585","0.43957660499999995","1.0091861332312495E8","1311.9419732006259"
"14167","154136","154128","7","154135","317460","33813.365625","0.43957375312499997","1.0095242668874994E8","1312.3815469537508"
"14168","154135","154128","5","154133","317465","33812.926875","0.43956804937499994","1.0098623961562493E8","1312.821115003126"
"14169","154133","154131","4","154135","317469","33813.365625","0.43957375312499997","1.0102005298124993E8","1313.2606887562508"
"14170","154135","154128","8","154136","317477","33813.585","0.43957660499999995","1.0105386656624992E8","1313.7002653612508"
"14171","154136","154130","4","154134","317481","33813.14625","0.4395709012499999","1.0108767971249992E8","1314.1398362625007"
"14172","154134","154125","6","154131","317487","33812.488124999996","0.4395623456249999","1.0112149220062491E8","1314.5793986081258"
"14173","154131","154125","8","154133","317495","33812.926875","0.43956804937499994","1.0115530512749991E8","1315.0189666575009"
"14174","154133","154131","9","154140","317504","33814.4625","0.4395880125","1.0118911958999991E8","1315.458554670001"
"14175","154140","154139","5","154144","317509","33815.34","0.4395994199999999","1.0122293492999992E8","1315.8981540900008"
"14176","154144","154141","6","154147","317515","33815.998125","0.4396079756249999","1.0125675092812492E8","1316.3377620656258"
"14177","154147","154141","2","154143","317517","33815.120624999996","0.4395965681249999","1.0129056604874992E8","1316.7773586337507"
"14178","154143","154139","1","154140","317518","33814.4625","0.4395880125","1.0132438051124993E8","1317.2169466462508"
"14179","154140","154135","4","154139","317522","33814.24312499999","0.4395851606249999","1.0135819475437494E8","1317.6565318068758"
"14180","154139","154131","1","154132","317523","33812.707500000004","0.4395651975","1.0139200746187493E8","1318.096097004376"
"14181","154132","154129","2","154131","317525","33812.488124999996","0.4395623456249999","1.0142581994999993E8","1318.535659350001"
"14182","154131","154127","4","154131","317529","33812.488124999996","0.4395623456249999","1.0145963243812492E8","1318.975221695626"
"14183","154131","154126","6","154132","317535","33812.707500000004","0.4395651975","1.0149344514562492E8","1319.4147868931261"
"14184","154132","154124","4","154128","317539","33811.83","0.43955379","1.0152725697562492E8","1319.854340683126"
"14185","154128","154120","2","154122","317541","33810.51375","0.43953667874999997","1.0156106748937492E8","1320.2938773618762"
"14186","154122","154115","1","154116","317542","33809.1975","0.4395195675","1.0159487668687493E8","1320.733396929376"
"14187","154116","154115","2","154117","317544","33809.416875","0.43952241937500003","1.0162868610374993E8","1321.172919348751"
"14188","154117","154116","9","154125","317553","33811.171875","0.439545234375","1.0166249727562493E8","1321.612464583126"
"14189","154125","154121","1","154122","317554","33810.51375","0.43953667874999997","1.0169630778937493E8","1322.052001261876"
"14190","154122","154121","4","154125","317558","33811.171875","0.439545234375","1.0173011896124993E8","1322.491546496251"
"14191","154125","154117","3","154120","317561","33810.075","0.43953097499999993","1.0176392903624994E8","1322.931077471251"
"14192","154120","154119","8","154127","317569","33811.610625","0.439550938125","1.0179774064687493E8","1323.370628409376"
"14193","154127","154126","3","154129","317572","33812.049374999995","0.43955664187499993","1.0183155269624993E8","1323.810185051251"
"14194","154129","154123","6","154129","317578","33812.049374999995","0.43955664187499993","1.0186536474562493E8","1324.249741693126"
"14195","154129","154120","8","154128","317586","33811.83","0.43955379","1.0189917657562493E8","1324.689295483126"
"14196","154128","154120","5","154125","317591","33811.171875","0.439545234375","1.0193298774749993E8","1325.128840717501"
"14197","154125","154121","1","154122","317592","33810.51375","0.43953667874999997","1.0196679826124993E8","1325.568377396251"
"14198","154122","154116","3","154119","317595","33809.855625","0.43952812312499995","1.0200060811687493E8","1326.007905519376"
"14199","154119","154115","1","154116","317596","33809.1975","0.4395195675","1.0203441731437494E8","1326.447425086876"
"14200","154116","154109","4","154113","317600","33808.539375","0.43951101187499997","1.0206822585374995E8","1326.886936098751"
"14201","154113","154111","3","154114","317603","33808.75874999999","0.4395138637499999","1.0210203461249995E8","1327.326449962501"
"14202","154114","154105","7","154112","317610","33808.32","0.43950816","1.0213584293249995E8","1327.7659581225012"
"14203","154112","154105","4","154109","317614","33807.661875","0.43949960437499996","1.0216965059437494E8","1328.2054577268761"
"14204","154109","154104","3","154107","317617","33807.223125000004","0.43949390062500004","1.0220345781749994E8","1328.644951627501"
"14205","154107","154105","2","154107","317619","33807.223125000004","0.43949390062500004","1.0223726504062493E8","1329.084445528126"
"14206","154107","154103","7","154110","317626","33807.88125","0.43950245624999995","1.0227107292187493E8","1329.523947984376"
"14207","154110","154103","5","154108","317631","33807.4425","0.4394967524999999","1.0230488036437492E8","1329.963444736876"
"14208","154108","154104","1","154105","317632","33806.784375","0.439488196875","1.0233868714874992E8","1330.402932933751"
"14209","154105","154099","4","154103","317636","33806.345625","0.439482493125","1.0237249349437492E8","1330.842415426876"
"14210","154103","154102","2","154104","317638","33806.564999999995","0.4394853449999999","1.0240630005937491E8","1331.281900771876"
"14211","154104","154103","4","154107","317642","33807.223125000004","0.43949390062500004","1.0244010728249991E8","1331.721394672501"
"14212","154107","154100","2","154102","317644","33806.12625","0.43947964125","1.0247391340874991E8","1332.160874313751"
"14213","154102","154097","7","154104","317651","33806.564999999995","0.4394853449999999","1.025077199737499E8","1332.6003596587511"
"14214","154104","154096","9","154105","317660","33806.784375","0.439488196875","1.025415267581249E8","1333.039847855626"
"14215","154105","154099","7","154106","317667","33807.003749999996","0.43949104874999995","1.025753337618749E8","1333.479338904376"
"14216","154106","154097","9","154106","317676","33807.003749999996","0.43949104874999995","1.026091407656249E8","1333.9188299531259"
"14217","154106","154103","2","154105","317678","33806.784375","0.439488196875","1.026429475499999E8","1334.3583181500007"
"14218","154105","154096","9","154105","317687","33806.784375","0.439488196875","1.0267675433437489E8","1334.7978063468756"
"14219","154105","154102","1","154103","317688","33806.345625","0.439482493125","1.0271056067999989E8","1335.2372888400007"
"14220","154103","154097","2","154099","317690","33805.468125","0.439471085625","1.0274436614812489E8","1335.6767599256257"
"14221","154099","154087","542","154629","318232","33921.736874999995","0.4409825793749999","1.0277828788499989E8","1336.1177425050007"
"14222","154629","154622","5","154627","318237","33921.298125","0.440976875625","1.0281220918312488E8","1336.5587193806257"
"14223","154627","154618","1","154619","318238","33919.543125","0.4409540606249999","1.0284612872624989E8","1336.9996734412507"
"14224","154619","154618","2","154620","318240","33919.7625","0.4409569124999999","1.0288004848874989E8","1337.4406303537507"
"14225","154620","154611","8","154619","318248","33919.543125","0.4409540606249999","1.029139680318749E8","1337.8815844143758"
"14226","154619","154610","7","154617","318255","33919.104375","0.440948356875","1.029478871362499E8","1338.3225327712507"
"14227","154617","154614","9","154623","318264","33920.420625","0.440965468125","1.029818075568749E8","1338.7634982393756"
"14228","154623","154615","4","154619","318268","33919.543125","0.4409540606249999","1.030157270999999E8","1339.2044523000006"
"14229","154619","154614","6","154620","318274","33919.7625","0.4409569124999999","1.0304964686249991E8","1339.6454092125007"
"14230","154620","154614","9","154623","318283","33920.420625","0.440965468125","1.0308356728312491E8","1340.0863746806256"
"14231","154623","154617","4","154621","318287","33919.981875","0.44095976437499995","1.0311748726499991E8","1340.5273344450006"
"14232","154621","154614","7","154621","318294","33919.981875","0.44095976437499995","1.0315140724687491E8","1340.9682942093757"
"14233","154621","154618","6","154624","318300","33920.64","0.44096831999999997","1.0318532788687491E8","1341.4092625293756"
"14234","154624","154623","9","154632","318309","33922.395000000004","0.44099113500000003","1.0321925028187491E8","1341.8502536643757"
"14235","154632","154626","8","154634","318317","33922.83375","0.44099683874999995","1.032531731156249E8","1342.2912505031256"
"14236","154634","154629","8","154637","318325","33923.491875","0.44100539437499997","1.032870966074999E8","1342.7322558975006"
"14237","154637","154630","8","154638","318333","33923.71125","0.44100824624999996","1.033210203187499E8","1343.1732641437507"
"14238","154638","154637","7","154644","318340","33925.0275","0.44102535749999994","1.0335494534624991E8","1343.6142895012506"
"14239","154644","154643","9","154652","318349","33926.7825","0.4410481725","1.033888721287499E8","1344.0553376737505"
"14240","154652","154648","9","154657","318358","33927.879375000004","0.44106243187500005","1.034228000081249E8","1344.4964001056255"
"14241","154657","154655","8","154663","318366","33929.195625","0.441079543125","1.0345672920374991E8","1344.9374796487505"
"14242","154663","154658","7","154665","318373","33929.634375","0.441085246875","1.0349065883812492E8","1345.3785648956255"
"14243","154665","154663","8","154671","318381","33930.950625","0.4411023581249999","1.0352458978874992E8","1345.8196672537504"
"14244","154671","154669","5","154674","318386","33931.60875","0.44111091374999994","1.0355852139749992E8","1346.2607781675003"
"14245","154674","154665","3","154668","318389","33930.292499999996","0.4410938024999999","1.0359245168999992E8","1346.7018719700004"
"14246","154668","154663","5","154668","318394","33930.292499999996","0.4410938024999999","1.0362638198249993E8","1347.1429657725005"
"14247","154668","154660","5","154665","318399","33929.634375","0.441085246875","1.0366031161687493E8","1347.5840510193755"
"14248","154665","154663","7","154670","318406","33930.73125","0.44109950624999994","1.0369424234812494E8","1348.0251505256256"
"14249","154670","154669","9","154678","318415","33932.48625","0.44112232125","1.0372817483437493E8","1348.4662728468757"
"14250","154678","154675","8","154683","318423","33933.583125","0.44113658062499994","1.0376210841749993E8","1348.9074094275006"
"14251","154683","154675","8","154683","318431","33933.583125","0.44113658062499994","1.0379604200062492E8","1349.3485460081256"
"14252","154683","154679","2","154681","318433","33933.144374999996","0.4411308768749999","1.0382997514499992E8","1349.7896768850005"
"14253","154681","154673","6","154679","318439","33932.705624999995","0.4411251731249999","1.0386390785062492E8","1350.2308020581256"
"14254","154679","154672","1","154673","318440","33931.389375","0.44110806187499996","1.0389783923999992E8","1350.6719101200006"
"14255","154673","154664","9","154673","318449","33931.389375","0.44110806187499996","1.0393177062937492E8","1351.1130181818755"
"14256","154673","154668","1","154669","318450","33930.511875","0.44109665437499995","1.0396570114124992E8","1351.5541148362506"
"14257","154669","154660","9","154669","318459","33930.511875","0.44109665437499995","1.0399963165312493E8","1351.9952114906257"
"14258","154669","154667","9","154676","318468","33932.0475","0.4411166175","1.0403356370062493E8","1352.4363281081257"
"14259","154676","154670","7","154677","318475","33932.266875","0.44111946937499996","1.0406749596749993E8","1352.8774475775008"
"14260","154677","154673","2","154675","318477","33931.828125","0.441113765625","1.0410142779562493E8","1353.3185613431258"
"14261","154675","154674","4","154678","318481","33932.48625","0.44112232125","1.0413536028187492E8","1353.7596836643759"
"14262","154678","154671","9","154680","318490","33932.925","0.44112802500000003","1.0416929320687492E8","1354.2008116893758"
"14263","154680","154672","7","154679","318497","33932.705624999995","0.4411251731249999","1.0420322591249992E8","1354.6419368625009"
"14264","154679","154675","2","154677","318499","33932.266875","0.44111946937499996","1.0423715817937492E8","1355.083056331876"
"14265","154677","154673","1","154674","318500","33931.60875","0.44111091374999994","1.0427108978812492E8","1355.524167245626"
"14266","154674","154671","4","154675","318504","33931.828125","0.441113765625","1.0430502161624992E8","1355.965281011251"
"14267","154675","154669","8","154677","318512","33932.266875","0.44111946937499996","1.0433895388312492E8","1356.406400480626"
"14268","154677","154669","3","154672","318515","33931.17","0.44110520999999997","1.0437288505312492E8","1356.847505690626"
"14269","154672","154666","1","154667","318516","33930.073125","0.44109095062500003","1.0440681512624992E8","1357.288596641251"
"14270","154667","154666","2","154668","318518","33930.292499999996","0.4410938024999999","1.0444074541874993E8","1357.729690443751"
"14271","154668","154663","1","154664","318519","33929.41499999999","0.4410823949999999","1.0447467483374994E8","1358.170772838751"
"14272","154664","154657","3","154660","318522","33928.5375","0.44107098749999996","1.0450860337124993E8","1358.611843826251"
"14273","154660","154659","9","154668","318531","33930.292499999996","0.4410938024999999","1.0454253366374993E8","1359.0529376287511"
"14274","154668","154660","1","154661","318532","33928.756875","0.44107383937499994","1.0457646242062493E8","1359.494011468126"
"14275","154661","154652","4","154656","318536","33927.659999999996","0.44105957999999995","1.0461039008062492E8","1359.935071048126"
"14276","154656","154648","5","154653","318541","33927.001875","0.441051024375","1.0464431708249992E8","1360.376122072501"
"14277","154653","154648","5","154653","318546","33927.001875","0.441051024375","1.0467824408437492E8","1360.8171730968759"
"14278","154653","154650","4","154654","318550","33927.221249999995","0.4410538762499999","1.0471217130562492E8","1361.2582269731258"
"14279","154654","154648","3","154651","318553","33926.563125","0.44104532062499996","1.0474609786874992E8","1361.699272293751"
"14280","154651","154648","6","154654","318559","33927.221249999995","0.4410538762499999","1.0478002508999991E8","1362.140326170001"
"14281","154654","154635","992","155627","319551","34140.673125","0.443828750625","1.0481416576312491E8","1362.584154920626"
"14282","155627","155618","2","155620","319553","34139.1375","0.4438087874999999","1.0484830490062492E8","1363.027963708126"
"14283","155620","155611","6","155617","319559","34138.479375","0.443800231875","1.0488244337999992E8","1363.471763940001"
"14284","155617","155608","9","155617","319568","34138.479375","0.443800231875","1.0491658185937493E8","1363.915564171876"
"14285","155617","155610","8","155618","319576","34138.698749999996","0.44380308374999994","1.0495072055812493E8","1364.359367255626"
"14286","155618","155612","8","155620","319584","34139.1375","0.4438087874999999","1.0498485969562493E8","1364.803176043126"
"14287","155620","155612","8","155620","319592","34139.1375","0.4438087874999999","1.0501899883312494E8","1365.2469848306262"
"14288","155620","155611","3","155614","319595","34137.82124999999","0.4437916762499999","1.0505313665437494E8","1365.690776506876"
"14289","155614","155611","3","155614","319598","34137.82124999999","0.4437916762499999","1.0508727447562495E8","1366.134568183126"
"14290","155614","155606","7","155613","319605","34137.601875","0.443788824375","1.0512141207749996E8","1366.578357007501"
"14291","155613","155610","8","155618","319613","34138.698749999996","0.44380308374999994","1.0515555077624996E8","1367.022160091251"
"14292","155618","155613","8","155621","319621","34139.356875","0.44381163937499996","1.0518969013312496E8","1367.465971730626"
"14293","155621","155619","2","155621","319623","34139.356875","0.44381163937499996","1.0522382948999996E8","1367.9097833700012"
"14294","155621","155616","7","155623","319630","34139.795625","0.44381734312499993","1.0525796928562497E8","1368.353600713126"
"14295","155623","155617","5","155622","319635","34139.57625","0.44381449124999994","1.0529210886187497E8","1368.797415204376"
"14296","155622","155613","3","155616","319638","34138.26","0.44379738","1.0532624712187497E8","1369.241212584376"
"14297","155616","155608","1","155609","319639","34136.724375","0.44377741687499994","1.0536038384624997E8","1369.684990001251"
"14298","155609","155605","2","155607","319641","34136.285625000004","0.443771713125","1.0539452013187496E8","1370.128761714376"
"14299","155607","155604","6","155610","319647","34136.94375","0.44378026874999993","1.0542865707562496E8","1370.572541983126"
"14300","155610","155603","3","155606","319650","34136.066249999996","0.4437688612499999","1.0546279314187495E8","1371.016310844376"
"14301","155606","155598","5","155603","319655","34135.408125","0.443760305625","1.0549692854999995E8","1371.4600711500009"
"14302","155603","155598","5","155603","319660","34135.408125","0.443760305625","1.0553106395812495E8","1371.9038314556258"
"14303","155603","155596","8","155604","319668","34135.627499999995","0.4437631574999999","1.0556519958562495E8","1372.3475946131257"
"14304","155604","155598","5","155603","319673","34135.408125","0.443760305625","1.0559933499374995E8","1372.7913549187506"
"14305","155603","155594","2","155596","319675","34133.8725","0.44374034249999994","1.0563346886624995E8","1373.2350952612505"
"14306","155596","155594","1","155595","319676","34133.653125","0.44373749062499995","1.0566760251937495E8","1373.6788327518755"
"14307","155595","155591","4","155595","319680","34133.653125","0.44373749062499995","1.0570173617249995E8","1374.1225702425004"
"14308","155595","155593","2","155595","319682","34133.653125","0.44373749062499995","1.0573586982562496E8","1374.5663077331253"
"14309","155595","155592","2","155594","319684","34133.43375","0.4437346387499999","1.0577000325937496E8","1375.0100423718752"
"14310","155594","155588","3","155591","319687","34132.775625","0.443726083125","1.0580413603499997E8","1375.4537684550003"
"14311","155591","155588","9","155597","319696","34134.091875","0.4437431943749999","1.0583827012687497E8","1375.8975116493752"
"14312","155597","155591","6","155597","319702","34134.091875","0.4437431943749999","1.0587240421874997E8","1376.3412548437502"
"14313","155597","155588","3","155591","319705","34132.775625","0.443726083125","1.0590653699437498E8","1376.7849809268753"
"14314","155591","155590","3","155593","319708","34133.214374999996","0.4437317868749999","1.0594067020874998E8","1377.2287127137504"
"14315","155593","155590","8","155598","319716","34134.31125","0.44374604624999997","1.0597480451999998E8","1377.6724587600004"
"14316","155598","155594","5","155599","319721","34134.530625","0.44374889812499996","1.0600893905062498E8","1378.1162076581254"
"14317","155599","155593","6","155599","319727","34134.530625","0.44374889812499996","1.0604307358124998E8","1378.5599565562504"
"14318","155599","155590","4","155594","319731","34133.43375","0.4437346387499999","1.0607720701499999E8","1379.0036911950003"
"14319","155594","155586","5","155591","319736","34132.775625","0.443726083125","1.0611133979062499E8","1379.4474172781254"
"14320","155591","155582","7","155589","319743","34132.33687499999","0.44372037937499986","1.061454721275E8","1379.8911376575004"
"14321","155589","155584","4","155588","319747","34132.1175","0.4437175275","1.06179604245E8","1380.3348551850004"
"14322","155588","155581","9","155590","319756","34132.55625","0.44372323125","1.0621373680125001E8","1380.7785784162504"
"14323","155590","155583","6","155589","319762","34132.33687499999","0.44372037937499986","1.0624786913812502E8","1381.2222987956254"
"14324","155589","155583","7","155590","319769","34132.55625","0.44372323125","1.0628200169437502E8","1381.6660220268755"
"14325","155590","155587","4","155591","319773","34132.775625","0.443726083125","1.0631613447000003E8","1382.1097481100005"
"14326","155591","155586","8","155594","319781","34133.43375","0.4437346387499999","1.0635026790375003E8","1382.5534827487504"
"14327","155594","155588","3","155591","319784","34132.775625","0.443726083125","1.0638440067937504E8","1382.9972088318755"
"14328","155591","155584","8","155592","319792","34132.995","0.443728935","1.0641853367437504E8","1383.4409377668755"
"14329","155592","155588","5","155593","319797","34133.214374999996","0.4437317868749999","1.0645266688875005E8","1383.8846695537507"
"14330","155593","155584","6","155590","319803","34132.55625","0.44372323125","1.0648679944500005E8","1384.3283927850007"
"14331","155590","155581","8","155589","319811","34132.33687499999","0.44372037937499986","1.0652093178187506E8","1384.7721131643757"
"14332","155589","155586","5","155591","319816","34132.775625","0.443726083125","1.0655506455750006E8","1385.2158392475008"
"14333","155591","155588","6","155594","319822","34133.43375","0.4437346387499999","1.0658919799125007E8","1385.6595738862507"
"14334","155594","155590","6","155596","319828","34133.8725","0.44374034249999994","1.0662333186375007E8","1386.1033142287506"
"14335","155596","155592","9","155601","319837","34134.969375","0.443754601875","1.0665746683312507E8","1386.5470688306257"
"14336","155601","155597","7","155604","319844","34135.627499999995","0.4437631574999999","1.0669160246062507E8","1386.9908319881256"
"14337","155604","155602","8","155610","319852","34136.94375","0.44378026874999993","1.0672573940437506E8","1387.4346122568757"
"14338","155610","155605","6","155611","319858","34137.163125","0.44378312062499997","1.0675987656750005E8","1387.8783953775007"
"14339","155611","155603","4","155607","319862","34136.285625000004","0.443771713125","1.0679401285312505E8","1388.3221670906257"
"14340","155607","155601","4","155605","319866","34135.846875","0.443766009375","1.0682814870000005E8","1388.7659331000007"
"14341","155605","155583","984","156567","320850","34346.885625","0.446509513125","1.0686249558562505E8","1389.2124426131256"
"14342","156567","156559","9","156568","320859","34347.104999999996","0.4465123649999999","1.0689684269062506E8","1389.6589549781256"
"14343","156568","156567","4","156571","320863","34347.763125","0.44652092062499993","1.0693119045375006E8","1390.1054758987507"
"14344","156571","156570","8","156578","320871","34349.29875","0.44654088375","1.0696553975250006E8","1390.5520167825007"
"14345","156578","156569","6","156575","320877","34348.640625","0.446532328125","1.0699988839312506E8","1390.9985491106256"
"14346","156575","156572","8","156580","320885","34349.7375","0.44654658750000004","1.0703423813062505E8","1391.4450956981257"
"14347","156580","156576","8","156584","320893","34350.615","0.44655799499999993","1.0706858874562505E8","1391.8916536931256"
"14348","156584","156578","4","156582","320897","34350.176250000004","0.44655229125","1.0710293892187504E8","1392.3382059843757"
"14349","156582","156574","4","156578","320901","34349.29875","0.44654088375","1.0713728822062504E8","1392.7847468681257"
"14350","156578","156574","8","156582","320909","34350.176250000004","0.44655229125","1.0717163839687504E8","1393.2312991593758"
"14351","156582","156579","2","156581","320911","34349.956874999996","0.4465494393749999","1.0720598835375004E8","1393.6778485987509"
"14352","156581","156576","9","156585","320920","34350.834375","0.446560846875","1.0724033918812503E8","1394.1244094456258"
"14353","156585","156584","4","156588","320924","34351.4925","0.4465694025","1.0727469068062504E8","1394.5709788481258"
"14354","156588","156580","9","156589","320933","34351.71187499999","0.44657225437499987","1.0730904239250004E8","1395.0175511025009"
"14355","156589","156584","9","156593","320942","34352.589374999996","0.4465836618749999","1.0734339498187505E8","1395.4641347643758"
"14356","156593","156589","8","156597","320950","34353.466875","0.44659506937499993","1.0737774844875005E8","1395.9107298337508"
"14357","156597","156596","9","156605","320959","34355.221875","0.446617884375","1.0741210367062505E8","1396.3573477181258"
"14358","156605","156600","6","156606","320965","34355.441249999996","0.44662073624999993","1.0744645911187504E8","1396.8039684543758"
"14359","156606","156602","6","156608","320971","34355.88","0.44662643999999996","1.0748081499187504E8","1397.2505948943758"
"14360","156608","156605","7","156612","320978","34356.7575","0.44663784749999996","1.0751517174937503E8","1397.6972327418757"
"14361","156612","156607","7","156614","320985","34357.19624999999","0.4466435512499999","1.0754952894562504E8","1398.1438762931257"
"14362","156614","156608","5","156613","320990","34356.976875","0.44664069937499995","1.0758388592250004E8","1398.5905169925006"
"14363","156613","156612","4","156616","320994","34357.635","0.446649255","1.0761824355750005E8","1399.0371662475006"
"14364","156616","156614","5","156619","320999","34358.293125","0.44665781062499993","1.0765260185062505E8","1399.4838240581257"
"14365","156619","156615","5","156620","321004","34358.5125","0.4466606624999999","1.0768696036312506E8","1399.9304847206258"
"14366","156620","156615","3","156618","321007","34358.073749999996","0.44665495874999994","1.0772131843687506E8","1400.377139679376"
"14367","156618","156613","3","156616","321010","34357.635","0.446649255","1.0775567607187507E8","1400.823788934376"
"14368","156616","156613","2","156615","321012","34357.415625","0.446646403125","1.0779003348750007E8","1401.2704353375009"
"14369","156615","156611","6","156617","321018","34357.854375","0.446652106875","1.0782439134187508E8","1401.717087444376"
"14370","156617","156616","5","156621","321023","34358.731875","0.44666351437499996","1.0785875007375008E8","1402.1637509587508"
"14371","156621","156615","9","156624","321032","34359.39","0.44667207","1.0789310946375008E8","1402.6104230287508"
"14372","156624","156618","3","156621","321035","34358.731875","0.44666351437499996","1.0792746819562508E8","1403.0570865431257"
"14373","156621","156615","3","156618","321038","34358.073749999996","0.44665495874999994","1.0796182626937509E8","1403.5037415018758"
"14374","156618","156617","1","156618","321039","34358.073749999996","0.44665495874999994","1.0799618434312509E8","1403.9503964606258"
"14375","156618","156611","8","156619","321047","34358.293125","0.44665781062499993","1.080305426362501E8","1404.397054271251"
"14376","156619","156612","9","156621","321056","34358.731875","0.44666351437499996","1.080649013681251E8","1404.8437177856258"
"14377","156621","156620","8","156628","321064","34360.2675","0.4466834775","1.080992616356251E8","1405.290401263126"
"14378","156628","156625","6","156631","321070","34360.925624999996","0.44669203312499994","1.0813362256125009E8","1405.7370932962508"
"14379","156631","156622","6","156628","321076","34360.2675","0.4466834775","1.0816798282875009E8","1406.1837767737509"
"14380","156628","156622","4","156626","321080","34359.82875","0.44667777375","1.0820234265750009E8","1406.630454547501"
"14381","156626","156617","2","156619","321082","34358.293125","0.44665781062499993","1.0823670095062509E8","1407.077112358126"
"14382","156619","156614","3","156617","321085","34357.854375","0.446652106875","1.082710588050001E8","1407.523764465001"
"14383","156617","156616","9","156625","321094","34359.609375","0.44667492187499996","1.083054184143751E8","1407.970439386876"
"14384","156625","156619","4","156623","321098","34359.170625","0.44666921812499993","1.083397775850001E8","1408.417108605001"
"14385","156623","156619","1","156620","321099","34358.5125","0.4466606624999999","1.083741360975001E8","1408.863769267501"
"14386","156620","156619","2","156621","321101","34358.731875","0.44666351437499996","1.084084948293751E8","1409.310432781876"
"14387","156621","156619","2","156621","321103","34358.731875","0.44666351437499996","1.084428535612501E8","1409.757096296251"
"14388","156621","156620","5","156625","321108","34359.609375","0.44667492187499996","1.084772131706251E8","1410.203771218126"
"14389","156625","156619","2","156621","321110","34358.731875","0.44666351437499996","1.0851157190250011E8","1410.6504347325008"
"14390","156621","156615","4","156619","321114","34358.293125","0.44665781062499993","1.0854593019562511E8","1411.0970925431259"
"14391","156619","156618","1","156619","321115","34358.293125","0.44665781062499993","1.0858028848875012E8","1411.543750353751"
"14392","156619","156615","8","156623","321123","34359.170625","0.44666921812499993","1.0861464765937512E8","1411.990419571876"
"14393","156623","156621","9","156630","321132","34360.70625","0.44668918125","1.0864900836562511E8","1412.4371087531258"
"14394","156630","156622","1","156623","321133","34359.170625","0.44666921812499993","1.0868336753625011E8","1412.8837779712508"
"14395","156623","156617","2","156619","321135","34358.293125","0.44665781062499993","1.0871772582937512E8","1413.3304357818758"
"14396","156619","156617","9","156626","321144","34359.82875","0.44667777375","1.0875208565812512E8","1413.7771135556259"
"14397","156626","156621","4","156625","321148","34359.609375","0.44667492187499996","1.0878644526750012E8","1414.2237884775009"
"14398","156625","156624","6","156630","321154","34360.70625","0.44668918125","1.0882080597375011E8","1414.6704776587508"
"14399","156630","156622","1","156623","321155","34359.170625","0.44666921812499993","1.0885516514437512E8","1415.1171468768757"
"14400","156623","156618","9","156627","321164","34360.048125","0.446680625625","1.0888952519250011E8","1415.5638275025008"
